,Date Time,Doctors (count),Nurses(Count),Doctors on-call (Count),Nurses on-call (Count),Total Hospital Beds (Count),Hospital Beds Open (Count),Hospital Beds Occupied (Count),Ambulances On Duty (Count)
0,2022-01-01 00:00:00,132,297,10,10,680,550,130,14
1,2022-01-01 01:00:00,126,274,13,11,737,593,144,13
2,2022-01-01 02:00:00,129,270,8,10,749,640,109,5
3,2022-01-01 03:00:00,120,251,14,19,783,629,154,9
4,2022-01-01 04:00:00,122,250,5,14,685,563,122,9
5,2022-01-01 05:00:00,146,281,13,11,709,504,205,8
6,2022-01-01 06:00:00,138,277,5,13,609,495,114,9
7,2022-01-01 07:00:00,140,253,9,14,575,456,119,8
8,2022-01-01 08:00:00,125,291,8,10,698,490,208,6
9,2022-01-01 09:00:00,149,253,7,10,681,577,104,5
10,2022-01-01 10:00:00,123,280,8,12,669,584,85,7
11,2022-01-01 11:00:00,131,290,7,13,694,602,92,11
12,2022-01-01 12:00:00,144,252,8,12,586,460,126,13
13,2022-01-01 13:00:00,132,264,5,14,793,573,220,11
14,2022-01-01 14:00:00,136,269,6,18,627,514,113,14
15,2022-01-01 15:00:00,144,274,14,12,763,549,214,11
16,2022-01-01 16:00:00,149,274,8,12,768,594,174,11
17,2022-01-01 17:00:00,131,282,13,14,714,642,72,13
18,2022-01-01 18:00:00,141,279,8,13,509,456,53,12
19,2022-01-01 19:00:00,129,260,12,17,783,665,118,7
20,2022-01-01 20:00:00,128,286,5,12,567,436,131,5
21,2022-01-01 21:00:00,144,277,13,14,571,506,65,12
22,2022-01-01 22:00:00,137,279,9,12,555,493,62,10
23,2022-01-01 23:00:00,131,272,6,16,764,683,81,8
24,2022-01-02 00:00:00,129,275,7,10,703,577,126,6
25,2022-01-02 01:00:00,124,280,13,14,764,672,92,13
26,2022-01-02 02:00:00,143,263,6,18,785,657,128,9
27,2022-01-02 03:00:00,123,269,12,18,719,596,123,13
28,2022-01-02 04:00:00,133,276,9,11,711,563,148,7
29,2022-01-02 05:00:00,133,273,6,16,565,480,85,5
30,2022-01-02 06:00:00,132,263,14,16,778,648,130,13
31,2022-01-02 07:00:00,128,285,11,11,762,584,178,5
32,2022-01-02 08:00:00,144,254,9,11,712,569,143,9
33,2022-01-02 09:00:00,142,257,14,11,691,534,157,13
34,2022-01-02 10:00:00,130,251,9,14,758,678,80,13
35,2022-01-02 11:00:00,135,285,8,12,717,503,214,8
36,2022-01-02 12:00:00,144,286,8,15,667,581,86,13
37,2022-01-02 13:00:00,139,259,10,15,657,517,140,13
38,2022-01-02 14:00:00,141,277,8,16,698,517,181,5
39,2022-01-02 15:00:00,125,278,13,10,637,451,186,8
40,2022-01-02 16:00:00,146,264,5,13,552,438,114,14
41,2022-01-02 17:00:00,147,267,8,12,538,418,120,12
42,2022-01-02 18:00:00,138,263,12,12,637,538,99,11
43,2022-01-02 19:00:00,136,297,13,10,502,382,120,11
44,2022-01-02 20:00:00,138,257,6,19,772,666,106,10
45,2022-01-02 21:00:00,138,283,5,19,592,428,164,5
46,2022-01-02 22:00:00,125,274,7,13,529,380,149,8
47,2022-01-02 23:00:00,139,256,7,16,694,561,133,14
48,2022-01-03 00:00:00,147,281,6,13,534,439,95,14
49,2022-01-03 01:00:00,134,287,6,15,519,444,75,11
50,2022-01-03 02:00:00,135,292,8,12,666,504,162,7
51,2022-01-03 03:00:00,144,253,10,18,604,521,83,13
52,2022-01-03 04:00:00,137,257,10,10,568,453,115,11
53,2022-01-03 05:00:00,148,275,7,14,612,520,92,11
54,2022-01-03 06:00:00,136,262,10,14,571,457,114,8
55,2022-01-03 07:00:00,123,260,9,11,790,710,80,7
56,2022-01-03 08:00:00,126,259,7,14,613,441,172,10
57,2022-01-03 09:00:00,132,290,6,15,577,428,149,8
58,2022-01-03 10:00:00,145,274,12,18,507,418,89,11
59,2022-01-03 11:00:00,123,256,8,12,653,523,130,11
60,2022-01-03 12:00:00,122,283,11,11,664,501,163,6
61,2022-01-03 13:00:00,131,271,7,12,776,557,219,14
62,2022-01-03 14:00:00,121,293,10,18,708,590,118,14
63,2022-01-03 15:00:00,128,276,10,15,708,610,98,5
64,2022-01-03 16:00:00,132,279,5,17,708,508,200,8
65,2022-01-03 17:00:00,137,269,11,17,794,694,100,12
66,2022-01-03 18:00:00,129,270,9,15,534,385,149,5
67,2022-01-03 19:00:00,135,288,6,14,571,466,105,12
68,2022-01-03 20:00:00,142,266,7,17,642,473,169,7
69,2022-01-03 21:00:00,133,298,10,14,500,409,91,13
70,2022-01-03 22:00:00,121,279,10,10,777,591,186,8
71,2022-01-03 23:00:00,147,253,11,15,629,514,115,6
72,2022-01-04 00:00:00,149,283,10,18,634,562,72,6
73,2022-01-04 01:00:00,125,297,14,19,524,447,77,10
74,2022-01-04 02:00:00,134,255,11,13,629,481,148,6
75,2022-01-04 03:00:00,135,282,9,12,734,544,190,13
76,2022-01-04 04:00:00,121,286,10,15,614,441,173,9
77,2022-01-04 05:00:00,144,280,7,13,793,622,171,9
78,2022-01-04 06:00:00,141,270,14,11,603,508,95,12
79,2022-01-04 07:00:00,131,284,6,13,746,619,127,6
80,2022-01-04 08:00:00,139,266,12,13,668,520,148,7
81,2022-01-04 09:00:00,134,285,9,17,530,462,68,14
82,2022-01-04 10:00:00,133,274,13,14,731,617,114,11
83,2022-01-04 11:00:00,125,257,14,10,566,438,128,6
84,2022-01-04 12:00:00,144,259,13,12,629,506,123,6
85,2022-01-04 13:00:00,141,278,10,11,761,634,127,7
86,2022-01-04 14:00:00,121,283,11,18,539,398,141,7
87,2022-01-04 15:00:00,142,250,10,13,791,554,237,9
88,2022-01-04 16:00:00,120,251,7,10,590,477,113,14
89,2022-01-04 17:00:00,138,264,9,17,637,502,135,12
90,2022-01-04 18:00:00,137,273,14,10,549,485,64,6
91,2022-01-04 19:00:00,132,272,7,18,628,545,83,10
92,2022-01-04 20:00:00,147,298,9,11,573,469,104,11
93,2022-01-04 21:00:00,120,298,6,18,778,652,126,5
94,2022-01-04 22:00:00,129,279,8,17,730,563,167,9
95,2022-01-04 23:00:00,139,264,11,18,703,512,191,7
96,2022-01-05 00:00:00,127,262,5,14,602,508,94,5
97,2022-01-05 01:00:00,138,254,14,17,714,559,155,9
98,2022-01-05 02:00:00,141,296,8,10,768,625,143,7
99,2022-01-05 03:00:00,148,286,8,16,708,625,83,11
100,2022-01-05 04:00:00,147,253,6,15,708,510,198,13
101,2022-01-05 05:00:00,149,299,13,12,607,510,97,6
102,2022-01-05 06:00:00,127,271,6,13,586,477,109,9
103,2022-01-05 07:00:00,139,297,6,14,513,392,121,7
104,2022-01-05 08:00:00,137,285,13,13,625,538,87,13
105,2022-01-05 09:00:00,132,288,10,18,697,588,109,11
106,2022-01-05 10:00:00,144,297,8,17,610,468,142,12
107,2022-01-05 11:00:00,140,290,9,14,666,576,90,13
108,2022-01-05 12:00:00,139,284,7,11,726,544,182,12
109,2022-01-05 13:00:00,137,284,9,11,520,437,83,7
110,2022-01-05 14:00:00,123,275,10,11,738,620,118,12
111,2022-01-05 15:00:00,139,284,9,10,726,595,131,8
112,2022-01-05 16:00:00,140,270,5,12,596,454,142,7
113,2022-01-05 17:00:00,138,268,10,15,640,457,183,13
114,2022-01-05 18:00:00,132,279,8,11,717,582,135,13
115,2022-01-05 19:00:00,137,295,5,16,596,444,152,12
116,2022-01-05 20:00:00,134,295,10,11,776,600,176,10
117,2022-01-05 21:00:00,147,280,8,10,532,402,130,13
118,2022-01-05 22:00:00,140,282,12,12,569,454,115,9
119,2022-01-05 23:00:00,137,254,13,10,762,568,194,9
120,2022-01-06 00:00:00,149,273,5,18,604,453,151,13
121,2022-01-06 01:00:00,135,253,10,10,597,453,144,11
122,2022-01-06 02:00:00,145,276,8,13,645,484,161,9
123,2022-01-06 03:00:00,138,263,8,11,527,393,134,12
124,2022-01-06 04:00:00,121,274,5,15,545,381,164,9
125,2022-01-06 05:00:00,134,299,11,14,668,565,103,14
126,2022-01-06 06:00:00,149,250,13,16,547,468,79,14
127,2022-01-06 07:00:00,145,275,9,14,795,681,114,7
128,2022-01-06 08:00:00,142,289,6,15,612,506,106,11
129,2022-01-06 09:00:00,139,268,11,19,592,530,62,10
130,2022-01-06 10:00:00,143,253,14,16,582,450,132,10
131,2022-01-06 11:00:00,136,255,5,16,784,663,121,14
132,2022-01-06 12:00:00,126,255,14,18,651,501,150,9
133,2022-01-06 13:00:00,133,258,10,17,786,599,187,11
134,2022-01-06 14:00:00,146,289,7,18,510,365,145,6
135,2022-01-06 15:00:00,133,264,12,15,721,606,115,10
136,2022-01-06 16:00:00,137,271,7,19,699,548,151,6
137,2022-01-06 17:00:00,121,251,9,19,740,518,222,13
138,2022-01-06 18:00:00,140,278,13,13,592,525,67,10
139,2022-01-06 19:00:00,127,280,8,12,740,524,216,14
140,2022-01-06 20:00:00,146,261,13,14,731,594,137,5
141,2022-01-06 21:00:00,130,252,14,13,511,436,75,8
142,2022-01-06 22:00:00,124,253,8,11,616,499,117,11
143,2022-01-06 23:00:00,126,283,13,15,590,528,62,10
144,2022-01-07 00:00:00,142,259,8,13,786,644,142,14
145,2022-01-07 01:00:00,144,294,13,15,727,575,152,12
146,2022-01-07 02:00:00,142,293,9,15,510,435,75,11
147,2022-01-07 03:00:00,131,297,11,14,568,423,145,9
148,2022-01-07 04:00:00,126,256,5,19,611,470,141,10
149,2022-01-07 05:00:00,148,250,7,15,545,490,55,8
150,2022-01-07 06:00:00,148,285,10,11,575,477,98,8
151,2022-01-07 07:00:00,139,272,14,15,665,536,129,8
152,2022-01-07 08:00:00,146,258,14,14,597,512,85,5
153,2022-01-07 09:00:00,149,266,8,16,571,430,141,12
154,2022-01-07 10:00:00,136,285,10,16,624,522,102,9
155,2022-01-07 11:00:00,142,271,14,14,522,373,149,11
156,2022-01-07 12:00:00,121,272,7,17,721,642,79,12
157,2022-01-07 13:00:00,123,270,6,13,759,672,87,14
158,2022-01-07 14:00:00,133,290,12,11,633,506,127,9
159,2022-01-07 15:00:00,149,260,13,18,692,590,102,9
160,2022-01-07 16:00:00,123,287,12,18,646,580,66,7
161,2022-01-07 17:00:00,134,267,14,12,580,495,85,8
162,2022-01-07 18:00:00,147,271,13,15,788,671,117,14
163,2022-01-07 19:00:00,133,297,7,19,783,619,164,9
164,2022-01-07 20:00:00,128,258,10,12,601,446,155,10
165,2022-01-07 21:00:00,128,274,8,10,645,565,80,14
166,2022-01-07 22:00:00,141,279,10,13,530,401,129,6
167,2022-01-07 23:00:00,125,293,12,18,769,587,182,11
168,2022-01-08 00:00:00,142,261,8,14,511,455,56,9
169,2022-01-08 01:00:00,137,257,13,13,770,690,80,5
170,2022-01-08 02:00:00,128,287,10,11,751,559,192,6
171,2022-01-08 03:00:00,149,252,9,14,513,379,134,10
172,2022-01-08 04:00:00,145,277,11,19,757,638,119,11
173,2022-01-08 05:00:00,125,262,7,10,731,621,110,5
174,2022-01-08 06:00:00,137,255,14,10,593,474,119,14
175,2022-01-08 07:00:00,135,280,14,18,701,511,190,10
176,2022-01-08 08:00:00,149,299,9,17,793,655,138,12
177,2022-01-08 09:00:00,123,280,10,18,630,479,151,5
178,2022-01-08 10:00:00,140,276,12,15,664,578,86,12
179,2022-01-08 11:00:00,131,298,11,14,570,490,80,5
180,2022-01-08 12:00:00,148,275,10,19,686,517,169,6
181,2022-01-08 13:00:00,127,275,8,18,797,589,208,10
182,2022-01-08 14:00:00,126,292,6,14,625,485,140,14
183,2022-01-08 15:00:00,123,290,5,15,554,400,154,11
184,2022-01-08 16:00:00,147,284,11,16,725,628,97,5
185,2022-01-08 17:00:00,132,254,6,19,678,547,131,8
186,2022-01-08 18:00:00,124,254,7,10,533,476,57,10
187,2022-01-08 19:00:00,125,273,8,16,727,512,215,10
188,2022-01-08 20:00:00,139,252,8,12,702,619,83,6
189,2022-01-08 21:00:00,136,266,11,14,731,552,179,10
190,2022-01-08 22:00:00,146,296,14,19,538,381,157,13
191,2022-01-08 23:00:00,135,259,13,10,543,477,66,11
192,2022-01-09 00:00:00,143,251,6,15,668,496,172,9
193,2022-01-09 01:00:00,134,280,9,19,613,544,69,5
194,2022-01-09 02:00:00,147,276,10,12,765,567,198,11
195,2022-01-09 03:00:00,131,279,8,10,585,429,156,14
196,2022-01-09 04:00:00,124,288,10,17,657,465,192,11
197,2022-01-09 05:00:00,137,290,9,12,527,438,89,8
198,2022-01-09 06:00:00,121,254,9,14,787,583,204,12
199,2022-01-09 07:00:00,125,279,14,11,732,608,124,11
200,2022-01-09 08:00:00,131,265,14,15,615,535,80,13
201,2022-01-09 09:00:00,140,291,11,19,763,549,214,7
202,2022-01-09 10:00:00,146,261,14,18,760,533,227,7
203,2022-01-09 11:00:00,142,293,6,15,597,477,120,14
204,2022-01-09 12:00:00,121,288,5,12,747,613,134,12
205,2022-01-09 13:00:00,131,251,14,10,755,537,218,8
206,2022-01-09 14:00:00,129,291,10,16,653,496,157,10
207,2022-01-09 15:00:00,141,250,8,11,772,569,203,8
208,2022-01-09 16:00:00,147,291,8,12,733,585,148,6
209,2022-01-09 17:00:00,147,265,7,12,693,498,195,9
210,2022-01-09 18:00:00,137,255,8,17,524,417,107,7
211,2022-01-09 19:00:00,129,258,14,11,682,525,157,6
212,2022-01-09 20:00:00,134,262,13,15,737,656,81,6
213,2022-01-09 21:00:00,132,250,10,16,576,479,97,6
214,2022-01-09 22:00:00,126,293,9,19,516,444,72,11
215,2022-01-09 23:00:00,128,290,9,12,664,558,106,5
216,2022-01-10 00:00:00,132,270,13,12,577,471,106,6
217,2022-01-10 01:00:00,120,273,13,14,635,529,106,13
218,2022-01-10 02:00:00,146,280,14,10,727,580,147,13
219,2022-01-10 03:00:00,130,265,11,18,783,573,210,9
220,2022-01-10 04:00:00,128,257,14,13,714,570,144,12
221,2022-01-10 05:00:00,140,285,5,12,568,411,157,7
222,2022-01-10 06:00:00,121,279,9,15,545,399,146,6
223,2022-01-10 07:00:00,129,291,8,17,534,450,84,5
224,2022-01-10 08:00:00,149,255,10,19,602,466,136,12
225,2022-01-10 09:00:00,132,250,12,16,751,535,216,5
226,2022-01-10 10:00:00,132,293,10,14,575,472,103,5
227,2022-01-10 11:00:00,139,271,11,14,539,381,158,5
228,2022-01-10 12:00:00,145,255,7,13,601,490,111,13
229,2022-01-10 13:00:00,146,278,12,17,676,560,116,5
230,2022-01-10 14:00:00,139,285,9,11,653,528,125,11
231,2022-01-10 15:00:00,121,288,9,14,572,482,90,14
232,2022-01-10 16:00:00,122,296,5,17,540,428,112,14
233,2022-01-10 17:00:00,135,292,11,11,617,459,158,9
234,2022-01-10 18:00:00,144,269,11,15,749,550,199,14
235,2022-01-10 19:00:00,132,297,10,13,659,567,92,8
236,2022-01-10 20:00:00,138,282,7,16,603,536,67,13
237,2022-01-10 21:00:00,126,270,7,15,715,629,86,7
238,2022-01-10 22:00:00,130,255,14,15,606,505,101,5
239,2022-01-10 23:00:00,139,299,8,11,597,502,95,11
240,2022-01-11 00:00:00,124,279,14,13,796,667,129,8
241,2022-01-11 01:00:00,138,267,8,18,565,408,157,10
242,2022-01-11 02:00:00,135,277,11,13,513,406,107,8
243,2022-01-11 03:00:00,146,271,14,18,612,478,134,7
244,2022-01-11 04:00:00,125,296,8,17,574,433,141,10
245,2022-01-11 05:00:00,129,278,14,17,624,489,135,10
246,2022-01-11 06:00:00,135,255,14,16,697,551,146,7
247,2022-01-11 07:00:00,142,297,14,13,754,623,131,7
248,2022-01-11 08:00:00,134,282,8,17,788,654,134,6
249,2022-01-11 09:00:00,142,250,10,15,601,497,104,8
250,2022-01-11 10:00:00,147,259,8,13,705,524,181,7
251,2022-01-11 11:00:00,144,271,13,13,696,614,82,11
252,2022-01-11 12:00:00,127,258,8,17,799,597,202,11
253,2022-01-11 13:00:00,125,288,8,17,537,425,112,7
254,2022-01-11 14:00:00,136,264,5,15,790,614,176,8
255,2022-01-11 15:00:00,140,293,14,10,560,486,74,11
256,2022-01-11 16:00:00,125,298,5,18,732,571,161,9
257,2022-01-11 17:00:00,127,287,11,13,615,458,157,5
258,2022-01-11 18:00:00,132,298,7,17,596,439,157,5
259,2022-01-11 19:00:00,136,256,9,16,504,387,117,13
260,2022-01-11 20:00:00,142,254,9,19,558,419,139,10
261,2022-01-11 21:00:00,148,277,7,12,773,618,155,14
262,2022-01-11 22:00:00,124,286,6,18,573,482,91,10
263,2022-01-11 23:00:00,131,291,11,11,797,692,105,11
264,2022-01-12 00:00:00,126,275,11,12,570,437,133,14
265,2022-01-12 01:00:00,124,268,10,12,725,549,176,13
266,2022-01-12 02:00:00,149,285,8,13,687,574,113,12
267,2022-01-12 03:00:00,138,252,5,17,597,528,69,5
268,2022-01-12 04:00:00,140,293,6,16,582,451,131,12
269,2022-01-12 05:00:00,129,279,5,11,504,375,129,8
270,2022-01-12 06:00:00,138,255,6,15,567,465,102,7
271,2022-01-12 07:00:00,124,288,6,15,641,552,89,13
272,2022-01-12 08:00:00,146,289,14,11,618,538,80,14
273,2022-01-12 09:00:00,133,281,10,11,788,555,233,12
274,2022-01-12 10:00:00,126,286,6,10,732,516,216,12
275,2022-01-12 11:00:00,129,297,9,16,584,455,129,11
276,2022-01-12 12:00:00,125,252,9,10,743,661,82,13
277,2022-01-12 13:00:00,148,284,11,16,755,662,93,6
278,2022-01-12 14:00:00,133,267,10,12,699,539,160,7
279,2022-01-12 15:00:00,125,257,8,16,577,415,162,7
280,2022-01-12 16:00:00,146,282,12,11,507,451,56,10
281,2022-01-12 17:00:00,125,292,9,17,730,654,76,11
282,2022-01-12 18:00:00,143,288,11,15,581,418,163,8
283,2022-01-12 19:00:00,145,296,10,10,738,579,159,7
284,2022-01-12 20:00:00,123,294,11,14,740,573,167,8
285,2022-01-12 21:00:00,120,253,10,17,755,564,191,13
286,2022-01-12 22:00:00,122,290,7,12,719,599,120,7
287,2022-01-12 23:00:00,123,275,12,14,583,440,143,6
288,2022-01-13 00:00:00,133,271,12,10,628,541,87,14
289,2022-01-13 01:00:00,139,287,8,12,798,680,118,8
290,2022-01-13 02:00:00,124,296,6,10,684,598,86,6
291,2022-01-13 03:00:00,136,294,6,18,645,462,183,8
292,2022-01-13 04:00:00,140,289,14,18,521,374,147,11
293,2022-01-13 05:00:00,135,283,5,13,541,474,67,14
294,2022-01-13 06:00:00,141,280,14,18,627,512,115,14
295,2022-01-13 07:00:00,138,298,14,17,623,448,175,8
296,2022-01-13 08:00:00,121,275,13,19,531,453,78,12
297,2022-01-13 09:00:00,147,286,5,19,705,594,111,8
298,2022-01-13 10:00:00,146,253,13,13,667,511,156,5
299,2022-01-13 11:00:00,143,257,6,12,798,689,109,6
300,2022-01-13 12:00:00,144,284,12,18,636,490,146,10
301,2022-01-13 13:00:00,126,250,14,14,547,427,120,7
302,2022-01-13 14:00:00,135,278,11,14,591,477,114,11
303,2022-01-13 15:00:00,137,256,9,10,503,452,51,12
304,2022-01-13 16:00:00,129,261,9,11,595,489,106,14
305,2022-01-13 17:00:00,147,299,12,10,634,566,68,13
306,2022-01-13 18:00:00,136,266,5,12,561,456,105,8
307,2022-01-13 19:00:00,140,258,14,12,781,579,202,13
308,2022-01-13 20:00:00,127,271,11,16,794,635,159,10
309,2022-01-13 21:00:00,123,282,10,11,541,389,152,6
310,2022-01-13 22:00:00,138,265,8,18,748,546,202,13
311,2022-01-13 23:00:00,133,274,9,11,523,465,58,8
312,2022-01-14 00:00:00,129,278,10,17,750,621,129,12
313,2022-01-14 01:00:00,130,278,10,11,695,575,120,7
314,2022-01-14 02:00:00,145,251,7,18,527,378,149,14
315,2022-01-14 03:00:00,121,291,11,19,791,595,196,6
316,2022-01-14 04:00:00,142,271,11,10,590,497,93,14
317,2022-01-14 05:00:00,139,257,7,19,764,591,173,6
318,2022-01-14 06:00:00,124,252,12,18,560,397,163,13
319,2022-01-14 07:00:00,144,264,8,17,757,598,159,7
320,2022-01-14 08:00:00,132,286,7,16,579,516,63,12
321,2022-01-14 09:00:00,137,292,9,16,647,483,164,12
322,2022-01-14 10:00:00,122,251,5,15,732,624,108,8
323,2022-01-14 11:00:00,121,273,12,18,722,573,149,5
324,2022-01-14 12:00:00,126,250,13,18,637,556,81,10
325,2022-01-14 13:00:00,125,254,14,10,775,696,79,11
326,2022-01-14 14:00:00,143,280,13,18,503,422,81,9
327,2022-01-14 15:00:00,123,286,9,14,586,420,166,13
328,2022-01-14 16:00:00,140,257,11,18,511,365,146,6
329,2022-01-14 17:00:00,147,284,11,19,538,389,149,14
330,2022-01-14 18:00:00,149,286,12,17,715,587,128,10
331,2022-01-14 19:00:00,142,299,6,17,737,611,126,9
332,2022-01-14 20:00:00,138,270,14,17,579,473,106,6
333,2022-01-14 21:00:00,146,297,13,11,550,469,81,7
334,2022-01-14 22:00:00,139,284,10,14,669,510,159,13
335,2022-01-14 23:00:00,148,270,9,15,615,544,71,8
336,2022-01-15 00:00:00,144,261,10,16,787,605,182,10
337,2022-01-15 01:00:00,140,287,10,13,619,553,66,8
338,2022-01-15 02:00:00,129,294,12,16,738,522,216,8
339,2022-01-15 03:00:00,121,275,11,17,688,552,136,8
340,2022-01-15 04:00:00,144,260,7,10,595,418,177,5
341,2022-01-15 05:00:00,146,286,9,14,524,416,108,9
342,2022-01-15 06:00:00,140,255,12,14,744,624,120,6
343,2022-01-15 07:00:00,129,252,5,17,549,475,74,5
344,2022-01-15 08:00:00,126,262,11,18,753,541,212,10
345,2022-01-15 09:00:00,149,273,7,19,690,614,76,14
346,2022-01-15 10:00:00,127,277,5,16,520,386,134,13
347,2022-01-15 11:00:00,123,283,9,10,549,434,115,12
348,2022-01-15 12:00:00,142,253,11,17,675,582,93,7
349,2022-01-15 13:00:00,133,288,14,15,540,457,83,8
350,2022-01-15 14:00:00,133,252,13,19,515,361,154,5
351,2022-01-15 15:00:00,132,299,9,10,614,434,180,8
352,2022-01-15 16:00:00,145,256,10,16,751,562,189,9
353,2022-01-15 17:00:00,122,261,9,19,571,437,134,5
354,2022-01-15 18:00:00,146,255,7,10,523,388,135,8
355,2022-01-15 19:00:00,120,288,5,19,658,467,191,6
356,2022-01-15 20:00:00,129,267,7,16,514,421,93,5
357,2022-01-15 21:00:00,131,254,11,16,671,545,126,5
358,2022-01-15 22:00:00,124,282,6,10,549,425,124,5
359,2022-01-15 23:00:00,126,276,14,14,541,420,121,5
360,2022-01-16 00:00:00,133,286,6,10,752,655,97,13
361,2022-01-16 01:00:00,122,292,5,17,553,432,121,9
362,2022-01-16 02:00:00,122,278,7,15,527,410,117,8
363,2022-01-16 03:00:00,148,260,14,19,741,602,139,8
364,2022-01-16 04:00:00,134,259,8,13,643,563,80,13
365,2022-01-16 05:00:00,131,258,11,13,785,649,136,13
366,2022-01-16 06:00:00,122,287,11,15,626,454,172,7
367,2022-01-16 07:00:00,149,284,14,10,624,504,120,9
368,2022-01-16 08:00:00,147,292,9,10,719,642,77,10
369,2022-01-16 09:00:00,147,284,13,17,736,649,87,13
370,2022-01-16 10:00:00,135,265,14,16,578,505,73,13
371,2022-01-16 11:00:00,126,283,8,10,706,530,176,12
372,2022-01-16 12:00:00,125,277,11,17,505,431,74,12
373,2022-01-16 13:00:00,144,261,11,18,555,494,61,10
374,2022-01-16 14:00:00,127,262,14,17,758,625,133,6
375,2022-01-16 15:00:00,123,291,11,14,592,497,95,9
376,2022-01-16 16:00:00,146,252,11,13,676,600,76,8
377,2022-01-16 17:00:00,140,253,5,10,572,476,96,7
378,2022-01-16 18:00:00,146,293,13,15,755,579,176,11
379,2022-01-16 19:00:00,148,260,6,12,673,585,88,8
380,2022-01-16 20:00:00,131,284,6,16,653,492,161,13
381,2022-01-16 21:00:00,146,270,14,14,579,477,102,8
382,2022-01-16 22:00:00,140,277,13,17,588,448,140,11
383,2022-01-16 23:00:00,120,250,6,10,780,550,230,8
384,2022-01-17 00:00:00,124,260,6,16,668,601,67,5
385,2022-01-17 01:00:00,133,290,12,18,522,458,64,7
386,2022-01-17 02:00:00,131,265,10,14,794,671,123,14
387,2022-01-17 03:00:00,123,291,13,13,641,558,83,12
388,2022-01-17 04:00:00,127,265,9,10,731,552,179,11
389,2022-01-17 05:00:00,148,253,12,19,591,515,76,6
390,2022-01-17 06:00:00,130,262,8,13,586,477,109,10
391,2022-01-17 07:00:00,123,250,11,14,740,531,209,10
392,2022-01-17 08:00:00,149,267,5,12,635,498,137,9
393,2022-01-17 09:00:00,120,293,6,12,640,458,182,9
394,2022-01-17 10:00:00,131,299,5,17,679,478,201,10
395,2022-01-17 11:00:00,131,283,9,11,622,472,150,8
396,2022-01-17 12:00:00,120,281,13,13,648,484,164,11
397,2022-01-17 13:00:00,126,261,9,12,504,451,53,5
398,2022-01-17 14:00:00,147,253,6,17,740,608,132,5
399,2022-01-17 15:00:00,132,267,12,13,559,432,127,9
400,2022-01-17 16:00:00,120,294,14,16,697,614,83,10
401,2022-01-17 17:00:00,123,257,13,14,575,426,149,10
402,2022-01-17 18:00:00,136,263,13,11,715,601,114,12
403,2022-01-17 19:00:00,147,276,12,17,755,532,223,8
404,2022-01-17 20:00:00,120,281,7,15,551,473,78,13
405,2022-01-17 21:00:00,131,297,5,16,706,601,105,6
406,2022-01-17 22:00:00,144,274,7,19,748,640,108,6
407,2022-01-17 23:00:00,135,268,11,18,592,426,166,14
408,2022-01-18 00:00:00,141,290,13,10,697,617,80,14
409,2022-01-18 01:00:00,142,294,6,17,689,499,190,14
410,2022-01-18 02:00:00,126,251,6,15,788,705,83,10
411,2022-01-18 03:00:00,122,265,6,19,623,533,90,5
412,2022-01-18 04:00:00,123,294,7,10,560,448,112,8
413,2022-01-18 05:00:00,130,266,9,11,559,403,156,13
414,2022-01-18 06:00:00,120,253,10,18,756,640,116,10
415,2022-01-18 07:00:00,127,298,8,11,752,672,80,11
416,2022-01-18 08:00:00,142,260,14,11,776,622,154,11
417,2022-01-18 09:00:00,120,285,11,17,720,538,182,11
418,2022-01-18 10:00:00,122,277,10,19,733,627,106,10
419,2022-01-18 11:00:00,132,277,14,10,730,579,151,11
420,2022-01-18 12:00:00,132,252,5,11,750,538,212,5
421,2022-01-18 13:00:00,127,258,5,16,568,425,143,5
422,2022-01-18 14:00:00,136,276,13,19,603,541,62,8
423,2022-01-18 15:00:00,131,296,13,16,527,429,98,6
424,2022-01-18 16:00:00,149,298,8,19,598,468,130,13
425,2022-01-18 17:00:00,149,260,6,13,678,498,180,6
426,2022-01-18 18:00:00,121,297,14,10,507,450,57,7
427,2022-01-18 19:00:00,128,251,11,10,583,423,160,5
428,2022-01-18 20:00:00,131,254,7,11,597,536,61,7
429,2022-01-18 21:00:00,127,284,5,11,603,499,104,12
430,2022-01-18 22:00:00,127,252,13,17,563,451,112,5
431,2022-01-18 23:00:00,129,256,10,11,683,494,189,10
432,2022-01-19 00:00:00,149,261,10,12,573,505,68,5
433,2022-01-19 01:00:00,124,289,8,17,798,611,187,13
434,2022-01-19 02:00:00,120,299,8,14,551,478,73,5
435,2022-01-19 03:00:00,139,284,6,13,634,493,141,14
436,2022-01-19 04:00:00,132,253,11,19,557,436,121,5
437,2022-01-19 05:00:00,141,271,11,17,566,493,73,14
438,2022-01-19 06:00:00,132,294,9,18,763,659,104,9
439,2022-01-19 07:00:00,126,289,7,11,588,481,107,14
440,2022-01-19 08:00:00,137,286,5,13,772,617,155,10
441,2022-01-19 09:00:00,137,268,7,11,642,478,164,9
442,2022-01-19 10:00:00,121,267,12,10,743,556,187,12
443,2022-01-19 11:00:00,124,252,6,19,790,605,185,9
444,2022-01-19 12:00:00,127,290,9,11,516,408,108,9
445,2022-01-19 13:00:00,140,286,13,10,752,568,184,13
446,2022-01-19 14:00:00,129,277,13,17,744,634,110,11
447,2022-01-19 15:00:00,144,269,12,16,697,560,137,10
448,2022-01-19 16:00:00,129,275,10,17,534,385,149,9
449,2022-01-19 17:00:00,146,259,14,14,613,432,181,11
450,2022-01-19 18:00:00,120,273,10,17,729,515,214,6
451,2022-01-19 19:00:00,139,287,14,13,663,506,157,11
452,2022-01-19 20:00:00,137,255,5,19,548,442,106,8
453,2022-01-19 21:00:00,122,261,7,18,663,589,74,13
454,2022-01-19 22:00:00,126,294,7,12,552,434,118,10
455,2022-01-19 23:00:00,138,277,14,15,789,626,163,8
456,2022-01-20 00:00:00,149,257,13,14,642,513,129,7
457,2022-01-20 01:00:00,140,259,6,13,534,433,101,7
458,2022-01-20 02:00:00,140,275,9,17,574,460,114,12
459,2022-01-20 03:00:00,138,276,7,17,768,590,178,11
460,2022-01-20 04:00:00,133,266,13,19,552,399,153,8
461,2022-01-20 05:00:00,122,250,14,18,502,376,126,9
462,2022-01-20 06:00:00,122,283,14,16,739,659,80,5
463,2022-01-20 07:00:00,129,251,5,13,642,501,141,8
464,2022-01-20 08:00:00,126,283,5,10,722,539,183,7
465,2022-01-20 09:00:00,138,291,12,18,503,366,137,6
466,2022-01-20 10:00:00,127,256,6,18,525,430,95,13
467,2022-01-20 11:00:00,122,282,11,18,641,527,114,8
468,2022-01-20 12:00:00,120,290,9,18,580,412,168,8
469,2022-01-20 13:00:00,148,255,6,11,633,558,75,9
470,2022-01-20 14:00:00,125,289,9,13,701,588,113,13
471,2022-01-20 15:00:00,132,256,5,14,629,549,80,6
472,2022-01-20 16:00:00,129,258,8,17,756,615,141,7
473,2022-01-20 17:00:00,127,265,14,11,627,512,115,6
474,2022-01-20 18:00:00,143,270,6,18,585,468,117,9
475,2022-01-20 19:00:00,142,291,9,17,534,449,85,10
476,2022-01-20 20:00:00,131,273,13,15,779,657,122,11
477,2022-01-20 21:00:00,140,294,10,14,769,607,162,11
478,2022-01-20 22:00:00,121,267,6,19,534,427,107,6
479,2022-01-20 23:00:00,142,254,9,11,713,503,210,9
480,2022-01-21 00:00:00,138,255,7,13,655,491,164,14
481,2022-01-21 01:00:00,126,254,11,11,630,537,93,5
482,2022-01-21 02:00:00,128,258,6,15,660,541,119,8
483,2022-01-21 03:00:00,140,268,13,15,645,468,177,12
484,2022-01-21 04:00:00,122,287,8,13,631,459,172,7
485,2022-01-21 05:00:00,141,253,6,12,745,641,104,8
486,2022-01-21 06:00:00,131,290,7,10,717,615,102,6
487,2022-01-21 07:00:00,145,278,7,17,660,470,190,8
488,2022-01-21 08:00:00,139,260,11,14,587,459,128,10
489,2022-01-21 09:00:00,121,295,8,19,703,583,120,11
490,2022-01-21 10:00:00,142,255,12,16,730,620,110,12
491,2022-01-21 11:00:00,131,267,11,18,594,461,133,13
492,2022-01-21 12:00:00,142,270,9,17,594,451,143,12
493,2022-01-21 13:00:00,123,260,5,15,556,460,96,7
494,2022-01-21 14:00:00,145,292,8,19,724,601,123,6
495,2022-01-21 15:00:00,137,282,6,17,726,586,140,14
496,2022-01-21 16:00:00,129,297,13,18,623,538,85,6
497,2022-01-21 17:00:00,149,293,14,15,623,528,95,7
498,2022-01-21 18:00:00,128,269,14,13,609,427,182,9
499,2022-01-21 19:00:00,144,278,7,14,632,561,71,6
500,2022-01-21 20:00:00,146,280,5,15,501,360,141,6
501,2022-01-21 21:00:00,133,293,7,13,707,617,90,14
502,2022-01-21 22:00:00,131,295,13,11,620,540,80,12
503,2022-01-21 23:00:00,129,251,13,13,683,522,161,7
504,2022-01-22 00:00:00,125,292,11,19,725,563,162,13
505,2022-01-22 01:00:00,126,296,9,16,511,445,66,12
506,2022-01-22 02:00:00,132,269,8,17,585,440,145,11
507,2022-01-22 03:00:00,126,255,10,12,621,514,107,10
508,2022-01-22 04:00:00,137,265,14,14,640,483,157,7
509,2022-01-22 05:00:00,129,261,12,15,682,507,175,5
510,2022-01-22 06:00:00,143,259,8,11,757,563,194,9
511,2022-01-22 07:00:00,120,264,14,16,656,541,115,11
512,2022-01-22 08:00:00,147,276,14,14,654,561,93,14
513,2022-01-22 09:00:00,134,254,14,10,672,507,165,9
514,2022-01-22 10:00:00,125,280,11,15,690,485,205,12
515,2022-01-22 11:00:00,126,275,10,17,720,520,200,14
516,2022-01-22 12:00:00,122,255,13,10,560,443,117,10
517,2022-01-22 13:00:00,128,284,6,12,671,539,132,11
518,2022-01-22 14:00:00,123,298,10,19,629,526,103,10
519,2022-01-22 15:00:00,126,250,14,15,664,520,144,5
520,2022-01-22 16:00:00,137,251,12,18,512,444,68,9
521,2022-01-22 17:00:00,127,281,6,19,565,502,63,13
522,2022-01-22 18:00:00,135,299,6,12,745,538,207,9
523,2022-01-22 19:00:00,146,261,14,19,731,642,89,12
524,2022-01-22 20:00:00,126,278,5,14,500,383,117,5
525,2022-01-22 21:00:00,132,275,5,15,714,601,113,9
526,2022-01-22 22:00:00,138,277,13,14,723,577,146,14
527,2022-01-22 23:00:00,131,290,9,15,781,680,101,13
528,2022-01-23 00:00:00,134,265,9,14,500,351,149,10
529,2022-01-23 01:00:00,147,263,10,14,765,562,203,6
530,2022-01-23 02:00:00,127,277,12,13,757,530,227,12
531,2022-01-23 03:00:00,146,291,5,19,791,632,159,10
532,2022-01-23 04:00:00,141,252,5,14,546,429,117,10
533,2022-01-23 05:00:00,146,295,11,18,558,481,77,13
534,2022-01-23 06:00:00,148,275,14,19,504,453,51,7
535,2022-01-23 07:00:00,122,281,7,14,682,488,194,10
536,2022-01-23 08:00:00,133,263,9,10,513,395,118,13
537,2022-01-23 09:00:00,128,251,11,10,738,641,97,8
538,2022-01-23 10:00:00,141,285,13,17,757,575,182,13
539,2022-01-23 11:00:00,123,286,9,14,633,447,186,11
540,2022-01-23 12:00:00,131,271,5,19,634,552,82,13
541,2022-01-23 13:00:00,123,282,13,19,782,557,225,9
542,2022-01-23 14:00:00,120,294,13,11,559,458,101,11
543,2022-01-23 15:00:00,146,261,11,10,741,524,217,7
544,2022-01-23 16:00:00,124,253,9,12,613,447,166,13
545,2022-01-23 17:00:00,144,285,14,14,732,620,112,14
546,2022-01-23 18:00:00,126,251,6,19,600,535,65,6
547,2022-01-23 19:00:00,143,267,12,10,553,412,141,5
548,2022-01-23 20:00:00,125,254,13,13,527,397,130,8
549,2022-01-23 21:00:00,137,283,13,18,696,530,166,8
550,2022-01-23 22:00:00,127,255,13,10,763,546,217,13
551,2022-01-23 23:00:00,130,272,11,13,619,493,126,8
552,2022-01-24 00:00:00,142,287,14,10,594,459,135,7
553,2022-01-24 01:00:00,136,299,10,10,677,565,112,10
554,2022-01-24 02:00:00,121,271,10,10,791,648,143,11
555,2022-01-24 03:00:00,131,271,13,19,548,454,94,10
556,2022-01-24 04:00:00,132,252,9,16,641,500,141,8
557,2022-01-24 05:00:00,148,262,8,13,748,549,199,5
558,2022-01-24 06:00:00,147,260,13,11,725,560,165,8
559,2022-01-24 07:00:00,123,259,14,10,643,537,106,13
560,2022-01-24 08:00:00,139,262,14,19,691,534,157,6
561,2022-01-24 09:00:00,132,285,9,15,626,467,159,10
562,2022-01-24 10:00:00,129,268,9,10,720,527,193,10
563,2022-01-24 11:00:00,127,270,10,16,599,529,70,11
564,2022-01-24 12:00:00,143,251,11,13,562,410,152,5
565,2022-01-24 13:00:00,124,293,6,18,797,662,135,6
566,2022-01-24 14:00:00,122,295,6,14,721,607,114,11
567,2022-01-24 15:00:00,120,270,9,10,750,562,188,14
568,2022-01-24 16:00:00,121,292,9,18,722,644,78,13
569,2022-01-24 17:00:00,131,288,8,11,626,525,101,8
570,2022-01-24 18:00:00,139,269,14,15,570,416,154,6
571,2022-01-24 19:00:00,142,251,5,19,589,420,169,9
572,2022-01-24 20:00:00,121,263,11,10,508,437,71,9
573,2022-01-24 21:00:00,124,280,10,17,552,408,144,8
574,2022-01-24 22:00:00,127,267,9,14,707,506,201,10
575,2022-01-24 23:00:00,136,259,14,12,669,481,188,5
576,2022-01-25 00:00:00,124,259,11,18,575,410,165,6
577,2022-01-25 01:00:00,142,277,7,15,710,594,116,13
578,2022-01-25 02:00:00,125,287,7,11,609,519,90,7
579,2022-01-25 03:00:00,142,257,8,11,540,438,102,6
580,2022-01-25 04:00:00,133,269,14,17,597,517,80,8
581,2022-01-25 05:00:00,121,283,12,16,541,446,95,8
582,2022-01-25 06:00:00,146,294,13,12,606,517,89,12
583,2022-01-25 07:00:00,126,267,9,14,772,606,166,8
584,2022-01-25 08:00:00,139,283,11,10,516,392,124,11
585,2022-01-25 09:00:00,129,263,14,11,570,467,103,5
586,2022-01-25 10:00:00,128,250,6,17,644,565,79,11
587,2022-01-25 11:00:00,142,284,14,12,554,410,144,10
588,2022-01-25 12:00:00,141,272,6,18,609,529,80,5
589,2022-01-25 13:00:00,137,297,10,16,606,436,170,9
590,2022-01-25 14:00:00,137,250,7,17,507,448,59,7
591,2022-01-25 15:00:00,124,261,7,15,753,616,137,6
592,2022-01-25 16:00:00,148,264,5,15,644,496,148,13
593,2022-01-25 17:00:00,122,255,13,18,660,537,123,9
594,2022-01-25 18:00:00,149,288,8,12,517,463,54,7
595,2022-01-25 19:00:00,131,290,10,14,628,494,134,13
596,2022-01-25 20:00:00,131,270,7,11,742,666,76,12
597,2022-01-25 21:00:00,123,264,6,15,566,451,115,5
598,2022-01-25 22:00:00,123,268,8,19,561,393,168,14
599,2022-01-25 23:00:00,141,259,14,12,506,375,131,9
600,2022-01-26 00:00:00,140,252,11,10,623,493,130,10
601,2022-01-26 01:00:00,127,270,8,12,689,567,122,6
602,2022-01-26 02:00:00,130,275,6,12,786,661,125,6
603,2022-01-26 03:00:00,148,277,9,19,537,454,83,7
604,2022-01-26 04:00:00,142,258,13,15,626,519,107,9
605,2022-01-26 05:00:00,146,298,12,11,652,554,98,6
606,2022-01-26 06:00:00,137,299,10,15,634,534,100,11
607,2022-01-26 07:00:00,135,271,11,18,733,559,174,10
608,2022-01-26 08:00:00,126,287,9,15,771,561,210,10
609,2022-01-26 09:00:00,143,292,7,19,748,595,153,10
610,2022-01-26 10:00:00,129,256,8,15,736,555,181,14
611,2022-01-26 11:00:00,138,282,8,13,519,435,84,10
612,2022-01-26 12:00:00,149,271,9,12,776,576,200,12
613,2022-01-26 13:00:00,121,298,14,15,725,637,88,8
614,2022-01-26 14:00:00,137,292,11,17,704,531,173,8
615,2022-01-26 15:00:00,135,280,5,10,795,623,172,12
616,2022-01-26 16:00:00,123,299,6,16,538,378,160,9
617,2022-01-26 17:00:00,144,251,11,13,613,545,68,14
618,2022-01-26 18:00:00,144,292,8,15,577,502,75,13
619,2022-01-26 19:00:00,123,275,14,13,745,554,191,12
620,2022-01-26 20:00:00,129,280,5,17,501,442,59,7
621,2022-01-26 21:00:00,132,271,7,18,606,489,117,8
622,2022-01-26 22:00:00,123,296,6,19,527,412,115,5
623,2022-01-26 23:00:00,143,282,9,19,527,403,124,10
624,2022-01-27 00:00:00,131,295,14,11,637,570,67,10
625,2022-01-27 01:00:00,143,293,11,18,574,453,121,6
626,2022-01-27 02:00:00,146,267,6,11,645,520,125,12
627,2022-01-27 03:00:00,141,290,14,19,763,561,202,12
628,2022-01-27 04:00:00,130,283,8,16,682,569,113,11
629,2022-01-27 05:00:00,147,280,7,12,523,458,65,13
630,2022-01-27 06:00:00,143,252,7,10,514,447,67,14
631,2022-01-27 07:00:00,140,253,8,10,702,577,125,9
632,2022-01-27 08:00:00,140,252,14,16,580,445,135,7
633,2022-01-27 09:00:00,136,283,12,14,778,666,112,8
634,2022-01-27 10:00:00,139,276,10,14,715,509,206,6
635,2022-01-27 11:00:00,149,254,14,13,605,482,123,12
636,2022-01-27 12:00:00,126,281,5,16,741,545,196,14
637,2022-01-27 13:00:00,132,250,9,16,782,598,184,7
638,2022-01-27 14:00:00,125,298,13,16,663,589,74,8
639,2022-01-27 15:00:00,131,268,6,18,518,429,89,14
640,2022-01-27 16:00:00,144,280,12,18,533,425,108,5
641,2022-01-27 17:00:00,135,266,5,16,592,434,158,11
642,2022-01-27 18:00:00,135,291,9,15,700,497,203,8
643,2022-01-27 19:00:00,142,281,14,14,659,525,134,8
644,2022-01-27 20:00:00,141,280,12,14,695,554,141,12
645,2022-01-27 21:00:00,124,289,7,16,678,572,106,7
646,2022-01-27 22:00:00,141,296,5,14,673,537,136,5
647,2022-01-27 23:00:00,142,293,10,18,652,507,145,12
648,2022-01-28 00:00:00,122,291,12,10,708,521,187,11
649,2022-01-28 01:00:00,124,281,5,13,617,451,166,8
650,2022-01-28 02:00:00,128,289,7,19,559,410,149,7
651,2022-01-28 03:00:00,123,260,14,12,685,568,117,7
652,2022-01-28 04:00:00,133,264,5,15,698,489,209,13
653,2022-01-28 05:00:00,125,285,13,19,605,486,119,13
654,2022-01-28 06:00:00,127,276,14,19,545,489,56,12
655,2022-01-28 07:00:00,148,263,14,11,641,569,72,12
656,2022-01-28 08:00:00,122,278,13,14,607,503,104,9
657,2022-01-28 09:00:00,139,290,14,14,753,598,155,9
658,2022-01-28 10:00:00,135,254,9,12,548,425,123,10
659,2022-01-28 11:00:00,129,288,14,10,553,470,83,10
660,2022-01-28 12:00:00,138,271,7,18,706,585,121,12
661,2022-01-28 13:00:00,140,280,7,12,773,645,128,6
662,2022-01-28 14:00:00,144,277,8,17,616,479,137,11
663,2022-01-28 15:00:00,127,265,7,18,708,585,123,8
664,2022-01-28 16:00:00,131,282,7,10,726,512,214,10
665,2022-01-28 17:00:00,143,281,9,18,605,442,163,8
666,2022-01-28 18:00:00,148,286,11,19,699,555,144,7
667,2022-01-28 19:00:00,140,263,13,12,589,528,61,14
668,2022-01-28 20:00:00,138,260,5,10,587,427,160,7
669,2022-01-28 21:00:00,140,293,5,13,798,689,109,10
670,2022-01-28 22:00:00,139,285,6,14,793,592,201,13
671,2022-01-28 23:00:00,141,281,5,14,557,498,59,10
672,2022-01-29 00:00:00,148,297,5,10,559,443,116,7
673,2022-01-29 01:00:00,135,280,5,16,645,521,124,12
674,2022-01-29 02:00:00,137,287,6,15,626,500,126,12
675,2022-01-29 03:00:00,131,284,7,10,522,387,135,8
676,2022-01-29 04:00:00,123,288,5,11,664,560,104,12
677,2022-01-29 05:00:00,124,275,10,18,700,597,103,6
678,2022-01-29 06:00:00,123,274,13,17,741,534,207,6
679,2022-01-29 07:00:00,131,269,13,13,676,555,121,11
680,2022-01-29 08:00:00,121,258,12,10,532,440,92,8
681,2022-01-29 09:00:00,128,251,8,14,660,530,130,8
682,2022-01-29 10:00:00,145,278,8,12,658,544,114,14
683,2022-01-29 11:00:00,149,265,11,17,573,409,164,14
684,2022-01-29 12:00:00,121,289,7,12,690,572,118,8
685,2022-01-29 13:00:00,132,270,14,14,562,402,160,14
686,2022-01-29 14:00:00,132,271,8,11,766,536,230,6
687,2022-01-29 15:00:00,139,273,11,14,745,610,135,13
688,2022-01-29 16:00:00,130,288,7,18,542,442,100,10
689,2022-01-29 17:00:00,129,274,12,11,694,608,86,13
690,2022-01-29 18:00:00,146,264,13,13,554,413,141,10
691,2022-01-29 19:00:00,134,252,14,14,551,429,122,6
692,2022-01-29 20:00:00,124,260,5,12,598,446,152,7
693,2022-01-29 21:00:00,129,262,11,10,717,555,162,10
694,2022-01-29 22:00:00,145,274,9,14,611,502,109,9
695,2022-01-29 23:00:00,127,296,13,19,558,484,74,7
696,2022-01-30 00:00:00,135,297,11,10,674,539,135,10
697,2022-01-30 01:00:00,125,291,7,19,542,480,62,5
698,2022-01-30 02:00:00,129,298,10,14,680,597,83,9
699,2022-01-30 03:00:00,137,274,14,16,761,632,129,14
700,2022-01-30 04:00:00,139,261,14,19,691,537,154,7
701,2022-01-30 05:00:00,142,258,7,18,747,657,90,10
702,2022-01-30 06:00:00,128,283,6,17,766,558,208,10
703,2022-01-30 07:00:00,132,274,6,17,619,485,134,10
704,2022-01-30 08:00:00,138,276,12,19,764,585,179,7
705,2022-01-30 09:00:00,136,250,6,15,562,440,122,9
706,2022-01-30 10:00:00,143,263,9,12,516,421,95,9
707,2022-01-30 11:00:00,122,289,8,12,773,613,160,9
708,2022-01-30 12:00:00,124,296,8,12,565,505,60,10
709,2022-01-30 13:00:00,148,285,13,15,677,588,89,8
710,2022-01-30 14:00:00,123,261,14,18,661,565,96,7
711,2022-01-30 15:00:00,146,274,13,13,685,583,102,13
712,2022-01-30 16:00:00,131,282,13,19,679,550,129,7
713,2022-01-30 17:00:00,129,291,9,11,617,469,148,7
714,2022-01-30 18:00:00,123,267,12,19,794,623,171,5
715,2022-01-30 19:00:00,145,297,10,14,724,582,142,14
716,2022-01-30 20:00:00,144,272,11,17,707,521,186,8
717,2022-01-30 21:00:00,135,276,7,19,675,597,78,7
718,2022-01-30 22:00:00,120,280,6,14,547,420,127,5
719,2022-01-30 23:00:00,124,291,6,14,752,605,147,9
720,2022-01-31 00:00:00,141,252,14,16,645,528,117,13
721,2022-01-31 01:00:00,137,279,14,19,661,558,103,7
722,2022-01-31 02:00:00,123,272,5,15,672,515,157,8
723,2022-01-31 03:00:00,139,288,5,15,699,595,104,5
724,2022-01-31 04:00:00,127,288,8,18,500,426,74,5
725,2022-01-31 05:00:00,134,288,7,12,584,488,96,7
726,2022-01-31 06:00:00,128,278,5,18,563,410,153,9
727,2022-01-31 07:00:00,134,264,8,12,690,547,143,10
728,2022-01-31 08:00:00,128,266,5,11,525,374,151,14
729,2022-01-31 09:00:00,147,279,8,15,681,551,130,8
730,2022-01-31 10:00:00,120,293,5,10,668,540,128,14
731,2022-01-31 11:00:00,127,265,7,14,693,585,108,14
732,2022-01-31 12:00:00,148,253,14,16,703,584,119,14
733,2022-01-31 13:00:00,145,254,6,19,568,455,113,10
734,2022-01-31 14:00:00,140,296,9,12,780,619,161,12
735,2022-01-31 15:00:00,143,295,10,18,541,442,99,14
736,2022-01-31 16:00:00,148,264,9,10,568,442,126,5
737,2022-01-31 17:00:00,131,273,7,11,713,550,163,8
738,2022-01-31 18:00:00,139,259,10,15,705,507,198,8
739,2022-01-31 19:00:00,142,257,9,16,592,416,176,13
740,2022-01-31 20:00:00,142,296,7,14,700,504,196,10
741,2022-01-31 21:00:00,125,259,6,17,585,454,131,7
742,2022-01-31 22:00:00,135,271,14,11,624,560,64,11
743,2022-01-31 23:00:00,142,251,9,16,588,431,157,7
744,2022-02-01 00:00:00,131,283,5,17,744,580,164,6
745,2022-02-01 01:00:00,126,255,13,15,514,383,131,13
746,2022-02-01 02:00:00,126,265,14,14,622,492,130,11
747,2022-02-01 03:00:00,138,274,13,14,730,637,93,7
748,2022-02-01 04:00:00,141,297,10,15,587,489,98,6
749,2022-02-01 05:00:00,127,283,11,18,711,513,198,8
750,2022-02-01 06:00:00,124,268,14,15,614,454,160,6
751,2022-02-01 07:00:00,148,275,12,18,768,576,192,10
752,2022-02-01 08:00:00,121,262,9,14,706,606,100,6
753,2022-02-01 09:00:00,135,250,10,17,608,453,155,7
754,2022-02-01 10:00:00,133,252,9,17,621,455,166,11
755,2022-02-01 11:00:00,122,273,12,17,552,467,85,5
756,2022-02-01 12:00:00,129,259,12,17,742,579,163,8
757,2022-02-01 13:00:00,122,255,6,14,593,427,166,8
758,2022-02-01 14:00:00,124,276,9,19,676,498,178,14
759,2022-02-01 15:00:00,138,281,6,16,542,441,101,6
760,2022-02-01 16:00:00,141,255,12,18,641,481,160,13
761,2022-02-01 17:00:00,128,280,10,10,593,508,85,12
762,2022-02-01 18:00:00,130,290,13,15,713,621,92,7
763,2022-02-01 19:00:00,144,292,11,19,640,478,162,14
764,2022-02-01 20:00:00,135,268,8,17,701,496,205,8
765,2022-02-01 21:00:00,135,282,8,12,651,476,175,8
766,2022-02-01 22:00:00,136,272,14,15,548,388,160,13
767,2022-02-01 23:00:00,149,258,10,18,536,381,155,14
768,2022-02-02 00:00:00,127,271,12,16,781,606,175,8
769,2022-02-02 01:00:00,141,291,6,10,678,547,131,10
770,2022-02-02 02:00:00,140,277,11,19,620,437,183,5
771,2022-02-02 03:00:00,145,258,9,11,788,569,219,6
772,2022-02-02 04:00:00,136,291,13,10,731,569,162,12
773,2022-02-02 05:00:00,148,252,14,14,604,431,173,13
774,2022-02-02 06:00:00,146,272,9,11,736,590,146,7
775,2022-02-02 07:00:00,128,270,6,18,640,449,191,5
776,2022-02-02 08:00:00,125,289,5,18,629,539,90,5
777,2022-02-02 09:00:00,132,284,6,17,611,526,85,6
778,2022-02-02 10:00:00,146,284,10,18,709,576,133,8
779,2022-02-02 11:00:00,123,269,11,14,502,399,103,7
780,2022-02-02 12:00:00,146,265,7,17,638,525,113,12
781,2022-02-02 13:00:00,135,293,5,12,671,545,126,11
782,2022-02-02 14:00:00,143,265,8,18,581,482,99,9
783,2022-02-02 15:00:00,122,251,5,10,636,454,182,10
784,2022-02-02 16:00:00,132,281,13,18,711,534,177,10
785,2022-02-02 17:00:00,148,285,7,10,711,630,81,10
786,2022-02-02 18:00:00,143,255,8,15,584,472,112,12
787,2022-02-02 19:00:00,143,266,9,18,571,484,87,14
788,2022-02-02 20:00:00,140,287,9,12,673,531,142,14
789,2022-02-02 21:00:00,127,293,6,18,518,416,102,7
790,2022-02-02 22:00:00,149,275,14,14,533,462,71,12
791,2022-02-02 23:00:00,142,280,9,18,567,475,92,11
792,2022-02-03 00:00:00,121,270,13,19,633,528,105,7
793,2022-02-03 01:00:00,126,283,12,15,592,479,113,13
794,2022-02-03 02:00:00,141,293,7,16,634,504,130,10
795,2022-02-03 03:00:00,139,286,10,12,529,426,103,12
796,2022-02-03 04:00:00,128,258,8,10,727,614,113,12
797,2022-02-03 05:00:00,138,275,9,10,552,424,128,14
798,2022-02-03 06:00:00,129,275,10,16,655,571,84,5
799,2022-02-03 07:00:00,133,263,8,17,737,660,77,9
800,2022-02-03 08:00:00,141,273,10,15,672,479,193,6
801,2022-02-03 09:00:00,130,279,10,19,538,435,103,14
802,2022-02-03 10:00:00,120,283,7,11,616,459,157,6
803,2022-02-03 11:00:00,131,289,14,16,535,445,90,6
804,2022-02-03 12:00:00,139,259,6,14,679,504,175,10
805,2022-02-03 13:00:00,135,297,11,19,701,550,151,5
806,2022-02-03 14:00:00,140,280,10,13,714,638,76,13
807,2022-02-03 15:00:00,123,262,11,14,535,403,132,10
808,2022-02-03 16:00:00,142,283,9,15,537,387,150,8
809,2022-02-03 17:00:00,135,267,14,11,707,504,203,8
810,2022-02-03 18:00:00,147,267,10,10,516,393,123,9
811,2022-02-03 19:00:00,136,252,9,18,606,454,152,7
812,2022-02-03 20:00:00,144,297,13,18,543,396,147,14
813,2022-02-03 21:00:00,121,259,6,18,583,496,87,6
814,2022-02-03 22:00:00,134,274,13,17,765,669,96,13
815,2022-02-03 23:00:00,135,287,11,10,710,562,148,9
816,2022-02-04 00:00:00,128,281,14,15,501,428,73,11
817,2022-02-04 01:00:00,147,254,6,19,767,641,126,12
818,2022-02-04 02:00:00,141,275,7,16,583,514,69,13
819,2022-02-04 03:00:00,134,275,13,19,684,607,77,8
820,2022-02-04 04:00:00,122,275,13,13,722,548,174,10
821,2022-02-04 05:00:00,123,260,11,18,637,510,127,9
822,2022-02-04 06:00:00,143,296,8,19,606,497,109,9
823,2022-02-04 07:00:00,146,272,13,18,551,454,97,7
824,2022-02-04 08:00:00,129,295,7,19,654,574,80,11
825,2022-02-04 09:00:00,120,275,8,13,677,527,150,8
826,2022-02-04 10:00:00,143,285,9,16,673,481,192,6
827,2022-02-04 11:00:00,138,258,5,15,687,545,142,7
828,2022-02-04 12:00:00,127,264,14,12,613,445,168,11
829,2022-02-04 13:00:00,143,273,12,19,617,490,127,8
830,2022-02-04 14:00:00,148,281,11,19,798,636,162,10
831,2022-02-04 15:00:00,120,291,13,14,610,538,72,7
832,2022-02-04 16:00:00,129,275,8,19,701,521,180,13
833,2022-02-04 17:00:00,127,267,13,19,690,570,120,6
834,2022-02-04 18:00:00,147,284,11,18,600,497,103,10
835,2022-02-04 19:00:00,122,259,10,16,589,455,134,11
836,2022-02-04 20:00:00,134,274,14,16,713,617,96,8
837,2022-02-04 21:00:00,138,266,12,15,596,440,156,14
838,2022-02-04 22:00:00,142,286,10,18,769,572,197,13
839,2022-02-04 23:00:00,126,297,14,12,769,617,152,14
840,2022-02-05 00:00:00,127,265,8,19,693,496,197,10
841,2022-02-05 01:00:00,137,261,13,15,557,441,116,10
842,2022-02-05 02:00:00,140,276,13,12,755,678,77,13
843,2022-02-05 03:00:00,126,264,6,19,601,440,161,12
844,2022-02-05 04:00:00,138,253,9,19,530,383,147,10
845,2022-02-05 05:00:00,125,254,13,13,625,467,158,12
846,2022-02-05 06:00:00,126,296,5,10,706,620,86,14
847,2022-02-05 07:00:00,132,259,8,12,757,627,130,10
848,2022-02-05 08:00:00,121,292,9,19,737,516,221,12
849,2022-02-05 09:00:00,144,274,6,12,583,422,161,6
850,2022-02-05 10:00:00,141,299,13,11,559,467,92,13
851,2022-02-05 11:00:00,134,281,14,17,614,497,117,11
852,2022-02-05 12:00:00,120,269,11,15,547,390,157,6
853,2022-02-05 13:00:00,131,275,12,16,699,601,98,9
854,2022-02-05 14:00:00,136,293,14,18,544,453,91,6
855,2022-02-05 15:00:00,127,276,12,16,794,704,90,7
856,2022-02-05 16:00:00,126,287,10,19,505,396,109,10
857,2022-02-05 17:00:00,127,282,10,14,785,556,229,10
858,2022-02-05 18:00:00,143,287,5,19,655,476,179,8
859,2022-02-05 19:00:00,134,278,10,15,562,489,73,12
860,2022-02-05 20:00:00,138,264,11,11,549,408,141,11
861,2022-02-05 21:00:00,137,283,8,18,574,410,164,6
862,2022-02-05 22:00:00,141,258,7,15,746,552,194,11
863,2022-02-05 23:00:00,128,279,8,17,524,381,143,11
864,2022-02-06 00:00:00,134,274,8,15,758,569,189,5
865,2022-02-06 01:00:00,123,288,8,11,734,612,122,9
866,2022-02-06 02:00:00,122,251,7,12,722,521,201,7
867,2022-02-06 03:00:00,137,255,9,10,769,680,89,13
868,2022-02-06 04:00:00,143,252,7,13,736,640,96,10
869,2022-02-06 05:00:00,128,298,11,12,794,634,160,12
870,2022-02-06 06:00:00,145,281,11,14,588,477,111,5
871,2022-02-06 07:00:00,138,275,12,15,753,541,212,7
872,2022-02-06 08:00:00,121,285,7,15,619,536,83,13
873,2022-02-06 09:00:00,125,256,6,12,795,612,183,14
874,2022-02-06 10:00:00,125,298,7,12,626,445,181,8
875,2022-02-06 11:00:00,133,273,14,13,688,489,199,14
876,2022-02-06 12:00:00,131,297,6,18,775,553,222,10
877,2022-02-06 13:00:00,124,289,11,12,551,415,136,12
878,2022-02-06 14:00:00,137,290,14,18,669,502,167,13
879,2022-02-06 15:00:00,144,269,8,17,501,429,72,8
880,2022-02-06 16:00:00,146,288,7,13,662,583,79,14
881,2022-02-06 17:00:00,139,269,12,15,787,657,130,7
882,2022-02-06 18:00:00,125,293,12,10,509,369,140,13
883,2022-02-06 19:00:00,147,266,7,13,565,400,165,13
884,2022-02-06 20:00:00,141,264,6,10,619,495,124,6
885,2022-02-06 21:00:00,134,268,13,17,691,574,117,5
886,2022-02-06 22:00:00,128,290,13,18,772,541,231,11
887,2022-02-06 23:00:00,142,297,5,12,509,435,74,6
888,2022-02-07 00:00:00,137,278,14,13,783,625,158,8
889,2022-02-07 01:00:00,128,264,14,15,633,499,134,6
890,2022-02-07 02:00:00,132,260,13,13,566,478,88,11
891,2022-02-07 03:00:00,126,293,9,17,706,620,86,9
892,2022-02-07 04:00:00,132,254,8,13,749,547,202,8
893,2022-02-07 05:00:00,146,299,10,10,741,644,97,12
894,2022-02-07 06:00:00,143,266,9,18,531,387,144,13
895,2022-02-07 07:00:00,141,251,12,15,639,495,144,10
896,2022-02-07 08:00:00,128,262,7,15,503,376,127,14
897,2022-02-07 09:00:00,135,280,14,10,500,423,77,12
898,2022-02-07 10:00:00,137,299,12,13,564,445,119,11
899,2022-02-07 11:00:00,128,269,12,14,693,604,89,5
900,2022-02-07 12:00:00,131,275,9,10,517,416,101,6
901,2022-02-07 13:00:00,146,277,8,13,670,595,75,11
902,2022-02-07 14:00:00,121,290,10,11,512,412,100,7
903,2022-02-07 15:00:00,130,254,12,12,795,596,199,9
904,2022-02-07 16:00:00,143,267,11,13,604,502,102,10
905,2022-02-07 17:00:00,137,268,8,12,675,485,190,7
906,2022-02-07 18:00:00,134,287,5,12,675,553,122,8
907,2022-02-07 19:00:00,140,272,13,15,656,472,184,13
908,2022-02-07 20:00:00,149,259,9,14,655,466,189,11
909,2022-02-07 21:00:00,137,254,14,14,700,586,114,13
910,2022-02-07 22:00:00,149,257,7,14,547,426,121,7
911,2022-02-07 23:00:00,126,279,12,12,740,597,143,9
912,2022-02-08 00:00:00,133,263,6,19,536,466,70,13
913,2022-02-08 01:00:00,137,252,13,10,584,472,112,14
914,2022-02-08 02:00:00,127,280,6,10,685,523,162,9
915,2022-02-08 03:00:00,124,272,11,15,560,476,84,11
916,2022-02-08 04:00:00,123,275,10,12,581,468,113,12
917,2022-02-08 05:00:00,130,257,13,16,789,676,113,6
918,2022-02-08 06:00:00,142,250,12,13,614,471,143,9
919,2022-02-08 07:00:00,131,279,13,15,632,538,94,5
920,2022-02-08 08:00:00,120,261,7,10,778,558,220,5
921,2022-02-08 09:00:00,120,286,11,12,649,458,191,12
922,2022-02-08 10:00:00,122,283,9,17,778,633,145,8
923,2022-02-08 11:00:00,147,264,10,13,567,483,84,13
924,2022-02-08 12:00:00,147,289,5,13,690,573,117,12
925,2022-02-08 13:00:00,141,269,8,13,753,613,140,11
926,2022-02-08 14:00:00,139,283,12,19,583,423,160,5
927,2022-02-08 15:00:00,127,294,7,10,644,458,186,13
928,2022-02-08 16:00:00,120,290,9,15,544,437,107,10
929,2022-02-08 17:00:00,144,287,13,19,712,640,72,6
930,2022-02-08 18:00:00,134,264,13,15,578,436,142,9
931,2022-02-08 19:00:00,140,276,5,13,683,597,86,7
932,2022-02-08 20:00:00,147,270,7,12,632,446,186,5
933,2022-02-08 21:00:00,126,256,8,11,773,636,137,10
934,2022-02-08 22:00:00,120,284,12,11,500,425,75,8
935,2022-02-08 23:00:00,135,252,6,11,509,383,126,5
936,2022-02-09 00:00:00,120,252,11,12,549,483,66,6
937,2022-02-09 01:00:00,143,253,12,16,654,461,193,8
938,2022-02-09 02:00:00,140,281,12,10,738,548,190,12
939,2022-02-09 03:00:00,136,260,5,18,722,509,213,8
940,2022-02-09 04:00:00,129,298,8,17,596,426,170,14
941,2022-02-09 05:00:00,122,296,8,17,765,628,137,7
942,2022-02-09 06:00:00,120,299,6,19,616,503,113,6
943,2022-02-09 07:00:00,133,271,14,11,752,606,146,10
944,2022-02-09 08:00:00,140,288,10,11,624,515,109,11
945,2022-02-09 09:00:00,124,289,6,10,553,428,125,11
946,2022-02-09 10:00:00,136,288,8,13,620,480,140,7
947,2022-02-09 11:00:00,137,299,8,12,726,618,108,13
948,2022-02-09 12:00:00,147,271,10,14,729,643,86,10
949,2022-02-09 13:00:00,123,291,12,18,625,513,112,8
950,2022-02-09 14:00:00,140,271,14,11,552,436,116,6
951,2022-02-09 15:00:00,129,261,12,15,745,604,141,11
952,2022-02-09 16:00:00,124,278,8,13,524,423,101,11
953,2022-02-09 17:00:00,126,267,12,15,777,560,217,12
954,2022-02-09 18:00:00,148,259,11,18,656,571,85,10
955,2022-02-09 19:00:00,131,251,6,18,619,550,69,14
956,2022-02-09 20:00:00,137,253,7,17,513,409,104,13
957,2022-02-09 21:00:00,133,259,6,19,583,506,77,5
958,2022-02-09 22:00:00,130,254,11,17,536,444,92,6
959,2022-02-09 23:00:00,128,285,12,19,764,625,139,7
960,2022-02-10 00:00:00,123,291,7,14,535,460,75,12
961,2022-02-10 01:00:00,124,280,10,12,786,611,175,14
962,2022-02-10 02:00:00,120,286,13,10,765,589,176,9
963,2022-02-10 03:00:00,123,258,14,11,781,663,118,10
964,2022-02-10 04:00:00,123,290,13,14,549,407,142,9
965,2022-02-10 05:00:00,128,289,5,11,588,474,114,12
966,2022-02-10 06:00:00,124,283,5,12,706,510,196,10
967,2022-02-10 07:00:00,122,293,6,12,627,493,134,10
968,2022-02-10 08:00:00,143,274,9,17,658,471,187,7
969,2022-02-10 09:00:00,148,263,14,12,536,401,135,6
970,2022-02-10 10:00:00,135,295,9,14,668,567,101,8
971,2022-02-10 11:00:00,149,259,10,13,511,420,91,6
972,2022-02-10 12:00:00,130,256,9,16,614,518,96,11
973,2022-02-10 13:00:00,144,261,14,17,745,556,189,12
974,2022-02-10 14:00:00,138,293,10,16,637,501,136,14
975,2022-02-10 15:00:00,133,270,13,15,591,529,62,11
976,2022-02-10 16:00:00,146,261,5,18,601,509,92,13
977,2022-02-10 17:00:00,120,289,9,14,696,538,158,6
978,2022-02-10 18:00:00,130,299,7,15,650,473,177,10
979,2022-02-10 19:00:00,124,280,8,11,662,488,174,10
980,2022-02-10 20:00:00,132,291,9,13,553,418,135,5
981,2022-02-10 21:00:00,120,253,14,13,703,627,76,9
982,2022-02-10 22:00:00,134,277,5,13,788,570,218,10
983,2022-02-10 23:00:00,131,262,9,17,797,639,158,11
984,2022-02-11 00:00:00,149,284,14,14,705,579,126,5
985,2022-02-11 01:00:00,146,280,12,10,600,535,65,13
986,2022-02-11 02:00:00,149,257,10,11,525,437,88,12
987,2022-02-11 03:00:00,120,298,9,19,580,480,100,14
988,2022-02-11 04:00:00,137,286,10,13,778,620,158,14
989,2022-02-11 05:00:00,136,277,10,17,731,574,157,7
990,2022-02-11 06:00:00,147,283,13,13,539,390,149,6
991,2022-02-11 07:00:00,139,288,14,19,606,479,127,9
992,2022-02-11 08:00:00,140,278,6,15,719,510,209,6
993,2022-02-11 09:00:00,122,251,6,17,527,436,91,14
994,2022-02-11 10:00:00,143,266,7,18,540,425,115,11
995,2022-02-11 11:00:00,132,286,9,13,774,548,226,9
996,2022-02-11 12:00:00,138,276,6,17,515,378,137,10
997,2022-02-11 13:00:00,126,264,11,11,697,617,80,7
998,2022-02-11 14:00:00,128,271,8,19,521,406,115,11
999,2022-02-11 15:00:00,132,293,12,19,714,517,197,7
1000,2022-02-11 16:00:00,149,293,7,13,547,415,132,11
1001,2022-02-11 17:00:00,146,269,13,12,503,382,121,10
1002,2022-02-11 18:00:00,143,295,8,11,731,521,210,10
1003,2022-02-11 19:00:00,133,292,10,15,717,591,126,7
1004,2022-02-11 20:00:00,140,288,6,16,518,452,66,6
1005,2022-02-11 21:00:00,122,277,9,10,727,517,210,10
1006,2022-02-11 22:00:00,130,277,11,16,732,557,175,7
1007,2022-02-11 23:00:00,145,271,9,14,758,670,88,13
1008,2022-02-12 00:00:00,138,276,12,10,516,398,118,11
1009,2022-02-12 01:00:00,127,269,10,16,592,492,100,12
1010,2022-02-12 02:00:00,144,281,6,11,691,486,205,8
1011,2022-02-12 03:00:00,143,285,12,17,736,601,135,7
1012,2022-02-12 04:00:00,137,261,11,12,764,561,203,12
1013,2022-02-12 05:00:00,120,277,14,19,666,490,176,13
1014,2022-02-12 06:00:00,143,261,12,11,524,415,109,10
1015,2022-02-12 07:00:00,129,252,11,18,597,428,169,6
1016,2022-02-12 08:00:00,125,256,13,18,641,530,111,10
1017,2022-02-12 09:00:00,120,251,12,16,724,568,156,13
1018,2022-02-12 10:00:00,147,269,13,19,711,516,195,11
1019,2022-02-12 11:00:00,128,283,5,19,597,506,91,6
1020,2022-02-12 12:00:00,137,294,7,17,667,487,180,14
1021,2022-02-12 13:00:00,149,254,14,14,777,679,98,7
1022,2022-02-12 14:00:00,120,255,7,12,507,384,123,5
1023,2022-02-12 15:00:00,133,275,14,18,756,532,224,5
1024,2022-02-12 16:00:00,123,293,10,14,720,515,205,6
1025,2022-02-12 17:00:00,149,259,10,16,513,414,99,7
1026,2022-02-12 18:00:00,149,278,9,12,632,543,89,14
1027,2022-02-12 19:00:00,145,263,10,19,650,571,79,14
1028,2022-02-12 20:00:00,122,280,9,16,646,541,105,12
1029,2022-02-12 21:00:00,142,250,13,18,712,515,197,6
1030,2022-02-12 22:00:00,136,283,5,17,651,497,154,11
1031,2022-02-12 23:00:00,133,272,12,17,774,615,159,14
1032,2022-02-13 00:00:00,148,296,8,13,531,394,137,12
1033,2022-02-13 01:00:00,130,266,5,11,619,468,151,5
1034,2022-02-13 02:00:00,143,295,6,16,529,383,146,5
1035,2022-02-13 03:00:00,132,262,7,13,585,417,168,11
1036,2022-02-13 04:00:00,148,262,11,12,751,529,222,13
1037,2022-02-13 05:00:00,132,267,10,17,664,565,99,6
1038,2022-02-13 06:00:00,131,273,5,18,609,495,114,14
1039,2022-02-13 07:00:00,128,263,10,18,785,630,155,7
1040,2022-02-13 08:00:00,133,296,12,11,605,439,166,12
1041,2022-02-13 09:00:00,133,282,10,14,626,447,179,11
1042,2022-02-13 10:00:00,128,261,6,18,565,474,91,9
1043,2022-02-13 11:00:00,128,297,8,12,599,445,154,9
1044,2022-02-13 12:00:00,123,256,7,18,613,540,73,9
1045,2022-02-13 13:00:00,135,260,10,16,571,489,82,7
1046,2022-02-13 14:00:00,121,272,14,18,596,470,126,5
1047,2022-02-13 15:00:00,142,298,14,15,576,418,158,12
1048,2022-02-13 16:00:00,124,255,14,14,662,542,120,11
1049,2022-02-13 17:00:00,146,276,10,13,691,609,82,13
1050,2022-02-13 18:00:00,144,270,6,14,665,540,125,9
1051,2022-02-13 19:00:00,139,272,6,18,538,484,54,14
1052,2022-02-13 20:00:00,140,273,13,18,713,509,204,9
1053,2022-02-13 21:00:00,146,296,10,13,776,618,158,7
1054,2022-02-13 22:00:00,141,297,13,19,505,403,102,12
1055,2022-02-13 23:00:00,128,275,5,18,719,641,78,8
1056,2022-02-14 00:00:00,143,267,9,14,642,505,137,11
1057,2022-02-14 01:00:00,139,284,12,18,505,395,110,10
1058,2022-02-14 02:00:00,142,266,5,12,618,475,143,7
1059,2022-02-14 03:00:00,123,266,10,12,726,577,149,14
1060,2022-02-14 04:00:00,144,279,5,13,766,673,93,8
1061,2022-02-14 05:00:00,136,271,7,18,676,483,193,7
1062,2022-02-14 06:00:00,131,278,14,11,732,563,169,12
1063,2022-02-14 07:00:00,136,285,10,12,591,421,170,10
1064,2022-02-14 08:00:00,122,271,8,11,580,438,142,8
1065,2022-02-14 09:00:00,126,267,14,18,544,393,151,14
1066,2022-02-14 10:00:00,141,297,10,15,680,554,126,5
1067,2022-02-14 11:00:00,146,265,14,18,600,424,176,13
1068,2022-02-14 12:00:00,138,293,10,19,604,465,139,5
1069,2022-02-14 13:00:00,120,262,6,17,541,441,100,14
1070,2022-02-14 14:00:00,132,251,8,15,577,412,165,11
1071,2022-02-14 15:00:00,123,257,9,18,507,421,86,6
1072,2022-02-14 16:00:00,128,288,9,19,501,409,92,5
1073,2022-02-14 17:00:00,147,294,5,17,554,434,120,12
1074,2022-02-14 18:00:00,130,251,5,17,538,417,121,13
1075,2022-02-14 19:00:00,126,281,5,18,555,490,65,10
1076,2022-02-14 20:00:00,141,263,9,16,776,694,82,12
1077,2022-02-14 21:00:00,133,299,11,12,709,509,200,13
1078,2022-02-14 22:00:00,143,287,5,12,567,470,97,12
1079,2022-02-14 23:00:00,143,279,7,19,517,389,128,5
1080,2022-02-15 00:00:00,146,260,5,12,611,474,137,5
1081,2022-02-15 01:00:00,144,269,8,17,751,589,162,6
1082,2022-02-15 02:00:00,120,272,12,13,623,537,86,13
1083,2022-02-15 03:00:00,136,259,13,14,792,589,203,7
1084,2022-02-15 04:00:00,138,283,12,10,791,663,128,8
1085,2022-02-15 05:00:00,147,281,5,13,558,492,66,13
1086,2022-02-15 06:00:00,149,284,9,13,589,447,142,10
1087,2022-02-15 07:00:00,142,250,9,19,654,538,116,10
1088,2022-02-15 08:00:00,128,273,7,15,625,440,185,10
1089,2022-02-15 09:00:00,130,267,10,16,524,421,103,8
1090,2022-02-15 10:00:00,131,274,6,13,735,521,214,10
1091,2022-02-15 11:00:00,142,295,5,10,516,426,90,14
1092,2022-02-15 12:00:00,147,270,12,10,560,429,131,12
1093,2022-02-15 13:00:00,133,257,5,17,784,677,107,10
1094,2022-02-15 14:00:00,136,286,12,13,558,492,66,9
1095,2022-02-15 15:00:00,137,288,8,10,751,611,140,11
1096,2022-02-15 16:00:00,126,269,10,12,704,524,180,10
1097,2022-02-15 17:00:00,123,285,12,13,626,555,71,13
1098,2022-02-15 18:00:00,129,284,14,14,703,494,209,13
1099,2022-02-15 19:00:00,120,256,9,19,779,688,91,8
1100,2022-02-15 20:00:00,136,287,8,13,547,387,160,9
1101,2022-02-15 21:00:00,144,258,11,15,564,410,154,8
1102,2022-02-15 22:00:00,149,272,11,10,701,584,117,5
1103,2022-02-15 23:00:00,133,277,8,18,736,599,137,12
1104,2022-02-16 00:00:00,144,294,14,12,757,605,152,12
1105,2022-02-16 01:00:00,143,259,11,16,587,471,116,11
1106,2022-02-16 02:00:00,139,261,5,13,672,490,182,6
1107,2022-02-16 03:00:00,123,263,12,13,732,632,100,11
1108,2022-02-16 04:00:00,128,275,12,13,764,585,179,8
1109,2022-02-16 05:00:00,141,270,10,13,611,504,107,12
1110,2022-02-16 06:00:00,145,285,10,10,546,441,105,9
1111,2022-02-16 07:00:00,130,257,9,12,705,597,108,11
1112,2022-02-16 08:00:00,142,294,12,11,686,531,155,7
1113,2022-02-16 09:00:00,127,284,11,19,592,415,177,5
1114,2022-02-16 10:00:00,129,295,10,13,592,479,113,12
1115,2022-02-16 11:00:00,120,291,6,15,528,426,102,14
1116,2022-02-16 12:00:00,128,281,7,19,774,572,202,11
1117,2022-02-16 13:00:00,148,286,7,12,738,545,193,12
1118,2022-02-16 14:00:00,147,279,12,17,578,500,78,6
1119,2022-02-16 15:00:00,120,292,12,18,544,472,72,12
1120,2022-02-16 16:00:00,124,253,5,15,532,463,69,8
1121,2022-02-16 17:00:00,147,260,7,16,750,614,136,13
1122,2022-02-16 18:00:00,149,283,12,15,699,508,191,14
1123,2022-02-16 19:00:00,146,278,9,16,748,524,224,13
1124,2022-02-16 20:00:00,135,260,10,12,677,512,165,9
1125,2022-02-16 21:00:00,125,272,8,10,574,476,98,13
1126,2022-02-16 22:00:00,148,279,5,14,786,630,156,10
1127,2022-02-16 23:00:00,123,269,10,10,631,562,69,13
1128,2022-02-17 00:00:00,132,294,8,13,617,447,170,14
1129,2022-02-17 01:00:00,126,259,10,13,697,546,151,9
1130,2022-02-17 02:00:00,123,280,13,18,630,451,179,14
1131,2022-02-17 03:00:00,129,277,8,17,736,592,144,11
1132,2022-02-17 04:00:00,144,299,5,10,567,463,104,5
1133,2022-02-17 05:00:00,137,271,13,15,788,659,129,13
1134,2022-02-17 06:00:00,124,268,13,11,679,603,76,5
1135,2022-02-17 07:00:00,122,250,9,14,500,427,73,12
1136,2022-02-17 08:00:00,143,282,12,10,666,589,77,5
1137,2022-02-17 09:00:00,126,292,13,18,509,445,64,13
1138,2022-02-17 10:00:00,128,279,9,13,682,490,192,12
1139,2022-02-17 11:00:00,143,274,13,14,727,529,198,9
1140,2022-02-17 12:00:00,144,291,11,12,741,561,180,6
1141,2022-02-17 13:00:00,146,277,8,16,798,567,231,10
1142,2022-02-17 14:00:00,120,287,6,17,771,565,206,14
1143,2022-02-17 15:00:00,129,285,12,19,559,471,88,10
1144,2022-02-17 16:00:00,143,264,10,18,554,448,106,12
1145,2022-02-17 17:00:00,121,290,13,18,765,563,202,8
1146,2022-02-17 18:00:00,148,294,11,13,544,423,121,11
1147,2022-02-17 19:00:00,120,294,9,19,755,617,138,11
1148,2022-02-17 20:00:00,128,297,11,14,751,647,104,12
1149,2022-02-17 21:00:00,122,257,6,10,765,667,98,9
1150,2022-02-17 22:00:00,130,250,12,10,789,705,84,10
1151,2022-02-17 23:00:00,134,250,5,15,643,521,122,5
1152,2022-02-18 00:00:00,140,284,12,11,509,403,106,8
1153,2022-02-18 01:00:00,141,283,5,13,689,485,204,6
1154,2022-02-18 02:00:00,142,261,7,10,508,441,67,7
1155,2022-02-18 03:00:00,135,298,7,10,581,499,82,8
1156,2022-02-18 04:00:00,142,253,7,19,638,447,191,8
1157,2022-02-18 05:00:00,123,265,5,16,641,478,163,9
1158,2022-02-18 06:00:00,142,270,10,11,618,450,168,6
1159,2022-02-18 07:00:00,144,278,7,12,587,411,176,5
1160,2022-02-18 08:00:00,136,294,5,11,602,501,101,14
1161,2022-02-18 09:00:00,122,263,5,10,667,548,119,14
1162,2022-02-18 10:00:00,148,269,11,13,610,523,87,7
1163,2022-02-18 11:00:00,130,292,12,17,504,427,77,7
1164,2022-02-18 12:00:00,130,267,13,15,698,519,179,7
1165,2022-02-18 13:00:00,131,268,5,16,788,658,130,6
1166,2022-02-18 14:00:00,120,279,12,12,711,561,150,7
1167,2022-02-18 15:00:00,139,259,5,16,710,577,133,6
1168,2022-02-18 16:00:00,126,254,13,13,622,467,155,12
1169,2022-02-18 17:00:00,126,292,11,13,612,526,86,11
1170,2022-02-18 18:00:00,122,290,5,11,713,512,201,11
1171,2022-02-18 19:00:00,129,251,13,15,793,652,141,8
1172,2022-02-18 20:00:00,139,293,9,12,560,457,103,6
1173,2022-02-18 21:00:00,127,276,5,10,503,438,65,9
1174,2022-02-18 22:00:00,140,254,13,10,694,584,110,10
1175,2022-02-18 23:00:00,149,283,6,16,662,520,142,6
1176,2022-02-19 00:00:00,125,263,8,15,587,450,137,8
1177,2022-02-19 01:00:00,137,295,11,19,799,682,117,11
1178,2022-02-19 02:00:00,130,299,13,17,688,515,173,13
1179,2022-02-19 03:00:00,121,278,6,12,775,634,141,8
1180,2022-02-19 04:00:00,125,254,8,14,602,476,126,8
1181,2022-02-19 05:00:00,128,290,13,18,528,420,108,11
1182,2022-02-19 06:00:00,141,297,5,10,520,402,118,6
1183,2022-02-19 07:00:00,130,275,7,10,754,577,177,9
1184,2022-02-19 08:00:00,137,293,14,15,617,526,91,14
1185,2022-02-19 09:00:00,125,292,6,16,546,481,65,11
1186,2022-02-19 10:00:00,145,268,9,17,741,632,109,10
1187,2022-02-19 11:00:00,133,272,12,15,603,522,81,9
1188,2022-02-19 12:00:00,121,261,7,18,714,604,110,10
1189,2022-02-19 13:00:00,136,284,10,11,738,523,215,8
1190,2022-02-19 14:00:00,136,291,9,14,649,457,192,13
1191,2022-02-19 15:00:00,129,271,9,17,665,575,90,9
1192,2022-02-19 16:00:00,121,284,7,10,604,459,145,14
1193,2022-02-19 17:00:00,141,264,10,11,797,696,101,7
1194,2022-02-19 18:00:00,143,281,5,16,740,592,148,6
1195,2022-02-19 19:00:00,125,298,7,15,581,448,133,8
1196,2022-02-19 20:00:00,132,298,7,14,687,560,127,10
1197,2022-02-19 21:00:00,139,294,5,19,781,668,113,10
1198,2022-02-19 22:00:00,132,279,7,15,672,543,129,14
1199,2022-02-19 23:00:00,120,259,13,17,674,502,172,5
1200,2022-02-20 00:00:00,144,284,5,16,578,477,101,9
1201,2022-02-20 01:00:00,143,299,12,10,785,628,157,10
1202,2022-02-20 02:00:00,121,277,13,14,710,519,191,7
1203,2022-02-20 03:00:00,122,281,8,16,773,631,142,9
1204,2022-02-20 04:00:00,125,278,10,10,746,661,85,7
1205,2022-02-20 05:00:00,125,293,5,19,569,430,139,8
1206,2022-02-20 06:00:00,142,258,13,13,768,588,180,14
1207,2022-02-20 07:00:00,149,251,12,15,723,633,90,9
1208,2022-02-20 08:00:00,122,265,10,17,548,408,140,11
1209,2022-02-20 09:00:00,131,263,14,18,528,446,82,9
1210,2022-02-20 10:00:00,129,289,10,13,760,649,111,7
1211,2022-02-20 11:00:00,137,288,10,19,737,558,179,14
1212,2022-02-20 12:00:00,134,292,8,19,700,601,99,11
1213,2022-02-20 13:00:00,136,266,5,10,515,408,107,9
1214,2022-02-20 14:00:00,137,263,8,15,771,587,184,12
1215,2022-02-20 15:00:00,121,272,7,17,613,475,138,14
1216,2022-02-20 16:00:00,128,294,10,11,749,591,158,13
1217,2022-02-20 17:00:00,136,289,13,19,504,427,77,9
1218,2022-02-20 18:00:00,144,262,6,17,653,463,190,5
1219,2022-02-20 19:00:00,120,289,11,12,668,568,100,12
1220,2022-02-20 20:00:00,142,297,11,17,532,378,154,6
1221,2022-02-20 21:00:00,148,268,7,18,690,581,109,10
1222,2022-02-20 22:00:00,137,252,11,19,500,365,135,10
1223,2022-02-20 23:00:00,146,274,8,14,615,448,167,14
1224,2022-02-21 00:00:00,129,292,7,15,619,547,72,13
1225,2022-02-21 01:00:00,120,296,12,16,509,399,110,5
1226,2022-02-21 02:00:00,143,269,6,19,614,494,120,11
1227,2022-02-21 03:00:00,120,283,12,16,540,457,83,10
1228,2022-02-21 04:00:00,149,276,14,10,754,670,84,11
1229,2022-02-21 05:00:00,147,260,12,19,690,575,115,7
1230,2022-02-21 06:00:00,136,258,11,16,789,604,185,12
1231,2022-02-21 07:00:00,140,264,11,15,514,398,116,6
1232,2022-02-21 08:00:00,148,277,12,16,784,625,159,11
1233,2022-02-21 09:00:00,127,263,12,15,589,488,101,10
1234,2022-02-21 10:00:00,146,257,6,19,622,549,73,10
1235,2022-02-21 11:00:00,126,260,5,18,548,418,130,12
1236,2022-02-21 12:00:00,121,282,9,13,579,442,137,10
1237,2022-02-21 13:00:00,143,282,5,15,507,382,125,6
1238,2022-02-21 14:00:00,121,294,10,14,769,576,193,5
1239,2022-02-21 15:00:00,138,264,14,15,541,378,163,11
1240,2022-02-21 16:00:00,128,275,5,16,737,559,178,13
1241,2022-02-21 17:00:00,133,293,6,15,548,484,64,14
1242,2022-02-21 18:00:00,135,276,14,19,694,621,73,12
1243,2022-02-21 19:00:00,130,286,14,16,592,523,69,12
1244,2022-02-21 20:00:00,126,258,11,18,526,400,126,14
1245,2022-02-21 21:00:00,149,282,11,18,561,453,108,8
1246,2022-02-21 22:00:00,146,267,6,16,608,527,81,7
1247,2022-02-21 23:00:00,149,280,13,17,742,581,161,12
1248,2022-02-22 00:00:00,146,293,10,18,628,452,176,10
1249,2022-02-22 01:00:00,132,250,11,14,566,424,142,8
1250,2022-02-22 02:00:00,130,267,10,16,500,378,122,7
1251,2022-02-22 03:00:00,147,276,7,17,676,561,115,11
1252,2022-02-22 04:00:00,129,274,10,17,553,448,105,12
1253,2022-02-22 05:00:00,135,281,13,14,680,487,193,7
1254,2022-02-22 06:00:00,130,285,7,11,636,532,104,9
1255,2022-02-22 07:00:00,141,265,7,19,728,612,116,14
1256,2022-02-22 08:00:00,142,270,10,12,506,430,76,6
1257,2022-02-22 09:00:00,142,286,5,10,650,490,160,9
1258,2022-02-22 10:00:00,124,261,6,18,576,453,123,8
1259,2022-02-22 11:00:00,142,270,7,16,563,433,130,12
1260,2022-02-22 12:00:00,141,281,13,18,693,581,112,13
1261,2022-02-22 13:00:00,126,299,10,15,705,566,139,5
1262,2022-02-22 14:00:00,131,285,7,10,506,430,76,8
1263,2022-02-22 15:00:00,148,282,12,11,623,480,143,7
1264,2022-02-22 16:00:00,124,276,12,15,621,494,127,9
1265,2022-02-22 17:00:00,123,286,6,11,534,410,124,8
1266,2022-02-22 18:00:00,123,271,13,13,648,517,131,14
1267,2022-02-22 19:00:00,134,295,14,15,758,584,174,5
1268,2022-02-22 20:00:00,142,283,9,19,679,560,119,12
1269,2022-02-22 21:00:00,136,281,6,15,646,573,73,10
1270,2022-02-22 22:00:00,133,298,11,11,791,686,105,13
1271,2022-02-22 23:00:00,149,258,5,13,655,538,117,12
1272,2022-02-23 00:00:00,145,263,5,19,553,399,154,12
1273,2022-02-23 01:00:00,125,252,10,14,623,471,152,9
1274,2022-02-23 02:00:00,123,262,5,12,557,459,98,7
1275,2022-02-23 03:00:00,141,253,6,18,662,464,198,8
1276,2022-02-23 04:00:00,126,297,7,13,712,612,100,5
1277,2022-02-23 05:00:00,144,298,9,12,589,433,156,8
1278,2022-02-23 06:00:00,143,278,7,18,542,406,136,6
1279,2022-02-23 07:00:00,145,263,14,16,544,385,159,5
1280,2022-02-23 08:00:00,148,254,7,17,758,561,197,13
1281,2022-02-23 09:00:00,134,260,6,15,611,459,152,13
1282,2022-02-23 10:00:00,142,294,11,15,610,444,166,9
1283,2022-02-23 11:00:00,134,255,6,10,637,463,174,5
1284,2022-02-23 12:00:00,131,294,8,11,765,538,227,10
1285,2022-02-23 13:00:00,127,286,9,14,628,486,142,9
1286,2022-02-23 14:00:00,128,289,11,12,731,655,76,14
1287,2022-02-23 15:00:00,131,292,6,12,616,524,92,10
1288,2022-02-23 16:00:00,132,279,7,11,618,531,87,5
1289,2022-02-23 17:00:00,125,282,13,13,750,568,182,7
1290,2022-02-23 18:00:00,129,287,8,15,527,454,73,7
1291,2022-02-23 19:00:00,133,250,9,10,638,498,140,13
1292,2022-02-23 20:00:00,136,277,12,13,698,552,146,14
1293,2022-02-23 21:00:00,144,256,9,11,617,505,112,9
1294,2022-02-23 22:00:00,123,264,10,16,632,507,125,10
1295,2022-02-23 23:00:00,145,275,11,19,757,644,113,9
1296,2022-02-24 00:00:00,130,255,9,19,625,547,78,6
1297,2022-02-24 01:00:00,147,274,8,10,556,439,117,9
1298,2022-02-24 02:00:00,124,289,14,12,716,605,111,13
1299,2022-02-24 03:00:00,127,270,7,17,712,514,198,5
1300,2022-02-24 04:00:00,127,265,5,18,671,558,113,9
1301,2022-02-24 05:00:00,132,260,12,15,580,435,145,14
1302,2022-02-24 06:00:00,136,254,10,15,632,516,116,14
1303,2022-02-24 07:00:00,140,289,5,15,770,545,225,14
1304,2022-02-24 08:00:00,129,267,5,15,743,639,104,10
1305,2022-02-24 09:00:00,140,285,11,13,687,564,123,13
1306,2022-02-24 10:00:00,128,292,14,10,661,560,101,7
1307,2022-02-24 11:00:00,125,265,14,18,560,498,62,5
1308,2022-02-24 12:00:00,140,251,10,13,637,525,112,9
1309,2022-02-24 13:00:00,144,293,12,15,762,620,142,9
1310,2022-02-24 14:00:00,143,299,13,19,700,522,178,11
1311,2022-02-24 15:00:00,137,282,12,11,688,569,119,5
1312,2022-02-24 16:00:00,131,299,12,14,796,575,221,11
1313,2022-02-24 17:00:00,125,257,13,11,660,558,102,8
1314,2022-02-24 18:00:00,136,295,11,16,729,632,97,10
1315,2022-02-24 19:00:00,121,296,7,19,568,475,93,12
1316,2022-02-24 20:00:00,148,293,13,10,770,660,110,10
1317,2022-02-24 21:00:00,137,297,7,16,797,623,174,6
1318,2022-02-24 22:00:00,146,251,11,15,757,653,104,11
1319,2022-02-24 23:00:00,133,254,7,13,779,546,233,5
1320,2022-02-25 00:00:00,148,269,11,12,631,474,157,12
1321,2022-02-25 01:00:00,143,265,11,13,773,619,154,9
1322,2022-02-25 02:00:00,135,297,12,16,547,445,102,7
1323,2022-02-25 03:00:00,121,271,9,14,769,543,226,11
1324,2022-02-25 04:00:00,137,272,7,15,609,514,95,8
1325,2022-02-25 05:00:00,120,268,13,13,798,665,133,7
1326,2022-02-25 06:00:00,129,298,6,14,630,556,74,7
1327,2022-02-25 07:00:00,137,271,5,18,644,528,116,11
1328,2022-02-25 08:00:00,133,263,12,10,767,609,158,14
1329,2022-02-25 09:00:00,146,266,10,16,558,486,72,12
1330,2022-02-25 10:00:00,131,274,8,13,577,445,132,12
1331,2022-02-25 11:00:00,125,266,14,16,768,573,195,11
1332,2022-02-25 12:00:00,123,278,8,11,722,573,149,10
1333,2022-02-25 13:00:00,127,275,12,11,702,573,129,8
1334,2022-02-25 14:00:00,144,252,7,12,709,504,205,5
1335,2022-02-25 15:00:00,130,266,9,18,769,670,99,12
1336,2022-02-25 16:00:00,132,251,13,16,687,541,146,14
1337,2022-02-25 17:00:00,145,273,14,13,762,555,207,5
1338,2022-02-25 18:00:00,129,297,11,14,641,505,136,5
1339,2022-02-25 19:00:00,137,292,6,11,754,557,197,12
1340,2022-02-25 20:00:00,129,284,5,19,512,400,112,5
1341,2022-02-25 21:00:00,140,252,7,10,572,474,98,14
1342,2022-02-25 22:00:00,141,270,10,19,596,472,124,8
1343,2022-02-25 23:00:00,148,279,7,19,511,447,64,5
1344,2022-02-26 00:00:00,146,298,14,18,573,414,159,5
1345,2022-02-26 01:00:00,143,281,10,12,727,582,145,12
1346,2022-02-26 02:00:00,132,274,9,10,639,564,75,7
1347,2022-02-26 03:00:00,128,279,13,19,630,559,71,7
1348,2022-02-26 04:00:00,135,259,12,10,616,467,149,10
1349,2022-02-26 05:00:00,124,287,6,12,751,640,111,7
1350,2022-02-26 06:00:00,144,260,9,18,693,583,110,11
1351,2022-02-26 07:00:00,120,262,10,16,550,492,58,7
1352,2022-02-26 08:00:00,138,293,8,15,704,515,189,13
1353,2022-02-26 09:00:00,141,286,6,12,708,521,187,6
1354,2022-02-26 10:00:00,145,285,9,13,696,497,199,5
1355,2022-02-26 11:00:00,148,277,11,15,676,542,134,6
1356,2022-02-26 12:00:00,142,263,12,10,691,611,80,6
1357,2022-02-26 13:00:00,145,281,13,16,536,477,59,9
1358,2022-02-26 14:00:00,130,285,12,15,682,599,83,10
1359,2022-02-26 15:00:00,142,263,8,18,790,696,94,6
1360,2022-02-26 16:00:00,147,254,8,13,693,511,182,10
1361,2022-02-26 17:00:00,147,270,12,12,795,707,88,12
1362,2022-02-26 18:00:00,138,257,9,17,595,441,154,6
1363,2022-02-26 19:00:00,148,297,9,11,718,561,157,10
1364,2022-02-26 20:00:00,137,292,13,10,530,455,75,13
1365,2022-02-26 21:00:00,136,256,12,14,761,589,172,7
1366,2022-02-26 22:00:00,125,261,11,16,562,415,147,11
1367,2022-02-26 23:00:00,141,256,8,19,721,553,168,13
1368,2022-02-27 00:00:00,127,270,7,13,774,558,216,10
1369,2022-02-27 01:00:00,147,298,11,11,761,605,156,8
1370,2022-02-27 02:00:00,137,258,9,11,595,505,90,8
1371,2022-02-27 03:00:00,134,257,11,19,692,529,163,6
1372,2022-02-27 04:00:00,130,252,14,12,534,420,114,11
1373,2022-02-27 05:00:00,131,275,12,12,556,406,150,14
1374,2022-02-27 06:00:00,138,293,9,14,693,507,186,11
1375,2022-02-27 07:00:00,143,264,12,10,689,517,172,8
1376,2022-02-27 08:00:00,123,287,11,10,623,521,102,11
1377,2022-02-27 09:00:00,126,252,12,17,720,601,119,9
1378,2022-02-27 10:00:00,144,256,5,13,758,671,87,8
1379,2022-02-27 11:00:00,129,272,10,11,795,590,205,8
1380,2022-02-27 12:00:00,140,261,6,11,741,573,168,7
1381,2022-02-27 13:00:00,142,272,7,15,594,428,166,14
1382,2022-02-27 14:00:00,138,256,11,17,579,506,73,7
1383,2022-02-27 15:00:00,141,250,5,19,526,450,76,10
1384,2022-02-27 16:00:00,126,265,9,14,597,424,173,13
1385,2022-02-27 17:00:00,131,296,6,19,571,419,152,9
1386,2022-02-27 18:00:00,149,259,6,17,716,502,214,14
1387,2022-02-27 19:00:00,124,268,12,16,616,479,137,6
1388,2022-02-27 20:00:00,127,265,11,18,747,661,86,12
1389,2022-02-27 21:00:00,124,281,13,19,548,418,130,5
1390,2022-02-27 22:00:00,120,258,8,12,586,523,63,5
1391,2022-02-27 23:00:00,136,293,5,13,710,544,166,5
1392,2022-02-28 00:00:00,146,251,14,12,589,495,94,6
1393,2022-02-28 01:00:00,123,269,8,16,670,484,186,13
1394,2022-02-28 02:00:00,138,281,12,17,768,556,212,6
1395,2022-02-28 03:00:00,121,291,12,15,517,375,142,13
1396,2022-02-28 04:00:00,139,277,14,11,571,449,122,5
1397,2022-02-28 05:00:00,136,296,6,12,620,440,180,12
1398,2022-02-28 06:00:00,130,286,11,18,715,618,97,8
1399,2022-02-28 07:00:00,137,262,10,19,530,390,140,8
1400,2022-02-28 08:00:00,127,298,8,11,723,638,85,12
1401,2022-02-28 09:00:00,149,273,10,12,676,592,84,7
1402,2022-02-28 10:00:00,134,271,10,11,607,468,139,13
1403,2022-02-28 11:00:00,126,251,8,10,546,430,116,11
1404,2022-02-28 12:00:00,145,263,8,18,573,452,121,12
1405,2022-02-28 13:00:00,127,269,6,11,691,580,111,11
1406,2022-02-28 14:00:00,140,281,12,18,616,443,173,6
1407,2022-02-28 15:00:00,135,290,8,17,665,508,157,7
1408,2022-02-28 16:00:00,144,267,12,17,606,518,88,9
1409,2022-02-28 17:00:00,139,283,6,13,552,471,81,13
1410,2022-02-28 18:00:00,143,270,8,18,723,536,187,5
1411,2022-02-28 19:00:00,133,285,5,13,699,574,125,14
1412,2022-02-28 20:00:00,122,297,12,16,784,660,124,5
1413,2022-02-28 21:00:00,145,260,7,17,704,538,166,12
1414,2022-02-28 22:00:00,120,274,7,17,720,533,187,12
1415,2022-02-28 23:00:00,137,285,12,16,728,518,210,12
1416,2022-03-01 00:00:00,138,251,9,16,735,610,125,9
1417,2022-03-01 01:00:00,135,290,10,12,757,563,194,5
1418,2022-03-01 02:00:00,141,260,8,10,500,401,99,13
1419,2022-03-01 03:00:00,141,288,12,19,691,537,154,8
1420,2022-03-01 04:00:00,128,257,7,17,562,452,110,9
1421,2022-03-01 05:00:00,123,297,12,14,705,623,82,14
1422,2022-03-01 06:00:00,132,282,14,11,689,525,164,9
1423,2022-03-01 07:00:00,135,267,12,15,543,396,147,10
1424,2022-03-01 08:00:00,139,271,5,19,543,462,81,8
1425,2022-03-01 09:00:00,145,270,6,11,545,411,134,7
1426,2022-03-01 10:00:00,130,277,9,13,568,470,98,10
1427,2022-03-01 11:00:00,127,276,6,10,774,673,101,6
1428,2022-03-01 12:00:00,124,294,7,16,617,544,73,5
1429,2022-03-01 13:00:00,140,294,7,14,734,635,99,10
1430,2022-03-01 14:00:00,137,261,13,13,681,602,79,12
1431,2022-03-01 15:00:00,136,250,5,10,554,452,102,10
1432,2022-03-01 16:00:00,142,296,8,18,703,501,202,8
1433,2022-03-01 17:00:00,138,267,14,11,516,373,143,12
1434,2022-03-01 18:00:00,139,284,7,15,759,586,173,6
1435,2022-03-01 19:00:00,124,284,9,18,753,607,146,12
1436,2022-03-01 20:00:00,141,297,6,16,619,486,133,11
1437,2022-03-01 21:00:00,138,268,7,14,501,361,140,12
1438,2022-03-01 22:00:00,143,254,8,19,788,613,175,6
1439,2022-03-01 23:00:00,123,281,14,19,575,467,108,11
1440,2022-03-02 00:00:00,143,255,12,10,694,559,135,9
1441,2022-03-02 01:00:00,122,280,7,19,661,572,89,7
1442,2022-03-02 02:00:00,137,278,14,17,512,377,135,11
1443,2022-03-02 03:00:00,134,296,6,13,746,638,108,10
1444,2022-03-02 04:00:00,127,298,11,19,723,625,98,12
1445,2022-03-02 05:00:00,133,264,7,16,639,541,98,5
1446,2022-03-02 06:00:00,141,290,12,14,640,541,99,12
1447,2022-03-02 07:00:00,135,274,8,13,548,490,58,13
1448,2022-03-02 08:00:00,139,296,9,18,743,622,121,8
1449,2022-03-02 09:00:00,125,285,7,10,730,532,198,6
1450,2022-03-02 10:00:00,138,294,9,11,687,610,77,7
1451,2022-03-02 11:00:00,121,255,8,17,788,660,128,5
1452,2022-03-02 12:00:00,138,271,10,15,776,591,185,9
1453,2022-03-02 13:00:00,132,261,12,17,586,469,117,14
1454,2022-03-02 14:00:00,134,274,5,11,779,665,114,10
1455,2022-03-02 15:00:00,149,279,6,17,584,470,114,14
1456,2022-03-02 16:00:00,132,270,6,15,512,418,94,8
1457,2022-03-02 17:00:00,128,255,9,12,609,432,177,9
1458,2022-03-02 18:00:00,137,297,14,11,697,573,124,8
1459,2022-03-02 19:00:00,122,294,10,13,687,518,169,8
1460,2022-03-02 20:00:00,129,293,6,13,577,460,117,8
1461,2022-03-02 21:00:00,138,280,7,11,723,634,89,7
1462,2022-03-02 22:00:00,129,257,13,13,638,465,173,12
1463,2022-03-02 23:00:00,137,258,11,14,767,651,116,12
1464,2022-03-03 00:00:00,132,293,5,17,767,659,108,8
1465,2022-03-03 01:00:00,132,284,11,14,785,696,89,13
1466,2022-03-03 02:00:00,144,284,6,11,762,644,118,11
1467,2022-03-03 03:00:00,139,289,14,11,676,515,161,7
1468,2022-03-03 04:00:00,141,290,9,10,694,541,153,13
1469,2022-03-03 05:00:00,147,272,7,19,797,570,227,11
1470,2022-03-03 06:00:00,125,298,7,12,580,415,165,8
1471,2022-03-03 07:00:00,134,260,14,10,550,458,92,6
1472,2022-03-03 08:00:00,123,268,7,17,605,524,81,11
1473,2022-03-03 09:00:00,123,291,7,12,774,569,205,5
1474,2022-03-03 10:00:00,149,293,7,18,725,529,196,14
1475,2022-03-03 11:00:00,135,266,8,19,679,506,173,14
1476,2022-03-03 12:00:00,140,296,7,14,647,532,115,8
1477,2022-03-03 13:00:00,137,284,7,16,699,516,183,5
1478,2022-03-03 14:00:00,129,257,12,17,635,477,158,14
1479,2022-03-03 15:00:00,144,256,9,14,775,595,180,5
1480,2022-03-03 16:00:00,137,298,5,11,548,436,112,12
1481,2022-03-03 17:00:00,136,271,9,14,737,611,126,7
1482,2022-03-03 18:00:00,133,275,9,17,786,680,106,5
1483,2022-03-03 19:00:00,132,287,8,14,519,381,138,13
1484,2022-03-03 20:00:00,139,291,14,12,729,646,83,11
1485,2022-03-03 21:00:00,127,258,6,15,706,558,148,5
1486,2022-03-03 22:00:00,135,270,6,17,633,518,115,7
1487,2022-03-03 23:00:00,147,255,10,17,520,399,121,14
1488,2022-03-04 00:00:00,148,294,11,19,563,473,90,11
1489,2022-03-04 01:00:00,133,299,8,11,649,500,149,6
1490,2022-03-04 02:00:00,130,276,13,15,676,597,79,5
1491,2022-03-04 03:00:00,134,294,5,12,639,495,144,8
1492,2022-03-04 04:00:00,121,270,13,10,747,553,194,10
1493,2022-03-04 05:00:00,144,293,9,10,654,548,106,10
1494,2022-03-04 06:00:00,146,268,14,18,602,522,80,13
1495,2022-03-04 07:00:00,133,291,8,14,612,520,92,14
1496,2022-03-04 08:00:00,143,250,7,16,746,576,170,6
1497,2022-03-04 09:00:00,140,286,12,11,626,518,108,5
1498,2022-03-04 10:00:00,144,256,10,17,604,444,160,11
1499,2022-03-04 11:00:00,140,293,11,19,649,467,182,10
1500,2022-03-04 12:00:00,149,277,10,16,677,511,166,10
1501,2022-03-04 13:00:00,142,264,12,13,694,571,123,5
1502,2022-03-04 14:00:00,136,267,13,13,754,596,158,12
1503,2022-03-04 15:00:00,132,286,14,11,538,463,75,9
1504,2022-03-04 16:00:00,144,271,7,17,613,433,180,7
1505,2022-03-04 17:00:00,147,266,6,17,589,477,112,6
1506,2022-03-04 18:00:00,121,299,6,19,541,430,111,11
1507,2022-03-04 19:00:00,134,292,14,19,642,507,135,9
1508,2022-03-04 20:00:00,120,263,5,13,724,587,137,13
1509,2022-03-04 21:00:00,139,261,9,13,627,479,148,6
1510,2022-03-04 22:00:00,149,297,9,14,709,524,185,8
1511,2022-03-04 23:00:00,141,297,8,15,697,504,193,14
1512,2022-03-05 00:00:00,124,290,7,15,753,656,97,12
1513,2022-03-05 01:00:00,136,274,12,15,514,420,94,8
1514,2022-03-05 02:00:00,143,251,8,18,548,392,156,12
1515,2022-03-05 03:00:00,128,260,10,17,773,693,80,12
1516,2022-03-05 04:00:00,148,279,6,16,673,524,149,14
1517,2022-03-05 05:00:00,137,257,5,15,714,507,207,11
1518,2022-03-05 06:00:00,144,260,14,14,685,494,191,8
1519,2022-03-05 07:00:00,141,291,14,14,644,562,82,9
1520,2022-03-05 08:00:00,144,288,8,18,729,534,195,5
1521,2022-03-05 09:00:00,130,264,11,16,769,551,218,7
1522,2022-03-05 10:00:00,129,270,6,17,544,381,163,7
1523,2022-03-05 11:00:00,125,278,9,16,778,696,82,7
1524,2022-03-05 12:00:00,135,261,10,15,737,615,122,12
1525,2022-03-05 13:00:00,132,268,13,14,742,638,104,9
1526,2022-03-05 14:00:00,127,289,10,11,639,460,179,9
1527,2022-03-05 15:00:00,145,296,11,16,688,514,174,11
1528,2022-03-05 16:00:00,136,293,14,13,786,685,101,6
1529,2022-03-05 17:00:00,120,258,8,10,668,490,178,13
1530,2022-03-05 18:00:00,125,252,5,14,745,624,121,12
1531,2022-03-05 19:00:00,126,268,14,15,684,499,185,10
1532,2022-03-05 20:00:00,124,251,12,16,506,415,91,14
1533,2022-03-05 21:00:00,124,285,6,14,524,371,153,7
1534,2022-03-05 22:00:00,126,268,11,16,640,520,120,6
1535,2022-03-05 23:00:00,123,281,11,14,629,468,161,5
1536,2022-03-06 00:00:00,140,274,5,15,728,570,158,10
1537,2022-03-06 01:00:00,141,286,5,19,764,640,124,14
1538,2022-03-06 02:00:00,136,290,10,13,700,518,182,14
1539,2022-03-06 03:00:00,138,278,9,14,616,476,140,9
1540,2022-03-06 04:00:00,146,258,14,16,750,596,154,11
1541,2022-03-06 05:00:00,127,269,11,13,744,520,224,9
1542,2022-03-06 06:00:00,137,273,12,15,662,570,92,14
1543,2022-03-06 07:00:00,145,258,14,16,648,510,138,9
1544,2022-03-06 08:00:00,148,282,13,14,739,518,221,10
1545,2022-03-06 09:00:00,125,280,9,19,772,651,121,14
1546,2022-03-06 10:00:00,142,276,7,17,654,527,127,7
1547,2022-03-06 11:00:00,127,293,12,13,721,536,185,7
1548,2022-03-06 12:00:00,131,282,9,16,690,578,112,11
1549,2022-03-06 13:00:00,139,276,14,11,743,583,160,5
1550,2022-03-06 14:00:00,137,254,10,14,538,413,125,8
1551,2022-03-06 15:00:00,143,256,14,10,641,571,70,11
1552,2022-03-06 16:00:00,131,294,7,15,763,576,187,11
1553,2022-03-06 17:00:00,145,279,6,13,609,447,162,12
1554,2022-03-06 18:00:00,127,269,12,12,669,585,84,6
1555,2022-03-06 19:00:00,126,254,8,11,507,394,113,8
1556,2022-03-06 20:00:00,139,295,9,11,699,524,175,9
1557,2022-03-06 21:00:00,147,263,6,16,504,380,124,8
1558,2022-03-06 22:00:00,132,254,11,16,728,577,151,13
1559,2022-03-06 23:00:00,123,269,9,11,674,546,128,12
1560,2022-03-07 00:00:00,126,291,13,17,561,490,71,13
1561,2022-03-07 01:00:00,121,262,8,12,713,542,171,12
1562,2022-03-07 02:00:00,126,290,10,12,731,543,188,7
1563,2022-03-07 03:00:00,131,260,7,15,544,448,96,6
1564,2022-03-07 04:00:00,141,293,12,11,690,611,79,10
1565,2022-03-07 05:00:00,128,299,13,19,786,698,88,10
1566,2022-03-07 06:00:00,122,279,12,13,502,415,87,5
1567,2022-03-07 07:00:00,128,298,11,14,778,698,80,6
1568,2022-03-07 08:00:00,122,266,11,18,579,406,173,13
1569,2022-03-07 09:00:00,132,251,7,13,579,490,89,10
1570,2022-03-07 10:00:00,123,262,14,16,540,449,91,6
1571,2022-03-07 11:00:00,126,276,12,10,764,562,202,9
1572,2022-03-07 12:00:00,138,295,11,16,655,535,120,14
1573,2022-03-07 13:00:00,123,294,11,10,575,408,167,6
1574,2022-03-07 14:00:00,128,274,8,19,642,531,111,8
1575,2022-03-07 15:00:00,142,286,7,10,591,506,85,9
1576,2022-03-07 16:00:00,138,267,11,14,769,621,148,7
1577,2022-03-07 17:00:00,140,277,10,17,750,625,125,7
1578,2022-03-07 18:00:00,129,285,7,14,689,535,154,14
1579,2022-03-07 19:00:00,123,250,6,19,520,396,124,8
1580,2022-03-07 20:00:00,130,279,13,15,629,524,105,9
1581,2022-03-07 21:00:00,120,267,13,19,747,571,176,5
1582,2022-03-07 22:00:00,145,272,7,11,718,586,132,10
1583,2022-03-07 23:00:00,135,278,11,18,547,433,114,8
1584,2022-03-08 00:00:00,120,273,7,19,606,510,96,12
1585,2022-03-08 01:00:00,138,277,14,15,669,585,84,9
1586,2022-03-08 02:00:00,121,270,11,17,572,416,156,5
1587,2022-03-08 03:00:00,126,283,13,11,782,551,231,7
1588,2022-03-08 04:00:00,134,252,5,10,509,443,66,7
1589,2022-03-08 05:00:00,135,279,7,19,588,504,84,13
1590,2022-03-08 06:00:00,129,294,13,11,715,519,196,10
1591,2022-03-08 07:00:00,141,284,11,10,547,442,105,8
1592,2022-03-08 08:00:00,127,271,10,12,669,503,166,8
1593,2022-03-08 09:00:00,128,250,10,10,738,520,218,12
1594,2022-03-08 10:00:00,132,285,5,13,581,438,143,9
1595,2022-03-08 11:00:00,138,253,10,19,523,401,122,12
1596,2022-03-08 12:00:00,146,259,8,10,682,602,80,14
1597,2022-03-08 13:00:00,125,279,11,18,521,385,136,13
1598,2022-03-08 14:00:00,130,297,9,15,664,530,134,7
1599,2022-03-08 15:00:00,130,269,14,10,690,558,132,6
1600,2022-03-08 16:00:00,149,288,10,11,591,455,136,7
1601,2022-03-08 17:00:00,142,284,7,13,758,576,182,7
1602,2022-03-08 18:00:00,121,295,10,12,698,584,114,9
1603,2022-03-08 19:00:00,135,280,5,10,649,530,119,14
1604,2022-03-08 20:00:00,120,251,7,16,511,404,107,12
1605,2022-03-08 21:00:00,142,276,10,11,515,409,106,7
1606,2022-03-08 22:00:00,122,270,13,13,763,564,199,9
1607,2022-03-08 23:00:00,141,293,13,12,658,529,129,6
1608,2022-03-09 00:00:00,132,287,13,16,688,488,200,10
1609,2022-03-09 01:00:00,132,277,8,11,715,544,171,11
1610,2022-03-09 02:00:00,132,271,5,11,564,447,117,7
1611,2022-03-09 03:00:00,148,296,5,10,605,512,93,13
1612,2022-03-09 04:00:00,128,270,5,11,607,445,162,11
1613,2022-03-09 05:00:00,140,286,7,14,671,538,133,7
1614,2022-03-09 06:00:00,146,278,13,12,645,453,192,5
1615,2022-03-09 07:00:00,131,274,8,11,609,430,179,5
1616,2022-03-09 08:00:00,141,268,7,11,541,424,117,10
1617,2022-03-09 09:00:00,138,250,8,18,669,556,113,12
1618,2022-03-09 10:00:00,143,262,10,12,622,552,70,9
1619,2022-03-09 11:00:00,139,272,7,13,775,673,102,10
1620,2022-03-09 12:00:00,147,255,12,13,513,397,116,9
1621,2022-03-09 13:00:00,136,275,7,11,557,501,56,9
1622,2022-03-09 14:00:00,122,278,6,13,589,492,97,9
1623,2022-03-09 15:00:00,120,294,11,18,575,446,129,14
1624,2022-03-09 16:00:00,131,263,5,13,617,440,177,11
1625,2022-03-09 17:00:00,148,257,9,19,508,454,54,5
1626,2022-03-09 18:00:00,130,288,7,11,712,506,206,8
1627,2022-03-09 19:00:00,127,284,9,12,772,582,190,13
1628,2022-03-09 20:00:00,135,277,13,19,699,560,139,8
1629,2022-03-09 21:00:00,144,270,12,11,684,581,103,6
1630,2022-03-09 22:00:00,142,254,10,17,586,410,176,9
1631,2022-03-09 23:00:00,139,288,13,18,715,515,200,11
1632,2022-03-10 00:00:00,140,286,6,18,655,488,167,6
1633,2022-03-10 01:00:00,135,287,9,17,569,441,128,12
1634,2022-03-10 02:00:00,130,265,10,11,558,446,112,10
1635,2022-03-10 03:00:00,134,266,8,19,570,461,109,11
1636,2022-03-10 04:00:00,120,263,14,13,505,373,132,12
1637,2022-03-10 05:00:00,144,286,11,19,670,575,95,11
1638,2022-03-10 06:00:00,125,250,14,13,539,467,72,11
1639,2022-03-10 07:00:00,137,254,9,10,512,381,131,13
1640,2022-03-10 08:00:00,130,289,8,13,503,407,96,10
1641,2022-03-10 09:00:00,128,289,8,10,622,483,139,12
1642,2022-03-10 10:00:00,129,255,7,13,707,613,94,8
1643,2022-03-10 11:00:00,136,264,5,18,604,425,179,7
1644,2022-03-10 12:00:00,132,291,10,19,772,563,209,11
1645,2022-03-10 13:00:00,148,261,8,12,602,437,165,13
1646,2022-03-10 14:00:00,143,283,10,11,649,458,191,6
1647,2022-03-10 15:00:00,144,288,5,14,599,526,73,12
1648,2022-03-10 16:00:00,128,287,8,12,757,637,120,12
1649,2022-03-10 17:00:00,126,294,12,15,508,364,144,6
1650,2022-03-10 18:00:00,146,283,10,13,595,510,85,11
1651,2022-03-10 19:00:00,149,264,7,16,769,618,151,9
1652,2022-03-10 20:00:00,126,257,6,15,566,459,107,10
1653,2022-03-10 21:00:00,136,294,8,17,624,472,152,6
1654,2022-03-10 22:00:00,136,276,7,19,579,437,142,6
1655,2022-03-10 23:00:00,121,267,11,11,675,494,181,12
1656,2022-03-11 00:00:00,138,259,14,11,574,511,63,11
1657,2022-03-11 01:00:00,138,272,6,11,790,650,140,10
1658,2022-03-11 02:00:00,121,270,11,17,525,471,54,14
1659,2022-03-11 03:00:00,125,255,13,19,668,499,169,9
1660,2022-03-11 04:00:00,122,280,8,16,718,612,106,8
1661,2022-03-11 05:00:00,149,276,8,10,682,503,179,7
1662,2022-03-11 06:00:00,122,291,10,16,758,534,224,5
1663,2022-03-11 07:00:00,121,253,7,18,738,594,144,9
1664,2022-03-11 08:00:00,138,292,14,10,705,554,151,9
1665,2022-03-11 09:00:00,145,259,14,11,539,460,79,7
1666,2022-03-11 10:00:00,142,252,12,19,799,611,188,14
1667,2022-03-11 11:00:00,133,297,8,15,509,422,87,6
1668,2022-03-11 12:00:00,133,297,7,16,725,554,171,13
1669,2022-03-11 13:00:00,125,254,12,14,737,567,170,9
1670,2022-03-11 14:00:00,122,293,10,14,609,471,138,6
1671,2022-03-11 15:00:00,124,273,5,17,644,536,108,7
1672,2022-03-11 16:00:00,149,294,11,19,777,604,173,9
1673,2022-03-11 17:00:00,138,250,6,16,704,598,106,5
1674,2022-03-11 18:00:00,134,256,7,11,777,561,216,8
1675,2022-03-11 19:00:00,137,270,5,11,740,613,127,12
1676,2022-03-11 20:00:00,142,263,13,15,723,646,77,5
1677,2022-03-11 21:00:00,126,292,13,19,521,378,143,8
1678,2022-03-11 22:00:00,121,259,6,19,510,434,76,6
1679,2022-03-11 23:00:00,146,270,13,16,667,496,171,9
1680,2022-03-12 00:00:00,142,258,12,16,781,663,118,10
1681,2022-03-12 01:00:00,144,257,13,16,520,375,145,11
1682,2022-03-12 02:00:00,146,251,11,10,714,580,134,8
1683,2022-03-12 03:00:00,143,250,10,17,528,376,152,8
1684,2022-03-12 04:00:00,127,258,10,14,619,496,123,13
1685,2022-03-12 05:00:00,130,260,14,14,545,412,133,13
1686,2022-03-12 06:00:00,141,262,6,11,625,550,75,6
1687,2022-03-12 07:00:00,148,289,8,16,582,446,136,6
1688,2022-03-12 08:00:00,127,298,14,18,781,602,179,14
1689,2022-03-12 09:00:00,132,297,14,19,697,604,93,10
1690,2022-03-12 10:00:00,143,264,14,10,536,423,113,5
1691,2022-03-12 11:00:00,127,280,7,13,574,436,138,12
1692,2022-03-12 12:00:00,140,299,10,19,524,445,79,12
1693,2022-03-12 13:00:00,123,273,14,15,590,442,148,12
1694,2022-03-12 14:00:00,132,278,14,17,552,404,148,9
1695,2022-03-12 15:00:00,132,286,8,13,742,550,192,12
1696,2022-03-12 16:00:00,121,290,7,12,635,568,67,12
1697,2022-03-12 17:00:00,145,258,5,11,668,492,176,6
1698,2022-03-12 18:00:00,145,280,6,12,737,638,99,14
1699,2022-03-12 19:00:00,146,264,9,17,585,476,109,9
1700,2022-03-12 20:00:00,132,287,6,11,574,414,160,8
1701,2022-03-12 21:00:00,128,258,10,17,528,419,109,10
1702,2022-03-12 22:00:00,131,285,14,17,562,400,162,11
1703,2022-03-12 23:00:00,121,257,11,18,726,574,152,11
1704,2022-03-13 00:00:00,120,252,12,13,638,537,101,14
1705,2022-03-13 01:00:00,145,252,7,15,796,619,177,8
1706,2022-03-13 02:00:00,120,262,5,18,598,480,118,7
1707,2022-03-13 03:00:00,121,297,13,18,739,602,137,12
1708,2022-03-13 04:00:00,148,252,9,17,797,682,115,13
1709,2022-03-13 05:00:00,130,274,11,11,522,424,98,7
1710,2022-03-13 06:00:00,126,278,8,14,766,663,103,6
1711,2022-03-13 07:00:00,130,266,7,15,503,389,114,6
1712,2022-03-13 08:00:00,137,291,6,16,735,539,196,14
1713,2022-03-13 09:00:00,142,265,13,13,706,501,205,10
1714,2022-03-13 10:00:00,145,259,11,19,579,445,134,11
1715,2022-03-13 11:00:00,143,252,9,19,607,489,118,10
1716,2022-03-13 12:00:00,120,286,11,14,532,464,68,6
1717,2022-03-13 13:00:00,132,254,14,10,799,682,117,11
1718,2022-03-13 14:00:00,135,288,7,14,582,521,61,5
1719,2022-03-13 15:00:00,142,280,13,12,633,475,158,13
1720,2022-03-13 16:00:00,145,276,8,15,530,435,95,10
1721,2022-03-13 17:00:00,144,263,13,17,595,506,89,8
1722,2022-03-13 18:00:00,146,285,12,17,712,508,204,5
1723,2022-03-13 19:00:00,128,290,9,15,609,537,72,7
1724,2022-03-13 20:00:00,142,287,5,14,544,466,78,14
1725,2022-03-13 21:00:00,122,253,13,16,636,567,69,7
1726,2022-03-13 22:00:00,138,252,14,15,554,390,164,10
1727,2022-03-13 23:00:00,145,262,12,11,676,536,140,10
1728,2022-03-14 00:00:00,122,279,6,15,689,564,125,11
1729,2022-03-14 01:00:00,126,265,11,16,561,494,67,7
1730,2022-03-14 02:00:00,140,263,8,17,616,544,72,14
1731,2022-03-14 03:00:00,143,250,9,17,583,452,131,7
1732,2022-03-14 04:00:00,145,279,12,12,573,405,168,5
1733,2022-03-14 05:00:00,146,274,9,16,546,476,70,12
1734,2022-03-14 06:00:00,146,254,6,18,668,599,69,7
1735,2022-03-14 07:00:00,127,299,7,17,599,496,103,5
1736,2022-03-14 08:00:00,130,257,5,14,547,436,111,12
1737,2022-03-14 09:00:00,138,264,9,15,545,415,130,7
1738,2022-03-14 10:00:00,148,252,14,18,678,475,203,10
1739,2022-03-14 11:00:00,142,294,9,17,615,536,79,8
1740,2022-03-14 12:00:00,134,270,6,18,744,612,132,10
1741,2022-03-14 13:00:00,121,259,7,19,680,522,158,7
1742,2022-03-14 14:00:00,125,268,10,18,599,510,89,9
1743,2022-03-14 15:00:00,131,289,14,18,724,630,94,5
1744,2022-03-14 16:00:00,148,254,9,16,595,494,101,7
1745,2022-03-14 17:00:00,138,257,7,13,712,594,118,9
1746,2022-03-14 18:00:00,133,295,6,17,653,481,172,10
1747,2022-03-14 19:00:00,121,256,13,10,558,423,135,13
1748,2022-03-14 20:00:00,144,262,14,13,733,626,107,7
1749,2022-03-14 21:00:00,139,285,13,11,783,584,199,9
1750,2022-03-14 22:00:00,125,274,5,14,512,363,149,7
1751,2022-03-14 23:00:00,126,252,8,14,657,461,196,13
1752,2022-03-15 00:00:00,137,295,7,19,713,530,183,8
1753,2022-03-15 01:00:00,126,295,8,11,635,562,73,9
1754,2022-03-15 02:00:00,137,281,6,12,667,522,145,8
1755,2022-03-15 03:00:00,145,257,6,13,693,588,105,11
1756,2022-03-15 04:00:00,137,250,7,14,711,637,74,13
1757,2022-03-15 05:00:00,136,279,13,14,704,551,153,10
1758,2022-03-15 06:00:00,141,261,9,18,514,461,53,11
1759,2022-03-15 07:00:00,137,294,13,19,769,595,174,11
1760,2022-03-15 08:00:00,123,260,12,17,584,501,83,11
1761,2022-03-15 09:00:00,146,275,14,14,614,511,103,12
1762,2022-03-15 10:00:00,126,275,12,11,630,452,178,5
1763,2022-03-15 11:00:00,120,267,10,19,681,527,154,13
1764,2022-03-15 12:00:00,145,295,12,10,592,497,95,6
1765,2022-03-15 13:00:00,136,250,5,17,542,471,71,8
1766,2022-03-15 14:00:00,149,268,14,19,763,571,192,7
1767,2022-03-15 15:00:00,132,292,6,10,571,414,157,13
1768,2022-03-15 16:00:00,130,261,12,11,609,459,150,13
1769,2022-03-15 17:00:00,144,250,14,18,761,536,225,7
1770,2022-03-15 18:00:00,127,267,13,11,586,471,115,7
1771,2022-03-15 19:00:00,145,252,12,19,720,514,206,6
1772,2022-03-15 20:00:00,135,261,13,11,506,423,83,10
1773,2022-03-15 21:00:00,147,295,14,11,549,466,83,14
1774,2022-03-15 22:00:00,130,295,12,12,776,567,209,5
1775,2022-03-15 23:00:00,134,274,7,13,719,543,176,8
1776,2022-03-16 00:00:00,136,270,14,17,780,588,192,10
1777,2022-03-16 01:00:00,125,278,5,12,574,491,83,8
1778,2022-03-16 02:00:00,142,266,6,13,573,420,153,14
1779,2022-03-16 03:00:00,139,254,8,12,516,370,146,12
1780,2022-03-16 04:00:00,149,272,9,17,694,573,121,11
1781,2022-03-16 05:00:00,139,275,6,19,529,444,85,5
1782,2022-03-16 06:00:00,129,291,5,12,611,494,117,11
1783,2022-03-16 07:00:00,123,276,5,10,634,457,177,11
1784,2022-03-16 08:00:00,132,299,6,13,699,551,148,12
1785,2022-03-16 09:00:00,127,278,13,12,714,627,87,12
1786,2022-03-16 10:00:00,131,266,10,19,751,563,188,5
1787,2022-03-16 11:00:00,147,290,12,14,787,675,112,10
1788,2022-03-16 12:00:00,129,265,6,17,645,552,93,11
1789,2022-03-16 13:00:00,126,276,13,19,611,487,124,9
1790,2022-03-16 14:00:00,146,299,12,10,565,439,126,10
1791,2022-03-16 15:00:00,148,286,14,10,664,524,140,11
1792,2022-03-16 16:00:00,133,257,5,18,619,550,69,11
1793,2022-03-16 17:00:00,148,275,9,10,539,435,104,6
1794,2022-03-16 18:00:00,143,258,9,17,530,469,61,7
1795,2022-03-16 19:00:00,120,285,7,13,594,417,177,11
1796,2022-03-16 20:00:00,145,284,7,18,569,457,112,12
1797,2022-03-16 21:00:00,136,299,14,17,539,410,129,5
1798,2022-03-16 22:00:00,129,294,7,10,784,586,198,5
1799,2022-03-16 23:00:00,122,259,5,19,524,372,152,8
1800,2022-03-17 00:00:00,123,253,14,16,738,528,210,11
1801,2022-03-17 01:00:00,147,281,10,16,578,425,153,7
1802,2022-03-17 02:00:00,148,286,10,17,592,447,145,9
1803,2022-03-17 03:00:00,122,257,5,12,522,446,76,11
1804,2022-03-17 04:00:00,147,277,14,10,630,442,188,11
1805,2022-03-17 05:00:00,138,279,5,13,615,532,83,14
1806,2022-03-17 06:00:00,144,265,7,14,673,519,154,6
1807,2022-03-17 07:00:00,135,296,8,18,690,597,93,7
1808,2022-03-17 08:00:00,140,284,13,19,558,461,97,5
1809,2022-03-17 09:00:00,139,283,5,18,593,487,106,9
1810,2022-03-17 10:00:00,140,265,11,16,617,511,106,6
1811,2022-03-17 11:00:00,125,286,6,16,600,534,66,10
1812,2022-03-17 12:00:00,143,297,8,15,692,535,157,12
1813,2022-03-17 13:00:00,132,272,12,11,524,401,123,11
1814,2022-03-17 14:00:00,128,288,5,13,514,380,134,5
1815,2022-03-17 15:00:00,144,279,5,14,584,501,83,9
1816,2022-03-17 16:00:00,145,252,10,18,556,432,124,5
1817,2022-03-17 17:00:00,123,299,6,14,605,424,181,9
1818,2022-03-17 18:00:00,131,255,12,13,768,628,140,7
1819,2022-03-17 19:00:00,143,261,8,13,533,465,68,5
1820,2022-03-17 20:00:00,126,259,5,17,795,704,91,11
1821,2022-03-17 21:00:00,137,290,5,15,562,440,122,8
1822,2022-03-17 22:00:00,140,272,9,10,562,411,151,12
1823,2022-03-17 23:00:00,131,291,10,12,779,563,216,11
1824,2022-03-18 00:00:00,121,297,13,19,560,487,73,10
1825,2022-03-18 01:00:00,122,295,8,13,773,668,105,13
1826,2022-03-18 02:00:00,130,285,14,19,626,522,104,7
1827,2022-03-18 03:00:00,137,287,12,17,710,527,183,12
1828,2022-03-18 04:00:00,139,294,14,13,775,599,176,14
1829,2022-03-18 05:00:00,127,283,9,12,592,427,165,8
1830,2022-03-18 06:00:00,120,283,13,14,552,405,147,6
1831,2022-03-18 07:00:00,136,274,12,12,740,567,173,9
1832,2022-03-18 08:00:00,139,259,13,17,628,529,99,7
1833,2022-03-18 09:00:00,122,252,10,17,514,411,103,8
1834,2022-03-18 10:00:00,148,294,14,16,697,551,146,8
1835,2022-03-18 11:00:00,131,294,7,13,656,587,69,14
1836,2022-03-18 12:00:00,141,280,5,10,793,566,227,14
1837,2022-03-18 13:00:00,149,254,9,12,755,622,133,11
1838,2022-03-18 14:00:00,146,267,12,17,710,596,114,5
1839,2022-03-18 15:00:00,141,286,9,14,617,452,165,8
1840,2022-03-18 16:00:00,122,263,11,19,557,485,72,7
1841,2022-03-18 17:00:00,120,271,11,13,609,473,136,12
1842,2022-03-18 18:00:00,147,257,11,16,669,485,184,7
1843,2022-03-18 19:00:00,134,265,9,12,535,417,118,10
1844,2022-03-18 20:00:00,137,286,7,18,632,521,111,8
1845,2022-03-18 21:00:00,130,283,7,16,782,701,81,8
1846,2022-03-18 22:00:00,144,262,11,19,546,470,76,6
1847,2022-03-18 23:00:00,146,296,5,15,690,587,103,6
1848,2022-03-19 00:00:00,148,264,10,10,514,434,80,12
1849,2022-03-19 01:00:00,147,285,13,19,646,579,67,9
1850,2022-03-19 02:00:00,122,261,8,15,731,624,107,12
1851,2022-03-19 03:00:00,133,258,12,16,552,392,160,6
1852,2022-03-19 04:00:00,141,292,12,13,516,455,61,14
1853,2022-03-19 05:00:00,132,254,6,16,775,656,119,9
1854,2022-03-19 06:00:00,138,296,13,18,791,663,128,6
1855,2022-03-19 07:00:00,130,252,6,11,526,393,133,7
1856,2022-03-19 08:00:00,147,288,14,15,735,516,219,14
1857,2022-03-19 09:00:00,120,273,13,19,666,578,88,13
1858,2022-03-19 10:00:00,147,286,10,10,684,567,117,13
1859,2022-03-19 11:00:00,144,297,10,19,657,526,131,14
1860,2022-03-19 12:00:00,141,297,7,18,740,654,86,14
1861,2022-03-19 13:00:00,137,292,13,15,681,562,119,8
1862,2022-03-19 14:00:00,131,250,13,14,571,405,166,5
1863,2022-03-19 15:00:00,124,254,7,13,732,634,98,9
1864,2022-03-19 16:00:00,127,257,8,15,796,701,95,11
1865,2022-03-19 17:00:00,130,257,14,11,597,533,64,13
1866,2022-03-19 18:00:00,122,261,8,17,757,582,175,12
1867,2022-03-19 19:00:00,143,294,13,19,718,553,165,9
1868,2022-03-19 20:00:00,123,282,10,11,551,395,156,10
1869,2022-03-19 21:00:00,136,263,5,11,736,651,85,12
1870,2022-03-19 22:00:00,128,254,14,13,698,574,124,12
1871,2022-03-19 23:00:00,122,281,9,11,722,597,125,13
1872,2022-03-20 00:00:00,134,270,9,10,503,443,60,10
1873,2022-03-20 01:00:00,142,272,11,19,615,508,107,10
1874,2022-03-20 02:00:00,135,271,8,19,795,571,224,12
1875,2022-03-20 03:00:00,142,259,9,19,757,570,187,11
1876,2022-03-20 04:00:00,147,263,9,12,571,471,100,13
1877,2022-03-20 05:00:00,141,267,10,19,761,611,150,12
1878,2022-03-20 06:00:00,125,295,11,13,532,394,138,12
1879,2022-03-20 07:00:00,143,273,10,15,614,548,66,7
1880,2022-03-20 08:00:00,124,253,5,17,796,678,118,6
1881,2022-03-20 09:00:00,124,295,11,18,535,433,102,10
1882,2022-03-20 10:00:00,137,294,14,13,718,510,208,9
1883,2022-03-20 11:00:00,126,278,5,19,714,562,152,8
1884,2022-03-20 12:00:00,125,258,6,17,731,526,205,10
1885,2022-03-20 13:00:00,123,286,10,19,605,531,74,9
1886,2022-03-20 14:00:00,141,290,11,12,736,528,208,6
1887,2022-03-20 15:00:00,129,283,10,11,719,630,89,8
1888,2022-03-20 16:00:00,123,250,5,18,773,597,176,7
1889,2022-03-20 17:00:00,137,258,14,19,798,637,161,12
1890,2022-03-20 18:00:00,131,295,6,19,613,532,81,5
1891,2022-03-20 19:00:00,146,280,13,10,616,448,168,12
1892,2022-03-20 20:00:00,127,259,12,12,605,542,63,9
1893,2022-03-20 21:00:00,135,296,8,11,524,377,147,8
1894,2022-03-20 22:00:00,120,276,12,19,658,474,184,12
1895,2022-03-20 23:00:00,127,283,12,14,572,418,154,5
1896,2022-03-21 00:00:00,132,283,11,17,726,639,87,6
1897,2022-03-21 01:00:00,147,262,9,15,656,470,186,8
1898,2022-03-21 02:00:00,129,285,10,11,757,573,184,13
1899,2022-03-21 03:00:00,124,293,6,19,596,452,144,8
1900,2022-03-21 04:00:00,126,256,7,17,709,579,130,10
1901,2022-03-21 05:00:00,132,298,6,12,645,563,82,5
1902,2022-03-21 06:00:00,129,269,11,14,752,673,79,7
1903,2022-03-21 07:00:00,137,250,7,10,579,459,120,9
1904,2022-03-21 08:00:00,138,252,10,17,687,587,100,13
1905,2022-03-21 09:00:00,134,281,6,13,535,441,94,8
1906,2022-03-21 10:00:00,139,293,10,12,511,395,116,10
1907,2022-03-21 11:00:00,128,297,8,15,511,379,132,5
1908,2022-03-21 12:00:00,133,294,14,14,609,477,132,5
1909,2022-03-21 13:00:00,132,275,8,19,772,582,190,14
1910,2022-03-21 14:00:00,138,263,13,12,545,414,131,14
1911,2022-03-21 15:00:00,128,272,6,17,751,634,117,14
1912,2022-03-21 16:00:00,144,285,13,16,653,492,161,12
1913,2022-03-21 17:00:00,145,282,6,19,698,604,94,14
1914,2022-03-21 18:00:00,135,276,6,11,543,443,100,12
1915,2022-03-21 19:00:00,132,298,7,12,630,488,142,12
1916,2022-03-21 20:00:00,134,258,13,12,512,396,116,7
1917,2022-03-21 21:00:00,148,284,14,12,549,469,80,6
1918,2022-03-21 22:00:00,123,263,13,19,678,520,158,7
1919,2022-03-21 23:00:00,145,279,13,16,586,496,90,14
1920,2022-03-22 00:00:00,121,256,7,18,506,443,63,6
1921,2022-03-22 01:00:00,135,274,5,12,618,491,127,5
1922,2022-03-22 02:00:00,123,272,14,19,529,375,154,8
1923,2022-03-22 03:00:00,122,274,10,16,543,468,75,12
1924,2022-03-22 04:00:00,121,287,8,11,666,583,83,14
1925,2022-03-22 05:00:00,120,258,5,10,574,456,118,6
1926,2022-03-22 06:00:00,121,285,5,12,789,571,218,5
1927,2022-03-22 07:00:00,129,276,14,13,658,579,79,6
1928,2022-03-22 08:00:00,133,252,14,15,719,644,75,10
1929,2022-03-22 09:00:00,125,269,7,14,770,634,136,5
1930,2022-03-22 10:00:00,137,253,8,18,796,631,165,6
1931,2022-03-22 11:00:00,137,293,11,11,694,523,171,10
1932,2022-03-22 12:00:00,130,291,5,17,742,608,134,9
1933,2022-03-22 13:00:00,145,254,7,12,700,494,206,7
1934,2022-03-22 14:00:00,133,258,7,10,536,380,156,7
1935,2022-03-22 15:00:00,122,252,8,10,687,552,135,9
1936,2022-03-22 16:00:00,123,284,5,13,767,602,165,14
1937,2022-03-22 17:00:00,126,273,13,16,571,479,92,8
1938,2022-03-22 18:00:00,126,281,6,18,529,462,67,10
1939,2022-03-22 19:00:00,145,285,14,15,754,542,212,9
1940,2022-03-22 20:00:00,134,297,10,14,706,532,174,5
1941,2022-03-22 21:00:00,139,288,10,17,785,652,133,9
1942,2022-03-22 22:00:00,142,289,7,16,658,499,159,7
1943,2022-03-22 23:00:00,139,286,7,16,656,518,138,13
1944,2022-03-23 00:00:00,136,286,11,14,542,416,126,14
1945,2022-03-23 01:00:00,133,276,6,16,647,573,74,10
1946,2022-03-23 02:00:00,122,279,14,12,630,498,132,6
1947,2022-03-23 03:00:00,148,261,5,17,719,613,106,6
1948,2022-03-23 04:00:00,138,276,8,13,769,548,221,12
1949,2022-03-23 05:00:00,146,255,10,15,794,591,203,10
1950,2022-03-23 06:00:00,132,278,10,12,729,599,130,6
1951,2022-03-23 07:00:00,128,269,8,12,715,579,136,13
1952,2022-03-23 08:00:00,146,265,8,13,764,686,78,7
1953,2022-03-23 09:00:00,133,274,6,14,519,422,97,7
1954,2022-03-23 10:00:00,124,284,5,14,500,359,141,6
1955,2022-03-23 11:00:00,145,286,11,11,683,492,191,8
1956,2022-03-23 12:00:00,130,250,13,17,556,412,144,7
1957,2022-03-23 13:00:00,135,287,10,12,619,541,78,7
1958,2022-03-23 14:00:00,140,274,5,13,686,570,116,6
1959,2022-03-23 15:00:00,141,292,6,15,544,465,79,7
1960,2022-03-23 16:00:00,149,299,9,10,524,404,120,11
1961,2022-03-23 17:00:00,132,293,7,13,552,433,119,9
1962,2022-03-23 18:00:00,121,256,10,14,543,394,149,13
1963,2022-03-23 19:00:00,135,296,14,18,772,625,147,5
1964,2022-03-23 20:00:00,130,282,7,17,610,493,117,8
1965,2022-03-23 21:00:00,146,292,12,12,670,538,132,5
1966,2022-03-23 22:00:00,125,278,7,12,652,577,75,10
1967,2022-03-23 23:00:00,149,259,8,10,787,623,164,9
1968,2022-03-24 00:00:00,140,280,11,19,620,473,147,6
1969,2022-03-24 01:00:00,121,290,12,12,531,424,107,9
1970,2022-03-24 02:00:00,128,285,10,16,774,547,227,5
1971,2022-03-24 03:00:00,137,289,9,10,539,431,108,8
1972,2022-03-24 04:00:00,127,257,11,18,745,553,192,14
1973,2022-03-24 05:00:00,143,278,11,12,705,608,97,8
1974,2022-03-24 06:00:00,133,269,14,17,621,551,70,12
1975,2022-03-24 07:00:00,142,294,6,18,705,505,200,5
1976,2022-03-24 08:00:00,135,264,7,11,602,538,64,14
1977,2022-03-24 09:00:00,138,298,9,16,762,591,171,11
1978,2022-03-24 10:00:00,128,262,12,18,573,481,92,12
1979,2022-03-24 11:00:00,148,285,8,16,729,576,153,5
1980,2022-03-24 12:00:00,137,291,7,10,791,651,140,14
1981,2022-03-24 13:00:00,145,274,6,15,728,652,76,8
1982,2022-03-24 14:00:00,141,274,9,15,749,597,152,10
1983,2022-03-24 15:00:00,134,250,10,19,551,434,117,10
1984,2022-03-24 16:00:00,135,277,11,11,695,614,81,10
1985,2022-03-24 17:00:00,132,278,11,10,745,543,202,7
1986,2022-03-24 18:00:00,139,267,9,10,756,598,158,12
1987,2022-03-24 19:00:00,130,287,12,17,520,436,84,6
1988,2022-03-24 20:00:00,147,262,7,10,749,666,83,14
1989,2022-03-24 21:00:00,127,287,8,19,592,424,168,11
1990,2022-03-24 22:00:00,131,263,11,15,519,393,126,13
1991,2022-03-24 23:00:00,131,299,7,13,616,496,120,11
1992,2022-03-25 00:00:00,148,299,12,19,747,544,203,13
1993,2022-03-25 01:00:00,134,262,8,12,777,569,208,8
1994,2022-03-25 02:00:00,145,285,7,17,522,393,129,13
1995,2022-03-25 03:00:00,126,287,5,19,720,504,216,6
1996,2022-03-25 04:00:00,131,264,14,18,599,524,75,7
1997,2022-03-25 05:00:00,147,283,7,17,726,628,98,5
1998,2022-03-25 06:00:00,125,283,5,12,593,473,120,7
1999,2022-03-25 07:00:00,132,282,11,17,647,470,177,10
2000,2022-03-25 08:00:00,128,287,8,15,655,465,190,5
2001,2022-03-25 09:00:00,120,259,7,10,712,502,210,10
2002,2022-03-25 10:00:00,128,273,13,15,715,501,214,6
2003,2022-03-25 11:00:00,127,270,7,19,766,615,151,8
2004,2022-03-25 12:00:00,142,256,5,18,560,466,94,14
2005,2022-03-25 13:00:00,124,283,13,11,565,405,160,6
2006,2022-03-25 14:00:00,144,256,13,16,799,707,92,5
2007,2022-03-25 15:00:00,125,297,13,16,785,702,83,8
2008,2022-03-25 16:00:00,138,294,10,10,682,526,156,9
2009,2022-03-25 17:00:00,135,296,8,15,770,634,136,13
2010,2022-03-25 18:00:00,139,254,9,15,532,388,144,5
2011,2022-03-25 19:00:00,143,294,12,17,735,552,183,9
2012,2022-03-25 20:00:00,138,287,13,11,717,615,102,6
2013,2022-03-25 21:00:00,120,281,6,17,706,531,175,10
2014,2022-03-25 22:00:00,134,252,8,17,628,536,92,11
2015,2022-03-25 23:00:00,123,250,5,12,569,420,149,7
2016,2022-03-26 00:00:00,147,268,12,16,678,594,84,6
2017,2022-03-26 01:00:00,134,252,8,12,751,576,175,13
2018,2022-03-26 02:00:00,131,291,12,11,732,527,205,14
2019,2022-03-26 03:00:00,137,288,11,11,503,414,89,6
2020,2022-03-26 04:00:00,142,296,10,13,693,520,173,11
2021,2022-03-26 05:00:00,130,288,6,10,756,578,178,5
2022,2022-03-26 06:00:00,143,289,7,19,510,410,100,9
2023,2022-03-26 07:00:00,141,283,10,13,559,475,84,6
2024,2022-03-26 08:00:00,122,256,5,15,698,612,86,7
2025,2022-03-26 09:00:00,122,267,7,11,711,515,196,8
2026,2022-03-26 10:00:00,138,292,13,14,509,446,63,6
2027,2022-03-26 11:00:00,144,286,14,18,642,465,177,8
2028,2022-03-26 12:00:00,124,263,13,11,526,420,106,13
2029,2022-03-26 13:00:00,130,264,5,18,634,511,123,14
2030,2022-03-26 14:00:00,141,260,11,13,767,682,85,12
2031,2022-03-26 15:00:00,144,287,13,13,783,605,178,11
2032,2022-03-26 16:00:00,146,285,8,11,586,472,114,13
2033,2022-03-26 17:00:00,135,269,10,15,740,629,111,7
2034,2022-03-26 18:00:00,125,262,5,11,523,372,151,14
2035,2022-03-26 19:00:00,136,294,7,10,799,663,136,7
2036,2022-03-26 20:00:00,149,276,12,16,684,552,132,9
2037,2022-03-26 21:00:00,125,263,12,16,651,536,115,11
2038,2022-03-26 22:00:00,133,293,9,18,783,554,229,10
2039,2022-03-26 23:00:00,146,284,9,18,523,387,136,14
2040,2022-03-27 00:00:00,135,272,10,10,666,519,147,8
2041,2022-03-27 01:00:00,142,293,14,16,596,506,90,7
2042,2022-03-27 02:00:00,140,291,10,17,780,672,108,11
2043,2022-03-27 03:00:00,145,260,11,14,653,509,144,5
2044,2022-03-27 04:00:00,134,258,14,14,585,442,143,9
2045,2022-03-27 05:00:00,146,275,14,14,536,453,83,10
2046,2022-03-27 06:00:00,127,262,11,13,652,536,116,8
2047,2022-03-27 07:00:00,133,280,7,11,749,556,193,13
2048,2022-03-27 08:00:00,123,256,9,10,505,364,141,9
2049,2022-03-27 09:00:00,122,262,13,11,611,429,182,11
2050,2022-03-27 10:00:00,143,288,6,18,643,547,96,5
2051,2022-03-27 11:00:00,149,259,14,10,678,517,161,10
2052,2022-03-27 12:00:00,121,260,13,10,517,375,142,11
2053,2022-03-27 13:00:00,137,255,11,17,579,462,117,12
2054,2022-03-27 14:00:00,149,285,8,15,526,436,90,13
2055,2022-03-27 15:00:00,135,276,9,15,752,623,129,13
2056,2022-03-27 16:00:00,125,293,12,19,775,619,156,7
2057,2022-03-27 17:00:00,145,276,13,11,524,429,95,10
2058,2022-03-27 18:00:00,125,266,9,18,636,469,167,10
2059,2022-03-27 19:00:00,123,254,14,12,777,664,113,7
2060,2022-03-27 20:00:00,136,253,8,17,637,543,94,13
2061,2022-03-27 21:00:00,123,252,5,13,716,643,73,9
2062,2022-03-27 22:00:00,123,273,10,12,694,523,171,14
2063,2022-03-27 23:00:00,133,270,12,12,659,559,100,11
2064,2022-03-28 00:00:00,126,277,13,13,567,474,93,11
2065,2022-03-28 01:00:00,129,271,7,10,719,512,207,9
2066,2022-03-28 02:00:00,124,277,14,14,656,580,76,10
2067,2022-03-28 03:00:00,130,263,10,17,531,393,138,10
2068,2022-03-28 04:00:00,129,273,5,10,740,537,203,11
2069,2022-03-28 05:00:00,146,297,6,17,594,488,106,13
2070,2022-03-28 06:00:00,127,290,9,18,652,519,133,8
2071,2022-03-28 07:00:00,134,267,5,10,663,576,87,7
2072,2022-03-28 08:00:00,135,288,11,17,723,510,213,9
2073,2022-03-28 09:00:00,147,284,8,18,681,559,122,9
2074,2022-03-28 10:00:00,135,261,12,19,688,516,172,14
2075,2022-03-28 11:00:00,128,292,11,12,534,440,94,14
2076,2022-03-28 12:00:00,140,283,14,13,788,570,218,5
2077,2022-03-28 13:00:00,121,299,10,11,721,521,200,7
2078,2022-03-28 14:00:00,143,276,11,11,763,603,160,12
2079,2022-03-28 15:00:00,125,298,5,11,577,435,142,8
2080,2022-03-28 16:00:00,134,278,6,19,644,484,160,9
2081,2022-03-28 17:00:00,143,282,7,13,611,496,115,11
2082,2022-03-28 18:00:00,127,257,10,16,708,619,89,12
2083,2022-03-28 19:00:00,124,275,6,15,713,613,100,9
2084,2022-03-28 20:00:00,128,290,13,18,709,522,187,11
2085,2022-03-28 21:00:00,148,264,13,15,780,583,197,11
2086,2022-03-28 22:00:00,126,280,13,12,518,445,73,5
2087,2022-03-28 23:00:00,139,272,11,10,603,433,170,14
2088,2022-03-29 00:00:00,132,269,14,17,535,384,151,5
2089,2022-03-29 01:00:00,134,273,7,14,563,419,144,8
2090,2022-03-29 02:00:00,143,258,5,14,580,493,87,14
2091,2022-03-29 03:00:00,133,295,9,18,612,477,135,10
2092,2022-03-29 04:00:00,138,274,6,12,540,443,97,9
2093,2022-03-29 05:00:00,130,287,9,16,592,486,106,9
2094,2022-03-29 06:00:00,135,275,8,12,726,563,163,9
2095,2022-03-29 07:00:00,133,269,6,18,608,542,66,7
2096,2022-03-29 08:00:00,142,261,8,16,585,437,148,14
2097,2022-03-29 09:00:00,142,259,14,13,609,483,126,12
2098,2022-03-29 10:00:00,140,293,10,16,745,588,157,13
2099,2022-03-29 11:00:00,146,261,13,11,771,644,127,6
2100,2022-03-29 12:00:00,131,293,10,12,620,515,105,12
2101,2022-03-29 13:00:00,129,257,6,19,789,707,82,10
2102,2022-03-29 14:00:00,120,258,5,12,670,590,80,11
2103,2022-03-29 15:00:00,136,273,7,19,542,405,137,8
2104,2022-03-29 16:00:00,138,276,12,13,692,526,166,9
2105,2022-03-29 17:00:00,131,267,12,11,527,418,109,8
2106,2022-03-29 18:00:00,126,270,8,12,526,469,57,9
2107,2022-03-29 19:00:00,139,299,9,14,657,529,128,10
2108,2022-03-29 20:00:00,126,286,11,17,774,687,87,13
2109,2022-03-29 21:00:00,145,288,9,16,602,526,76,7
2110,2022-03-29 22:00:00,137,294,12,11,640,508,132,11
2111,2022-03-29 23:00:00,134,257,7,19,795,628,167,13
2112,2022-03-30 00:00:00,140,286,5,17,650,459,191,7
2113,2022-03-30 01:00:00,139,287,13,19,769,564,205,9
2114,2022-03-30 02:00:00,140,276,5,11,698,600,98,7
2115,2022-03-30 03:00:00,124,295,10,12,707,614,93,13
2116,2022-03-30 04:00:00,134,292,9,16,605,499,106,6
2117,2022-03-30 05:00:00,137,279,12,10,676,607,69,7
2118,2022-03-30 06:00:00,123,265,14,16,780,659,121,11
2119,2022-03-30 07:00:00,138,271,8,14,546,450,96,8
2120,2022-03-30 08:00:00,129,284,12,14,532,374,158,11
2121,2022-03-30 09:00:00,146,250,14,18,658,583,75,12
2122,2022-03-30 10:00:00,136,268,5,10,691,597,94,10
2123,2022-03-30 11:00:00,121,251,14,14,647,566,81,8
2124,2022-03-30 12:00:00,128,263,9,13,739,525,214,11
2125,2022-03-30 13:00:00,123,271,7,15,782,696,86,8
2126,2022-03-30 14:00:00,147,296,14,19,512,413,99,8
2127,2022-03-30 15:00:00,131,281,10,15,513,384,129,14
2128,2022-03-30 16:00:00,125,289,6,11,534,395,139,12
2129,2022-03-30 17:00:00,127,263,10,18,590,455,135,10
2130,2022-03-30 18:00:00,148,258,8,11,742,543,199,13
2131,2022-03-30 19:00:00,144,296,7,15,519,379,140,13
2132,2022-03-30 20:00:00,126,299,8,14,501,383,118,14
2133,2022-03-30 21:00:00,120,273,5,14,581,473,108,10
2134,2022-03-30 22:00:00,137,271,11,19,583,427,156,7
2135,2022-03-30 23:00:00,122,260,7,12,683,508,175,5
2136,2022-03-31 00:00:00,148,258,5,18,511,411,100,12
2137,2022-03-31 01:00:00,131,254,9,19,536,380,156,8
2138,2022-03-31 02:00:00,120,287,12,16,588,507,81,10
2139,2022-03-31 03:00:00,145,292,14,13,748,644,104,9
2140,2022-03-31 04:00:00,130,262,12,12,719,632,87,5
2141,2022-03-31 05:00:00,136,260,9,15,674,540,134,6
2142,2022-03-31 06:00:00,148,250,8,15,512,376,136,5
2143,2022-03-31 07:00:00,135,262,12,19,766,612,154,9
2144,2022-03-31 08:00:00,121,281,13,13,643,504,139,12
2145,2022-03-31 09:00:00,148,279,12,18,675,595,80,13
2146,2022-03-31 10:00:00,146,253,9,15,623,448,175,7
2147,2022-03-31 11:00:00,148,260,14,13,532,388,144,11
2148,2022-03-31 12:00:00,122,289,5,18,534,467,67,11
2149,2022-03-31 13:00:00,145,276,10,15,643,474,169,12
2150,2022-03-31 14:00:00,131,295,13,10,692,522,170,9
2151,2022-03-31 15:00:00,141,263,13,15,591,507,84,11
2152,2022-03-31 16:00:00,137,285,5,17,671,544,127,11
2153,2022-03-31 17:00:00,131,257,7,16,640,474,166,5
2154,2022-03-31 18:00:00,122,278,6,10,614,544,70,9
2155,2022-03-31 19:00:00,138,254,13,10,587,448,139,9
2156,2022-03-31 20:00:00,135,299,13,14,653,568,85,14
2157,2022-03-31 21:00:00,129,294,13,17,522,369,153,10
2158,2022-03-31 22:00:00,133,274,11,13,528,409,119,12
2159,2022-03-31 23:00:00,140,276,6,18,503,421,82,10
2160,2022-04-01 00:00:00,122,250,9,14,572,491,81,11
2161,2022-04-01 01:00:00,140,274,13,11,588,450,138,11
2162,2022-04-01 02:00:00,146,279,7,17,784,627,157,13
2163,2022-04-01 03:00:00,125,267,13,13,582,454,128,6
2164,2022-04-01 04:00:00,125,281,9,14,771,644,127,7
2165,2022-04-01 05:00:00,147,267,9,15,540,453,87,9
2166,2022-04-01 06:00:00,146,270,5,14,777,680,97,14
2167,2022-04-01 07:00:00,135,298,11,16,668,578,90,7
2168,2022-04-01 08:00:00,144,298,8,16,785,689,96,13
2169,2022-04-01 09:00:00,125,252,12,10,764,678,86,12
2170,2022-04-01 10:00:00,122,288,14,19,630,449,181,8
2171,2022-04-01 11:00:00,136,297,9,18,786,704,82,7
2172,2022-04-01 12:00:00,145,279,8,10,546,445,101,14
2173,2022-04-01 13:00:00,139,276,5,10,639,527,112,5
2174,2022-04-01 14:00:00,123,298,5,15,755,559,196,11
2175,2022-04-01 15:00:00,132,289,11,16,697,550,147,14
2176,2022-04-01 16:00:00,142,296,6,19,673,480,193,8
2177,2022-04-01 17:00:00,130,263,11,19,563,410,153,8
2178,2022-04-01 18:00:00,133,287,9,13,549,486,63,11
2179,2022-04-01 19:00:00,139,274,6,17,531,379,152,13
2180,2022-04-01 20:00:00,140,253,5,15,509,452,57,6
2181,2022-04-01 21:00:00,134,253,14,10,749,647,102,8
2182,2022-04-01 22:00:00,126,258,5,17,587,434,153,10
2183,2022-04-01 23:00:00,120,298,10,18,717,595,122,9
2184,2022-04-02 00:00:00,142,297,12,15,734,549,185,7
2185,2022-04-02 01:00:00,143,296,13,14,502,351,151,13
2186,2022-04-02 02:00:00,125,270,12,11,700,576,124,13
2187,2022-04-02 03:00:00,149,282,7,11,514,445,69,6
2188,2022-04-02 04:00:00,139,290,7,12,541,378,163,7
2189,2022-04-02 05:00:00,143,283,6,14,689,553,136,12
2190,2022-04-02 06:00:00,133,297,8,14,537,446,91,6
2191,2022-04-02 07:00:00,130,277,11,15,660,549,111,6
2192,2022-04-02 08:00:00,123,271,6,13,566,432,134,12
2193,2022-04-02 09:00:00,137,298,13,10,575,462,113,12
2194,2022-04-02 10:00:00,127,295,13,12,680,480,200,10
2195,2022-04-02 11:00:00,128,258,9,19,721,506,215,7
2196,2022-04-02 12:00:00,123,294,11,15,564,471,93,12
2197,2022-04-02 13:00:00,145,264,6,17,541,405,136,5
2198,2022-04-02 14:00:00,144,253,11,12,764,647,117,9
2199,2022-04-02 15:00:00,146,279,12,17,546,439,107,9
2200,2022-04-02 16:00:00,129,280,6,12,682,560,122,12
2201,2022-04-02 17:00:00,131,286,6,15,666,580,86,12
2202,2022-04-02 18:00:00,123,252,14,16,651,457,194,6
2203,2022-04-02 19:00:00,145,272,8,18,662,553,109,11
2204,2022-04-02 20:00:00,139,279,6,14,739,520,219,13
2205,2022-04-02 21:00:00,122,295,7,10,541,391,150,8
2206,2022-04-02 22:00:00,122,281,8,15,555,451,104,6
2207,2022-04-02 23:00:00,137,289,8,12,727,587,140,6
2208,2022-04-03 00:00:00,127,271,7,17,521,376,145,11
2209,2022-04-03 01:00:00,122,284,13,18,573,433,140,12
2210,2022-04-03 02:00:00,133,272,10,15,520,425,95,5
2211,2022-04-03 03:00:00,121,279,5,13,784,622,162,13
2212,2022-04-03 04:00:00,149,273,11,14,733,513,220,9
2213,2022-04-03 05:00:00,146,286,5,16,631,535,96,5
2214,2022-04-03 06:00:00,136,274,7,18,658,517,141,9
2215,2022-04-03 07:00:00,145,264,8,11,720,622,98,14
2216,2022-04-03 08:00:00,135,270,13,17,595,501,94,8
2217,2022-04-03 09:00:00,136,260,5,19,623,537,86,9
2218,2022-04-03 10:00:00,139,266,8,18,655,572,83,11
2219,2022-04-03 11:00:00,132,259,7,10,777,592,185,10
2220,2022-04-03 12:00:00,124,290,13,11,687,611,76,9
2221,2022-04-03 13:00:00,140,258,7,14,522,382,140,9
2222,2022-04-03 14:00:00,140,297,5,13,563,471,92,9
2223,2022-04-03 15:00:00,130,255,11,13,667,587,80,5
2224,2022-04-03 16:00:00,123,274,6,15,722,540,182,10
2225,2022-04-03 17:00:00,139,252,12,17,503,393,110,14
2226,2022-04-03 18:00:00,148,286,6,11,570,414,156,8
2227,2022-04-03 19:00:00,128,265,9,14,773,586,187,13
2228,2022-04-03 20:00:00,149,292,11,12,566,500,66,7
2229,2022-04-03 21:00:00,133,281,12,18,795,607,188,9
2230,2022-04-03 22:00:00,124,297,13,10,619,513,106,12
2231,2022-04-03 23:00:00,127,279,8,18,676,494,182,13
2232,2022-04-04 00:00:00,136,289,5,14,776,560,216,6
2233,2022-04-04 01:00:00,123,264,8,12,758,556,202,14
2234,2022-04-04 02:00:00,141,280,8,17,797,712,85,13
2235,2022-04-04 03:00:00,132,292,14,11,528,443,85,8
2236,2022-04-04 04:00:00,125,265,11,17,548,453,95,5
2237,2022-04-04 05:00:00,125,285,14,19,616,518,98,10
2238,2022-04-04 06:00:00,121,288,7,10,692,616,76,11
2239,2022-04-04 07:00:00,122,253,12,15,755,667,88,13
2240,2022-04-04 08:00:00,131,279,14,17,526,439,87,13
2241,2022-04-04 09:00:00,136,295,5,14,785,558,227,7
2242,2022-04-04 10:00:00,123,269,8,12,535,389,146,6
2243,2022-04-04 11:00:00,124,265,10,12,591,470,121,11
2244,2022-04-04 12:00:00,135,265,5,15,577,428,149,14
2245,2022-04-04 13:00:00,145,296,9,14,581,432,149,13
2246,2022-04-04 14:00:00,128,274,12,18,615,506,109,14
2247,2022-04-04 15:00:00,145,291,11,15,532,454,78,14
2248,2022-04-04 16:00:00,146,274,9,13,679,484,195,8
2249,2022-04-04 17:00:00,120,256,7,12,713,504,209,11
2250,2022-04-04 18:00:00,124,297,6,17,591,420,171,5
2251,2022-04-04 19:00:00,129,250,10,16,518,419,99,13
2252,2022-04-04 20:00:00,129,284,12,16,754,676,78,6
2253,2022-04-04 21:00:00,148,284,11,11,514,454,60,10
2254,2022-04-04 22:00:00,141,253,10,10,782,551,231,6
2255,2022-04-04 23:00:00,124,267,14,19,786,644,142,11
2256,2022-04-05 00:00:00,148,255,13,19,658,558,100,11
2257,2022-04-05 01:00:00,133,272,7,13,517,386,131,8
2258,2022-04-05 02:00:00,141,264,13,13,750,553,197,9
2259,2022-04-05 03:00:00,139,263,5,15,775,696,79,14
2260,2022-04-05 04:00:00,129,276,11,19,761,582,179,8
2261,2022-04-05 05:00:00,122,257,7,11,555,455,100,11
2262,2022-04-05 06:00:00,124,254,9,16,651,568,83,14
2263,2022-04-05 07:00:00,132,276,13,15,573,448,125,7
2264,2022-04-05 08:00:00,139,267,11,19,753,550,203,7
2265,2022-04-05 09:00:00,128,291,10,18,641,546,95,7
2266,2022-04-05 10:00:00,146,267,8,14,694,540,154,6
2267,2022-04-05 11:00:00,146,296,11,10,537,394,143,11
2268,2022-04-05 12:00:00,130,278,8,18,682,573,109,10
2269,2022-04-05 13:00:00,130,272,9,15,756,602,154,14
2270,2022-04-05 14:00:00,148,281,6,19,672,592,80,11
2271,2022-04-05 15:00:00,129,261,6,17,642,565,77,12
2272,2022-04-05 16:00:00,148,297,12,19,573,444,129,13
2273,2022-04-05 17:00:00,147,286,12,14,542,407,135,13
2274,2022-04-05 18:00:00,127,279,6,14,598,507,91,11
2275,2022-04-05 19:00:00,143,281,12,17,748,672,76,11
2276,2022-04-05 20:00:00,134,256,13,11,574,405,169,8
2277,2022-04-05 21:00:00,120,262,13,17,657,537,120,10
2278,2022-04-05 22:00:00,145,271,14,12,684,493,191,9
2279,2022-04-05 23:00:00,126,298,12,14,703,556,147,8
2280,2022-04-06 00:00:00,127,294,11,10,693,535,158,10
2281,2022-04-06 01:00:00,139,270,13,16,773,580,193,10
2282,2022-04-06 02:00:00,132,275,10,11,775,562,213,12
2283,2022-04-06 03:00:00,135,280,12,13,748,648,100,8
2284,2022-04-06 04:00:00,149,268,9,13,779,678,101,8
2285,2022-04-06 05:00:00,120,283,8,10,644,487,157,13
2286,2022-04-06 06:00:00,121,253,5,15,794,589,205,13
2287,2022-04-06 07:00:00,123,295,11,12,624,498,126,7
2288,2022-04-06 08:00:00,148,250,11,15,563,443,120,14
2289,2022-04-06 09:00:00,146,265,7,16,707,613,94,12
2290,2022-04-06 10:00:00,149,264,11,16,696,502,194,12
2291,2022-04-06 11:00:00,126,273,8,19,611,511,100,13
2292,2022-04-06 12:00:00,134,298,11,11,738,659,79,11
2293,2022-04-06 13:00:00,132,262,9,15,573,495,78,12
2294,2022-04-06 14:00:00,129,281,9,14,762,627,135,5
2295,2022-04-06 15:00:00,135,279,11,11,654,487,167,6
2296,2022-04-06 16:00:00,141,280,13,17,579,417,162,9
2297,2022-04-06 17:00:00,144,272,8,18,606,431,175,8
2298,2022-04-06 18:00:00,141,257,11,19,688,607,81,10
2299,2022-04-06 19:00:00,141,295,8,11,796,623,173,12
2300,2022-04-06 20:00:00,139,284,9,16,535,437,98,8
2301,2022-04-06 21:00:00,147,295,11,17,651,470,181,7
2302,2022-04-06 22:00:00,135,254,7,16,517,408,109,14
2303,2022-04-06 23:00:00,137,263,5,12,513,390,123,9
2304,2022-04-07 00:00:00,126,290,11,15,606,475,131,13
2305,2022-04-07 01:00:00,131,268,9,18,589,522,67,8
2306,2022-04-07 02:00:00,127,269,9,15,637,538,99,10
2307,2022-04-07 03:00:00,135,264,8,18,677,600,77,14
2308,2022-04-07 04:00:00,147,293,10,17,745,585,160,5
2309,2022-04-07 05:00:00,131,271,8,19,778,563,215,8
2310,2022-04-07 06:00:00,146,287,11,12,637,548,89,11
2311,2022-04-07 07:00:00,134,287,5,16,680,536,144,10
2312,2022-04-07 08:00:00,126,288,8,16,740,622,118,12
2313,2022-04-07 09:00:00,128,276,6,15,501,405,96,12
2314,2022-04-07 10:00:00,124,294,6,14,622,510,112,5
2315,2022-04-07 11:00:00,130,281,14,13,637,555,82,6
2316,2022-04-07 12:00:00,123,267,6,10,722,565,157,13
2317,2022-04-07 13:00:00,134,289,9,11,675,573,102,5
2318,2022-04-07 14:00:00,138,272,11,16,654,461,193,10
2319,2022-04-07 15:00:00,129,292,14,12,581,516,65,7
2320,2022-04-07 16:00:00,141,271,9,18,527,413,114,8
2321,2022-04-07 17:00:00,126,253,14,10,755,542,213,8
2322,2022-04-07 18:00:00,145,272,9,19,550,394,156,6
2323,2022-04-07 19:00:00,125,288,9,11,597,467,130,8
2324,2022-04-07 20:00:00,126,273,8,17,631,476,155,13
2325,2022-04-07 21:00:00,126,298,9,18,661,540,121,8
2326,2022-04-07 22:00:00,130,279,5,13,634,527,107,13
2327,2022-04-07 23:00:00,139,297,11,15,727,532,195,7
2328,2022-04-08 00:00:00,138,265,12,14,725,507,218,14
2329,2022-04-08 01:00:00,142,258,6,19,697,613,84,14
2330,2022-04-08 02:00:00,125,289,11,15,627,555,72,11
2331,2022-04-08 03:00:00,136,286,10,11,686,567,119,11
2332,2022-04-08 04:00:00,124,295,12,14,734,555,179,11
2333,2022-04-08 05:00:00,129,259,5,10,608,444,164,11
2334,2022-04-08 06:00:00,142,263,11,18,760,647,113,13
2335,2022-04-08 07:00:00,124,287,14,12,677,486,191,14
2336,2022-04-08 08:00:00,139,263,11,13,653,542,111,9
2337,2022-04-08 09:00:00,130,295,12,14,524,463,61,10
2338,2022-04-08 10:00:00,123,271,11,16,749,568,181,9
2339,2022-04-08 11:00:00,127,293,10,16,644,566,78,11
2340,2022-04-08 12:00:00,140,260,6,19,675,501,174,10
2341,2022-04-08 13:00:00,145,289,13,17,730,616,114,7
2342,2022-04-08 14:00:00,132,292,14,14,703,571,132,9
2343,2022-04-08 15:00:00,124,260,12,18,787,705,82,10
2344,2022-04-08 16:00:00,132,254,12,10,612,521,91,12
2345,2022-04-08 17:00:00,145,259,13,17,692,578,114,10
2346,2022-04-08 18:00:00,144,265,9,18,525,378,147,9
2347,2022-04-08 19:00:00,129,264,12,12,545,458,87,6
2348,2022-04-08 20:00:00,124,297,11,12,704,628,76,9
2349,2022-04-08 21:00:00,141,285,9,12,787,640,147,13
2350,2022-04-08 22:00:00,146,261,11,10,748,535,213,9
2351,2022-04-08 23:00:00,143,297,10,12,710,603,107,5
2352,2022-04-09 00:00:00,128,273,10,11,529,404,125,6
2353,2022-04-09 01:00:00,144,276,10,19,550,400,150,13
2354,2022-04-09 02:00:00,124,293,10,12,712,576,136,9
2355,2022-04-09 03:00:00,143,250,14,13,792,558,234,14
2356,2022-04-09 04:00:00,145,251,7,13,710,513,197,10
2357,2022-04-09 05:00:00,129,285,12,12,605,478,127,14
2358,2022-04-09 06:00:00,131,275,13,19,563,398,165,6
2359,2022-04-09 07:00:00,139,255,10,15,678,608,70,13
2360,2022-04-09 08:00:00,143,264,6,16,510,437,73,11
2361,2022-04-09 09:00:00,132,290,13,18,549,415,134,10
2362,2022-04-09 10:00:00,128,288,9,14,741,566,175,12
2363,2022-04-09 11:00:00,143,287,6,16,792,705,87,14
2364,2022-04-09 12:00:00,137,254,6,12,792,558,234,7
2365,2022-04-09 13:00:00,136,278,10,14,794,567,227,7
2366,2022-04-09 14:00:00,139,252,6,16,736,645,91,5
2367,2022-04-09 15:00:00,120,253,9,11,523,382,141,10
2368,2022-04-09 16:00:00,144,271,7,14,513,363,150,11
2369,2022-04-09 17:00:00,140,263,8,19,545,484,61,11
2370,2022-04-09 18:00:00,141,274,13,11,774,611,163,7
2371,2022-04-09 19:00:00,135,251,6,18,536,437,99,13
2372,2022-04-09 20:00:00,144,251,14,19,603,440,163,12
2373,2022-04-09 21:00:00,141,254,13,13,649,504,145,12
2374,2022-04-09 22:00:00,134,277,5,11,663,580,83,12
2375,2022-04-09 23:00:00,140,275,5,10,693,570,123,9
2376,2022-04-10 00:00:00,125,292,11,10,536,452,84,10
2377,2022-04-10 01:00:00,129,273,8,16,789,693,96,14
2378,2022-04-10 02:00:00,129,278,5,14,566,424,142,13
2379,2022-04-10 03:00:00,145,261,10,12,751,666,85,9
2380,2022-04-10 04:00:00,134,282,7,13,666,597,69,6
2381,2022-04-10 05:00:00,132,270,7,19,754,613,141,12
2382,2022-04-10 06:00:00,146,272,11,19,700,564,136,11
2383,2022-04-10 07:00:00,147,270,13,12,591,503,88,7
2384,2022-04-10 08:00:00,146,292,13,10,795,686,109,5
2385,2022-04-10 09:00:00,145,297,10,10,707,603,104,13
2386,2022-04-10 10:00:00,128,292,6,19,796,689,107,10
2387,2022-04-10 11:00:00,142,257,12,19,622,548,74,10
2388,2022-04-10 12:00:00,135,252,9,17,719,602,117,7
2389,2022-04-10 13:00:00,125,261,6,14,788,557,231,9
2390,2022-04-10 14:00:00,124,284,12,13,610,539,71,12
2391,2022-04-10 15:00:00,145,284,11,12,657,461,196,6
2392,2022-04-10 16:00:00,140,255,9,18,673,515,158,8
2393,2022-04-10 17:00:00,137,290,6,15,612,463,149,6
2394,2022-04-10 18:00:00,144,275,5,16,546,482,64,12
2395,2022-04-10 19:00:00,133,260,5,13,648,468,180,12
2396,2022-04-10 20:00:00,149,297,8,14,778,699,79,5
2397,2022-04-10 21:00:00,124,286,10,16,720,572,148,11
2398,2022-04-10 22:00:00,126,278,9,17,644,546,98,13
2399,2022-04-10 23:00:00,139,295,9,16,698,590,108,6
2400,2022-04-11 00:00:00,145,260,10,12,610,474,136,9
2401,2022-04-11 01:00:00,128,289,7,17,682,519,163,12
2402,2022-04-11 02:00:00,140,255,12,15,521,435,86,14
2403,2022-04-11 03:00:00,135,298,8,18,615,502,113,6
2404,2022-04-11 04:00:00,120,256,11,18,557,465,92,5
2405,2022-04-11 05:00:00,143,275,12,15,597,533,64,6
2406,2022-04-11 06:00:00,142,257,9,11,520,438,82,14
2407,2022-04-11 07:00:00,136,275,6,11,683,591,92,13
2408,2022-04-11 08:00:00,129,259,13,12,539,478,61,7
2409,2022-04-11 09:00:00,147,269,11,16,627,485,142,14
2410,2022-04-11 10:00:00,149,286,7,10,575,487,88,12
2411,2022-04-11 11:00:00,138,275,13,19,605,451,154,13
2412,2022-04-11 12:00:00,128,296,13,11,548,456,92,8
2413,2022-04-11 13:00:00,122,270,10,16,550,479,71,8
2414,2022-04-11 14:00:00,133,257,7,10,781,659,122,6
2415,2022-04-11 15:00:00,138,282,6,15,731,542,189,6
2416,2022-04-11 16:00:00,143,276,8,11,666,482,184,6
2417,2022-04-11 17:00:00,120,277,10,18,652,579,73,6
2418,2022-04-11 18:00:00,137,285,5,12,731,591,140,5
2419,2022-04-11 19:00:00,144,256,7,18,532,419,113,11
2420,2022-04-11 20:00:00,139,294,6,11,553,467,86,7
2421,2022-04-11 21:00:00,136,297,14,12,537,457,80,13
2422,2022-04-11 22:00:00,146,274,13,17,793,608,185,14
2423,2022-04-11 23:00:00,138,292,10,10,760,570,190,10
2424,2022-04-12 00:00:00,148,283,6,16,575,420,155,5
2425,2022-04-12 01:00:00,140,276,13,18,589,463,126,8
2426,2022-04-12 02:00:00,137,253,12,12,518,410,108,5
2427,2022-04-12 03:00:00,122,296,11,15,677,590,87,6
2428,2022-04-12 04:00:00,127,259,5,15,593,469,124,9
2429,2022-04-12 05:00:00,123,298,6,17,563,462,101,13
2430,2022-04-12 06:00:00,135,283,11,17,784,610,174,5
2431,2022-04-12 07:00:00,146,263,8,12,628,547,81,8
2432,2022-04-12 08:00:00,141,269,8,16,647,519,128,11
2433,2022-04-12 09:00:00,145,290,8,11,778,641,137,10
2434,2022-04-12 10:00:00,129,252,13,19,728,515,213,10
2435,2022-04-12 11:00:00,136,298,12,15,707,551,156,6
2436,2022-04-12 12:00:00,137,263,13,15,779,641,138,13
2437,2022-04-12 13:00:00,123,269,9,16,622,523,99,5
2438,2022-04-12 14:00:00,134,294,11,13,638,483,155,7
2439,2022-04-12 15:00:00,139,265,11,14,602,517,85,14
2440,2022-04-12 16:00:00,137,280,6,19,701,605,96,9
2441,2022-04-12 17:00:00,133,271,13,12,669,578,91,14
2442,2022-04-12 18:00:00,123,252,8,15,578,406,172,11
2443,2022-04-12 19:00:00,126,286,9,12,699,523,176,13
2444,2022-04-12 20:00:00,130,298,10,17,797,616,181,7
2445,2022-04-12 21:00:00,134,288,12,13,795,619,176,12
2446,2022-04-12 22:00:00,127,256,11,13,664,471,193,8
2447,2022-04-12 23:00:00,126,292,9,12,567,455,112,11
2448,2022-04-13 00:00:00,133,296,6,11,528,448,80,9
2449,2022-04-13 01:00:00,146,288,8,17,607,444,163,8
2450,2022-04-13 02:00:00,140,264,7,13,700,606,94,12
2451,2022-04-13 03:00:00,142,296,14,15,587,524,63,10
2452,2022-04-13 04:00:00,142,290,7,15,706,524,182,8
2453,2022-04-13 05:00:00,140,290,13,18,760,609,151,12
2454,2022-04-13 06:00:00,134,298,10,19,681,583,98,5
2455,2022-04-13 07:00:00,141,292,7,19,750,674,76,12
2456,2022-04-13 08:00:00,132,262,8,18,706,610,96,5
2457,2022-04-13 09:00:00,144,279,5,14,762,569,193,7
2458,2022-04-13 10:00:00,134,279,7,13,532,433,99,5
2459,2022-04-13 11:00:00,133,257,12,10,575,470,105,11
2460,2022-04-13 12:00:00,141,298,10,17,762,595,167,12
2461,2022-04-13 13:00:00,121,275,8,19,799,591,208,14
2462,2022-04-13 14:00:00,146,265,9,16,541,431,110,12
2463,2022-04-13 15:00:00,135,293,6,19,630,563,67,6
2464,2022-04-13 16:00:00,127,284,13,13,522,425,97,14
2465,2022-04-13 17:00:00,121,268,11,17,724,574,150,5
2466,2022-04-13 18:00:00,143,261,9,15,640,475,165,7
2467,2022-04-13 19:00:00,148,282,7,11,779,627,152,9
2468,2022-04-13 20:00:00,136,258,14,19,675,551,124,5
2469,2022-04-13 21:00:00,125,277,13,19,618,504,114,8
2470,2022-04-13 22:00:00,121,289,6,15,718,632,86,14
2471,2022-04-13 23:00:00,120,254,6,13,535,374,161,9
2472,2022-04-14 00:00:00,142,260,6,10,512,412,100,7
2473,2022-04-14 01:00:00,130,264,12,18,552,456,96,6
2474,2022-04-14 02:00:00,129,259,7,12,513,440,73,5
2475,2022-04-14 03:00:00,135,278,10,16,567,460,107,14
2476,2022-04-14 04:00:00,132,266,14,12,739,579,160,9
2477,2022-04-14 05:00:00,126,275,12,18,674,540,134,6
2478,2022-04-14 06:00:00,122,267,14,14,722,515,207,12
2479,2022-04-14 07:00:00,126,272,6,10,554,409,145,8
2480,2022-04-14 08:00:00,147,262,5,15,792,614,178,5
2481,2022-04-14 09:00:00,126,260,9,18,767,540,227,7
2482,2022-04-14 10:00:00,122,274,13,16,546,473,73,7
2483,2022-04-14 11:00:00,133,264,9,10,749,536,213,13
2484,2022-04-14 12:00:00,138,288,6,18,714,513,201,8
2485,2022-04-14 13:00:00,127,296,13,16,542,390,152,8
2486,2022-04-14 14:00:00,144,256,9,18,651,456,195,10
2487,2022-04-14 15:00:00,124,258,7,14,563,420,143,8
2488,2022-04-14 16:00:00,144,286,14,13,555,482,73,7
2489,2022-04-14 17:00:00,144,297,6,14,744,573,171,7
2490,2022-04-14 18:00:00,126,271,12,17,746,641,105,5
2491,2022-04-14 19:00:00,132,261,11,14,680,496,184,13
2492,2022-04-14 20:00:00,135,277,7,18,740,524,216,13
2493,2022-04-14 21:00:00,137,250,9,11,536,405,131,11
2494,2022-04-14 22:00:00,147,262,9,13,694,525,169,10
2495,2022-04-14 23:00:00,130,283,5,14,599,450,149,10
2496,2022-04-15 00:00:00,125,265,5,15,755,614,141,6
2497,2022-04-15 01:00:00,135,265,13,18,621,480,141,5
2498,2022-04-15 02:00:00,130,265,14,13,500,422,78,10
2499,2022-04-15 03:00:00,120,275,11,13,509,400,109,12
2500,2022-04-15 04:00:00,149,299,14,10,656,516,140,9
2501,2022-04-15 05:00:00,139,286,13,19,677,478,199,10
2502,2022-04-15 06:00:00,143,286,5,13,567,441,126,10
2503,2022-04-15 07:00:00,143,296,14,13,606,497,109,8
2504,2022-04-15 08:00:00,125,294,12,15,503,449,54,12
2505,2022-04-15 09:00:00,147,298,5,10,644,541,103,12
2506,2022-04-15 10:00:00,141,261,5,12,570,399,171,7
2507,2022-04-15 11:00:00,148,290,14,17,505,448,57,11
2508,2022-04-15 12:00:00,147,299,11,12,553,427,126,10
2509,2022-04-15 13:00:00,132,270,14,17,540,417,123,14
2510,2022-04-15 14:00:00,144,281,6,15,719,583,136,14
2511,2022-04-15 15:00:00,145,270,8,14,643,504,139,11
2512,2022-04-15 16:00:00,138,279,10,11,533,431,102,14
2513,2022-04-15 17:00:00,135,251,14,18,785,675,110,6
2514,2022-04-15 18:00:00,124,263,13,18,736,547,189,13
2515,2022-04-15 19:00:00,138,265,11,18,749,575,174,9
2516,2022-04-15 20:00:00,133,269,7,11,634,542,92,6
2517,2022-04-15 21:00:00,149,282,10,15,572,411,161,5
2518,2022-04-15 22:00:00,138,277,9,11,554,461,93,10
2519,2022-04-15 23:00:00,124,283,9,11,644,566,78,7
2520,2022-04-16 00:00:00,146,259,10,16,758,658,100,11
2521,2022-04-16 01:00:00,130,281,9,12,655,584,71,6
2522,2022-04-16 02:00:00,143,287,7,11,515,387,128,7
2523,2022-04-16 03:00:00,129,289,14,14,690,607,83,6
2524,2022-04-16 04:00:00,149,269,9,16,611,492,119,8
2525,2022-04-16 05:00:00,148,276,10,18,550,491,59,12
2526,2022-04-16 06:00:00,132,259,5,17,590,497,93,14
2527,2022-04-16 07:00:00,136,279,10,14,690,603,87,8
2528,2022-04-16 08:00:00,130,270,12,10,562,432,130,8
2529,2022-04-16 09:00:00,138,259,13,17,646,550,96,11
2530,2022-04-16 10:00:00,134,256,12,17,649,526,123,9
2531,2022-04-16 11:00:00,146,285,7,13,574,433,141,11
2532,2022-04-16 12:00:00,140,280,5,16,531,401,130,8
2533,2022-04-16 13:00:00,147,287,14,12,664,576,88,12
2534,2022-04-16 14:00:00,123,253,7,13,711,510,201,5
2535,2022-04-16 15:00:00,122,286,13,17,598,419,179,8
2536,2022-04-16 16:00:00,146,284,8,16,775,649,126,5
2537,2022-04-16 17:00:00,129,295,6,10,746,575,171,7
2538,2022-04-16 18:00:00,129,274,13,12,548,474,74,9
2539,2022-04-16 19:00:00,139,278,7,17,646,557,89,7
2540,2022-04-16 20:00:00,130,268,10,10,642,528,114,7
2541,2022-04-16 21:00:00,144,275,9,10,534,478,56,5
2542,2022-04-16 22:00:00,130,259,7,19,744,575,169,5
2543,2022-04-16 23:00:00,146,288,13,17,674,472,202,5
2544,2022-04-17 00:00:00,133,265,6,10,755,637,118,12
2545,2022-04-17 01:00:00,133,281,10,11,781,625,156,13
2546,2022-04-17 02:00:00,122,286,6,17,671,494,177,11
2547,2022-04-17 03:00:00,121,277,11,10,705,611,94,5
2548,2022-04-17 04:00:00,134,299,14,12,794,625,169,6
2549,2022-04-17 05:00:00,149,289,8,11,542,441,101,13
2550,2022-04-17 06:00:00,137,252,13,10,584,504,80,8
2551,2022-04-17 07:00:00,139,255,5,10,606,514,92,8
2552,2022-04-17 08:00:00,125,299,9,11,670,562,108,9
2553,2022-04-17 09:00:00,121,262,7,12,580,505,75,9
2554,2022-04-17 10:00:00,126,292,6,16,578,423,155,5
2555,2022-04-17 11:00:00,145,293,12,14,628,458,170,6
2556,2022-04-17 12:00:00,146,252,14,19,757,638,119,6
2557,2022-04-17 13:00:00,149,250,9,19,630,493,137,7
2558,2022-04-17 14:00:00,141,256,10,17,592,447,145,14
2559,2022-04-17 15:00:00,141,284,8,11,568,481,87,10
2560,2022-04-17 16:00:00,142,261,12,16,554,445,109,6
2561,2022-04-17 17:00:00,147,250,6,11,582,463,119,7
2562,2022-04-17 18:00:00,120,284,9,17,754,586,168,9
2563,2022-04-17 19:00:00,134,284,10,19,624,444,180,6
2564,2022-04-17 20:00:00,126,274,8,15,583,502,81,5
2565,2022-04-17 21:00:00,132,288,10,15,516,391,125,12
2566,2022-04-17 22:00:00,121,279,9,11,766,539,227,10
2567,2022-04-17 23:00:00,123,264,6,14,794,689,105,8
2568,2022-04-18 00:00:00,121,293,5,17,682,515,167,7
2569,2022-04-18 01:00:00,131,299,6,15,729,533,196,6
2570,2022-04-18 02:00:00,135,297,11,17,785,640,145,14
2571,2022-04-18 03:00:00,132,284,5,15,670,501,169,9
2572,2022-04-18 04:00:00,147,278,10,17,723,601,122,7
2573,2022-04-18 05:00:00,147,279,8,13,667,482,185,5
2574,2022-04-18 06:00:00,141,253,14,12,695,616,79,9
2575,2022-04-18 07:00:00,146,252,8,10,585,515,70,11
2576,2022-04-18 08:00:00,138,260,5,14,647,496,151,8
2577,2022-04-18 09:00:00,144,287,12,18,510,401,109,8
2578,2022-04-18 10:00:00,127,264,6,10,766,621,145,12
2579,2022-04-18 11:00:00,145,285,9,10,501,423,78,5
2580,2022-04-18 12:00:00,141,268,11,11,695,593,102,12
2581,2022-04-18 13:00:00,130,261,13,19,674,550,124,6
2582,2022-04-18 14:00:00,144,269,11,13,578,489,89,8
2583,2022-04-18 15:00:00,137,274,12,19,561,475,86,13
2584,2022-04-18 16:00:00,128,277,5,11,629,466,163,13
2585,2022-04-18 17:00:00,130,282,12,18,783,606,177,8
2586,2022-04-18 18:00:00,125,293,8,16,714,586,128,11
2587,2022-04-18 19:00:00,121,254,12,17,671,583,88,12
2588,2022-04-18 20:00:00,137,299,12,18,674,517,157,9
2589,2022-04-18 21:00:00,137,297,5,13,603,510,93,10
2590,2022-04-18 22:00:00,134,296,10,14,606,460,146,13
2591,2022-04-18 23:00:00,139,294,14,14,680,528,152,7
2592,2022-04-19 00:00:00,134,294,14,11,637,569,68,14
2593,2022-04-19 01:00:00,138,254,10,16,693,568,125,9
2594,2022-04-19 02:00:00,149,289,11,16,661,554,107,8
2595,2022-04-19 03:00:00,147,264,9,18,795,584,211,14
2596,2022-04-19 04:00:00,136,297,5,12,793,661,132,9
2597,2022-04-19 05:00:00,132,251,10,11,616,445,171,7
2598,2022-04-19 06:00:00,132,261,14,18,716,590,126,10
2599,2022-04-19 07:00:00,139,289,7,16,729,577,152,8
2600,2022-04-19 08:00:00,145,283,10,18,744,629,115,10
2601,2022-04-19 09:00:00,130,291,10,16,619,487,132,7
2602,2022-04-19 10:00:00,143,268,13,18,781,573,208,5
2603,2022-04-19 11:00:00,141,259,11,10,698,523,175,10
2604,2022-04-19 12:00:00,126,271,12,14,727,522,205,10
2605,2022-04-19 13:00:00,129,252,14,16,585,432,153,14
2606,2022-04-19 14:00:00,138,256,11,12,743,614,129,7
2607,2022-04-19 15:00:00,137,255,9,15,575,507,68,8
2608,2022-04-19 16:00:00,122,289,5,19,699,599,100,8
2609,2022-04-19 17:00:00,124,276,11,16,740,544,196,6
2610,2022-04-19 18:00:00,132,259,6,18,500,382,118,7
2611,2022-04-19 19:00:00,131,290,11,12,583,437,146,10
2612,2022-04-19 20:00:00,132,295,13,17,536,481,55,5
2613,2022-04-19 21:00:00,141,263,9,14,656,483,173,13
2614,2022-04-19 22:00:00,133,258,9,17,614,520,94,12
2615,2022-04-19 23:00:00,141,251,13,14,610,460,150,8
2616,2022-04-20 00:00:00,144,295,10,17,651,577,74,11
2617,2022-04-20 01:00:00,138,295,9,12,651,575,76,13
2618,2022-04-20 02:00:00,145,280,10,15,563,453,110,12
2619,2022-04-20 03:00:00,146,265,10,17,770,552,218,7
2620,2022-04-20 04:00:00,126,260,13,10,586,480,106,11
2621,2022-04-20 05:00:00,146,278,8,19,662,506,156,8
2622,2022-04-20 06:00:00,147,277,7,15,546,391,155,11
2623,2022-04-20 07:00:00,129,268,11,19,753,595,158,12
2624,2022-04-20 08:00:00,130,274,6,13,706,558,148,8
2625,2022-04-20 09:00:00,136,274,7,10,667,584,83,10
2626,2022-04-20 10:00:00,129,269,11,17,648,566,82,8
2627,2022-04-20 11:00:00,124,276,10,18,700,604,96,12
2628,2022-04-20 12:00:00,131,267,13,14,633,476,157,6
2629,2022-04-20 13:00:00,136,266,13,14,758,664,94,11
2630,2022-04-20 14:00:00,131,279,5,12,674,535,139,8
2631,2022-04-20 15:00:00,125,284,9,13,500,433,67,11
2632,2022-04-20 16:00:00,129,252,12,10,640,496,144,6
2633,2022-04-20 17:00:00,127,272,12,15,569,497,72,11
2634,2022-04-20 18:00:00,138,258,9,17,739,636,103,9
2635,2022-04-20 19:00:00,120,267,14,17,575,512,63,14
2636,2022-04-20 20:00:00,129,268,8,12,537,391,146,9
2637,2022-04-20 21:00:00,136,276,14,16,573,468,105,6
2638,2022-04-20 22:00:00,142,298,11,17,628,516,112,8
2639,2022-04-20 23:00:00,140,268,9,14,534,468,66,6
2640,2022-04-21 00:00:00,136,263,12,14,711,614,97,14
2641,2022-04-21 01:00:00,142,284,13,14,550,457,93,9
2642,2022-04-21 02:00:00,141,289,9,11,661,520,141,10
2643,2022-04-21 03:00:00,124,251,14,19,735,528,207,6
2644,2022-04-21 04:00:00,140,286,12,13,671,589,82,7
2645,2022-04-21 05:00:00,146,292,7,12,536,471,65,6
2646,2022-04-21 06:00:00,132,280,5,12,602,483,119,10
2647,2022-04-21 07:00:00,142,267,10,18,530,384,146,5
2648,2022-04-21 08:00:00,135,258,14,14,630,542,88,5
2649,2022-04-21 09:00:00,124,297,13,16,690,503,187,10
2650,2022-04-21 10:00:00,136,271,13,10,794,574,220,10
2651,2022-04-21 11:00:00,140,289,5,11,678,516,162,9
2652,2022-04-21 12:00:00,132,281,9,16,660,549,111,11
2653,2022-04-21 13:00:00,127,281,5,17,588,419,169,11
2654,2022-04-21 14:00:00,140,295,14,16,651,582,69,6
2655,2022-04-21 15:00:00,123,256,6,15,570,467,103,14
2656,2022-04-21 16:00:00,137,290,7,12,691,563,128,9
2657,2022-04-21 17:00:00,125,276,14,13,680,551,129,8
2658,2022-04-21 18:00:00,148,269,7,11,671,532,139,7
2659,2022-04-21 19:00:00,145,258,13,18,677,507,170,6
2660,2022-04-21 20:00:00,148,271,12,19,736,601,135,6
2661,2022-04-21 21:00:00,130,281,5,12,735,586,149,7
2662,2022-04-21 22:00:00,144,271,6,15,721,582,139,6
2663,2022-04-21 23:00:00,140,268,6,15,528,465,63,10
2664,2022-04-22 00:00:00,127,289,11,11,556,498,58,9
2665,2022-04-22 01:00:00,125,267,9,10,716,564,152,10
2666,2022-04-22 02:00:00,125,291,11,19,767,554,213,9
2667,2022-04-22 03:00:00,139,274,5,19,721,622,99,8
2668,2022-04-22 04:00:00,144,262,13,16,510,410,100,13
2669,2022-04-22 05:00:00,129,279,9,12,552,436,116,7
2670,2022-04-22 06:00:00,133,252,12,11,681,599,82,13
2671,2022-04-22 07:00:00,122,276,14,18,525,457,68,14
2672,2022-04-22 08:00:00,140,273,7,16,500,355,145,12
2673,2022-04-22 09:00:00,143,282,9,16,769,568,201,14
2674,2022-04-22 10:00:00,134,272,12,10,742,633,109,10
2675,2022-04-22 11:00:00,136,294,13,17,580,423,157,12
2676,2022-04-22 12:00:00,122,281,11,17,755,542,213,9
2677,2022-04-22 13:00:00,144,280,9,15,788,570,218,12
2678,2022-04-22 14:00:00,130,252,14,12,521,444,77,6
2679,2022-04-22 15:00:00,131,264,11,13,592,437,155,10
2680,2022-04-22 16:00:00,127,252,14,19,650,498,152,14
2681,2022-04-22 17:00:00,134,291,8,14,723,521,202,5
2682,2022-04-22 18:00:00,144,295,6,10,681,552,129,13
2683,2022-04-22 19:00:00,143,258,9,17,731,621,110,6
2684,2022-04-22 20:00:00,146,282,9,11,526,373,153,5
2685,2022-04-22 21:00:00,125,292,6,16,715,515,200,14
2686,2022-04-22 22:00:00,149,289,12,11,748,564,184,5
2687,2022-04-22 23:00:00,149,297,6,19,622,549,73,6
2688,2022-04-23 00:00:00,145,269,5,16,653,564,89,8
2689,2022-04-23 01:00:00,136,255,7,12,509,441,68,7
2690,2022-04-23 02:00:00,148,254,11,17,616,443,173,8
2691,2022-04-23 03:00:00,132,252,6,17,664,487,177,6
2692,2022-04-23 04:00:00,143,257,11,13,557,410,147,9
2693,2022-04-23 05:00:00,138,272,14,13,624,547,77,12
2694,2022-04-23 06:00:00,125,277,9,16,504,357,147,12
2695,2022-04-23 07:00:00,137,267,7,16,581,490,91,8
2696,2022-04-23 08:00:00,147,250,10,18,772,580,192,7
2697,2022-04-23 09:00:00,127,270,14,12,792,696,96,9
2698,2022-04-23 10:00:00,132,269,13,16,618,435,183,14
2699,2022-04-23 11:00:00,126,273,5,18,560,396,164,13
2700,2022-04-23 12:00:00,140,293,14,12,501,407,94,13
2701,2022-04-23 13:00:00,121,288,5,14,778,665,113,10
2702,2022-04-23 14:00:00,138,275,11,13,505,360,145,7
2703,2022-04-23 15:00:00,134,269,7,16,574,449,125,8
2704,2022-04-23 16:00:00,123,281,7,10,620,436,184,10
2705,2022-04-23 17:00:00,121,269,8,14,724,621,103,8
2706,2022-04-23 18:00:00,121,271,6,13,552,424,128,7
2707,2022-04-23 19:00:00,145,265,11,14,531,422,109,11
2708,2022-04-23 20:00:00,127,287,7,13,737,561,176,6
2709,2022-04-23 21:00:00,145,299,8,18,598,428,170,7
2710,2022-04-23 22:00:00,120,278,8,15,757,612,145,8
2711,2022-04-23 23:00:00,142,253,11,19,526,465,61,5
2712,2022-04-24 00:00:00,127,271,12,13,782,657,125,12
2713,2022-04-24 01:00:00,124,295,6,12,678,557,121,11
2714,2022-04-24 02:00:00,146,274,7,12,560,449,111,10
2715,2022-04-24 03:00:00,148,289,6,11,759,550,209,11
2716,2022-04-24 04:00:00,139,266,12,12,506,412,94,13
2717,2022-04-24 05:00:00,124,280,13,15,577,495,82,5
2718,2022-04-24 06:00:00,139,251,11,16,602,487,115,6
2719,2022-04-24 07:00:00,149,288,12,17,516,387,129,12
2720,2022-04-24 08:00:00,144,260,12,14,698,573,125,10
2721,2022-04-24 09:00:00,127,292,7,12,679,531,148,5
2722,2022-04-24 10:00:00,123,260,6,13,530,386,144,6
2723,2022-04-24 11:00:00,141,291,5,14,510,381,129,7
2724,2022-04-24 12:00:00,125,288,5,10,791,593,198,8
2725,2022-04-24 13:00:00,131,259,8,12,696,512,184,6
2726,2022-04-24 14:00:00,130,278,12,11,723,509,214,11
2727,2022-04-24 15:00:00,125,275,14,11,698,623,75,9
2728,2022-04-24 16:00:00,128,279,6,13,548,456,92,7
2729,2022-04-24 17:00:00,140,268,8,13,737,625,112,13
2730,2022-04-24 18:00:00,139,278,9,16,532,454,78,13
2731,2022-04-24 19:00:00,135,259,8,18,740,544,196,7
2732,2022-04-24 20:00:00,145,287,13,15,671,478,193,5
2733,2022-04-24 21:00:00,122,257,9,15,701,568,133,7
2734,2022-04-24 22:00:00,147,299,14,10,662,489,173,8
2735,2022-04-24 23:00:00,143,262,8,12,589,482,107,12
2736,2022-04-25 00:00:00,122,251,6,13,668,578,90,5
2737,2022-04-25 01:00:00,145,257,9,12,592,454,138,7
2738,2022-04-25 02:00:00,125,272,12,12,779,548,231,10
2739,2022-04-25 03:00:00,144,284,5,17,509,427,82,7
2740,2022-04-25 04:00:00,142,293,13,18,702,579,123,12
2741,2022-04-25 05:00:00,129,296,13,14,549,396,153,9
2742,2022-04-25 06:00:00,144,294,9,10,708,511,197,13
2743,2022-04-25 07:00:00,131,285,10,13,692,579,113,7
2744,2022-04-25 08:00:00,139,274,5,12,559,426,133,12
2745,2022-04-25 09:00:00,121,287,5,16,588,431,157,11
2746,2022-04-25 10:00:00,121,271,6,15,710,608,102,11
2747,2022-04-25 11:00:00,123,297,14,19,532,401,131,6
2748,2022-04-25 12:00:00,135,289,13,16,736,565,171,13
2749,2022-04-25 13:00:00,139,287,10,10,669,567,102,5
2750,2022-04-25 14:00:00,140,261,6,11,748,539,209,10
2751,2022-04-25 15:00:00,144,292,12,12,723,590,133,13
2752,2022-04-25 16:00:00,148,284,9,19,673,537,136,11
2753,2022-04-25 17:00:00,120,272,7,15,550,476,74,8
2754,2022-04-25 18:00:00,149,289,11,10,629,502,127,7
2755,2022-04-25 19:00:00,121,293,9,12,724,640,84,14
2756,2022-04-25 20:00:00,122,275,5,15,648,480,168,7
2757,2022-04-25 21:00:00,147,254,8,10,533,392,141,11
2758,2022-04-25 22:00:00,122,278,9,11,551,425,126,13
2759,2022-04-25 23:00:00,142,254,14,19,763,585,178,8
2760,2022-04-26 00:00:00,140,253,13,19,558,435,123,5
2761,2022-04-26 01:00:00,139,283,14,18,715,520,195,9
2762,2022-04-26 02:00:00,136,282,5,17,687,488,199,5
2763,2022-04-26 03:00:00,123,263,5,14,661,477,184,13
2764,2022-04-26 04:00:00,148,284,11,10,652,486,166,5
2765,2022-04-26 05:00:00,126,254,11,19,550,480,70,13
2766,2022-04-26 06:00:00,120,288,12,16,657,570,87,12
2767,2022-04-26 07:00:00,135,293,10,10,643,574,69,10
2768,2022-04-26 08:00:00,147,263,8,16,758,587,171,8
2769,2022-04-26 09:00:00,120,296,12,18,745,567,178,6
2770,2022-04-26 10:00:00,129,274,5,19,671,575,96,5
2771,2022-04-26 11:00:00,133,277,13,13,506,418,88,11
2772,2022-04-26 12:00:00,121,260,10,14,606,435,171,9
2773,2022-04-26 13:00:00,127,293,10,14,681,573,108,13
2774,2022-04-26 14:00:00,144,250,13,10,667,486,181,6
2775,2022-04-26 15:00:00,127,267,13,10,649,518,131,14
2776,2022-04-26 16:00:00,146,286,5,18,610,484,126,8
2777,2022-04-26 17:00:00,148,273,10,16,795,711,84,12
2778,2022-04-26 18:00:00,121,287,14,18,553,412,141,10
2779,2022-04-26 19:00:00,123,266,9,13,735,585,150,8
2780,2022-04-26 20:00:00,140,299,9,14,675,504,171,8
2781,2022-04-26 21:00:00,147,252,10,18,515,371,144,14
2782,2022-04-26 22:00:00,130,259,13,17,787,595,192,6
2783,2022-04-26 23:00:00,122,265,5,19,534,432,102,9
2784,2022-04-27 00:00:00,143,299,9,16,545,448,97,6
2785,2022-04-27 01:00:00,146,289,5,12,672,501,171,14
2786,2022-04-27 02:00:00,139,285,13,17,690,596,94,7
2787,2022-04-27 03:00:00,134,269,10,16,668,558,110,12
2788,2022-04-27 04:00:00,148,290,10,18,768,543,225,13
2789,2022-04-27 05:00:00,125,296,6,15,539,431,108,14
2790,2022-04-27 06:00:00,141,279,14,14,541,478,63,10
2791,2022-04-27 07:00:00,146,297,6,19,501,430,71,7
2792,2022-04-27 08:00:00,144,277,6,11,741,573,168,9
2793,2022-04-27 09:00:00,138,270,7,13,522,449,73,6
2794,2022-04-27 10:00:00,139,262,5,16,733,543,190,14
2795,2022-04-27 11:00:00,134,253,12,18,648,573,75,8
2796,2022-04-27 12:00:00,122,293,13,17,675,552,123,8
2797,2022-04-27 13:00:00,140,263,11,11,508,445,63,12
2798,2022-04-27 14:00:00,134,262,11,13,538,471,67,7
2799,2022-04-27 15:00:00,124,297,8,16,761,564,197,6
2800,2022-04-27 16:00:00,136,267,6,12,639,529,110,12
2801,2022-04-27 17:00:00,125,298,5,13,616,498,118,7
2802,2022-04-27 18:00:00,133,291,14,15,684,534,150,10
2803,2022-04-27 19:00:00,135,285,11,18,629,506,123,6
2804,2022-04-27 20:00:00,131,258,13,16,503,450,53,8
2805,2022-04-27 21:00:00,131,289,5,19,691,536,155,5
2806,2022-04-27 22:00:00,135,285,12,16,617,432,185,9
2807,2022-04-27 23:00:00,145,287,13,13,732,653,79,9
2808,2022-04-28 00:00:00,129,253,11,15,776,556,220,8
2809,2022-04-28 01:00:00,128,253,5,18,572,447,125,9
2810,2022-04-28 02:00:00,144,283,10,14,782,679,103,11
2811,2022-04-28 03:00:00,121,277,14,11,658,498,160,10
2812,2022-04-28 04:00:00,135,296,9,10,682,601,81,5
2813,2022-04-28 05:00:00,128,291,14,19,761,629,132,8
2814,2022-04-28 06:00:00,146,252,13,13,766,608,158,12
2815,2022-04-28 07:00:00,129,250,11,17,524,432,92,13
2816,2022-04-28 08:00:00,132,281,9,12,784,566,218,8
2817,2022-04-28 09:00:00,134,291,9,15,682,568,114,11
2818,2022-04-28 10:00:00,123,272,5,11,584,411,173,6
2819,2022-04-28 11:00:00,132,265,7,16,718,535,183,9
2820,2022-04-28 12:00:00,144,263,7,13,563,485,78,11
2821,2022-04-28 13:00:00,149,283,11,14,797,669,128,8
2822,2022-04-28 14:00:00,141,274,5,12,736,585,151,8
2823,2022-04-28 15:00:00,138,281,13,15,518,401,117,7
2824,2022-04-28 16:00:00,143,250,11,12,548,435,113,6
2825,2022-04-28 17:00:00,137,254,13,13,583,418,165,7
2826,2022-04-28 18:00:00,130,267,6,18,779,664,115,5
2827,2022-04-28 19:00:00,135,261,11,19,745,546,199,5
2828,2022-04-28 20:00:00,141,286,12,16,636,514,122,10
2829,2022-04-28 21:00:00,120,273,6,18,778,553,225,8
2830,2022-04-28 22:00:00,127,264,7,15,691,542,149,5
2831,2022-04-28 23:00:00,137,291,8,15,652,503,149,8
2832,2022-04-29 00:00:00,138,285,9,19,742,549,193,12
2833,2022-04-29 01:00:00,134,268,7,17,779,637,142,5
2834,2022-04-29 02:00:00,132,265,7,18,740,549,191,10
2835,2022-04-29 03:00:00,141,266,13,13,512,441,71,10
2836,2022-04-29 04:00:00,144,267,13,16,726,649,77,8
2837,2022-04-29 05:00:00,148,299,6,13,601,474,127,5
2838,2022-04-29 06:00:00,135,264,14,11,760,650,110,7
2839,2022-04-29 07:00:00,133,276,13,15,662,482,180,6
2840,2022-04-29 08:00:00,146,271,8,19,501,431,70,5
2841,2022-04-29 09:00:00,135,296,6,19,580,453,127,11
2842,2022-04-29 10:00:00,131,295,7,18,714,571,143,8
2843,2022-04-29 11:00:00,131,283,14,12,672,506,166,13
2844,2022-04-29 12:00:00,130,269,10,10,513,412,101,11
2845,2022-04-29 13:00:00,131,296,11,13,598,436,162,9
2846,2022-04-29 14:00:00,140,289,14,15,511,363,148,12
2847,2022-04-29 15:00:00,137,267,14,12,634,497,137,13
2848,2022-04-29 16:00:00,148,298,12,15,740,596,144,11
2849,2022-04-29 17:00:00,128,298,6,19,541,438,103,5
2850,2022-04-29 18:00:00,139,265,5,19,568,502,66,9
2851,2022-04-29 19:00:00,145,282,5,17,682,480,202,13
2852,2022-04-29 20:00:00,121,277,10,13,780,590,190,5
2853,2022-04-29 21:00:00,137,256,6,12,759,606,153,13
2854,2022-04-29 22:00:00,125,291,12,12,542,380,162,12
2855,2022-04-29 23:00:00,142,268,8,18,764,654,110,9
2856,2022-04-30 00:00:00,137,267,14,14,589,449,140,6
2857,2022-04-30 01:00:00,132,295,5,12,754,572,182,12
2858,2022-04-30 02:00:00,148,296,5,16,539,395,144,9
2859,2022-04-30 03:00:00,127,262,6,19,758,607,151,10
2860,2022-04-30 04:00:00,135,252,11,15,683,572,111,12
2861,2022-04-30 05:00:00,145,293,5,12,765,640,125,6
2862,2022-04-30 06:00:00,129,270,5,14,623,464,159,14
2863,2022-04-30 07:00:00,125,285,5,18,624,517,107,13
2864,2022-04-30 08:00:00,143,276,10,12,582,487,95,8
2865,2022-04-30 09:00:00,131,261,7,15,695,554,141,8
2866,2022-04-30 10:00:00,138,279,13,17,572,409,163,9
2867,2022-04-30 11:00:00,146,272,13,13,637,461,176,5
2868,2022-04-30 12:00:00,147,278,11,17,648,560,88,11
2869,2022-04-30 13:00:00,139,277,10,14,715,523,192,11
2870,2022-04-30 14:00:00,142,262,5,19,500,355,145,9
2871,2022-04-30 15:00:00,144,277,8,15,603,508,95,12
2872,2022-04-30 16:00:00,120,297,12,17,542,468,74,9
2873,2022-04-30 17:00:00,122,283,7,17,701,606,95,11
2874,2022-04-30 18:00:00,139,262,7,12,542,409,133,5
2875,2022-04-30 19:00:00,131,287,10,13,762,605,157,10
2876,2022-04-30 20:00:00,135,252,8,14,678,531,147,9
2877,2022-04-30 21:00:00,139,273,12,12,589,436,153,7
2878,2022-04-30 22:00:00,133,269,13,19,585,470,115,10
2879,2022-04-30 23:00:00,149,256,9,12,640,571,69,8
2880,2022-05-01 00:00:00,142,299,7,19,686,517,169,11
2881,2022-05-01 01:00:00,129,268,12,16,570,430,140,14
2882,2022-05-01 02:00:00,132,254,14,18,538,472,66,14
2883,2022-05-01 03:00:00,122,289,10,15,788,685,103,10
2884,2022-05-01 04:00:00,124,280,9,11,760,537,223,6
2885,2022-05-01 05:00:00,132,268,9,14,692,510,182,13
2886,2022-05-01 06:00:00,129,274,10,11,619,446,173,14
2887,2022-05-01 07:00:00,147,275,5,10,639,490,149,13
2888,2022-05-01 08:00:00,134,285,12,18,777,615,162,8
2889,2022-05-01 09:00:00,128,259,11,16,589,465,124,12
2890,2022-05-01 10:00:00,146,293,13,13,573,467,106,9
2891,2022-05-01 11:00:00,129,272,7,19,709,508,201,9
2892,2022-05-01 12:00:00,136,295,7,14,683,582,101,6
2893,2022-05-01 13:00:00,149,259,7,15,719,598,121,7
2894,2022-05-01 14:00:00,143,271,7,14,536,388,148,8
2895,2022-05-01 15:00:00,128,297,8,13,632,560,72,8
2896,2022-05-01 16:00:00,143,295,5,18,679,546,133,11
2897,2022-05-01 17:00:00,130,254,13,12,635,554,81,6
2898,2022-05-01 18:00:00,133,291,12,19,611,496,115,12
2899,2022-05-01 19:00:00,131,273,14,11,586,460,126,8
2900,2022-05-01 20:00:00,139,261,14,15,765,688,77,11
2901,2022-05-01 21:00:00,125,299,6,11,771,656,115,11
2902,2022-05-01 22:00:00,143,286,13,18,695,497,198,7
2903,2022-05-01 23:00:00,124,251,10,12,710,565,145,12
2904,2022-05-02 00:00:00,143,262,10,16,731,552,179,5
2905,2022-05-02 01:00:00,149,288,13,10,789,607,182,12
2906,2022-05-02 02:00:00,130,272,7,11,741,649,92,8
2907,2022-05-02 03:00:00,128,272,6,13,617,450,167,9
2908,2022-05-02 04:00:00,130,298,7,15,751,560,191,14
2909,2022-05-02 05:00:00,132,299,13,19,581,474,107,7
2910,2022-05-02 06:00:00,132,275,11,13,538,421,117,6
2911,2022-05-02 07:00:00,127,263,14,19,755,529,226,7
2912,2022-05-02 08:00:00,128,299,13,15,599,532,67,10
2913,2022-05-02 09:00:00,140,263,10,19,682,598,84,10
2914,2022-05-02 10:00:00,135,257,12,12,796,707,89,8
2915,2022-05-02 11:00:00,135,274,11,16,650,535,115,14
2916,2022-05-02 12:00:00,129,262,9,19,722,643,79,9
2917,2022-05-02 13:00:00,135,253,9,17,752,546,206,13
2918,2022-05-02 14:00:00,122,262,9,15,792,671,121,10
2919,2022-05-02 15:00:00,128,280,6,13,769,667,102,14
2920,2022-05-02 16:00:00,123,252,9,14,598,494,104,13
2921,2022-05-02 17:00:00,125,251,8,18,618,457,161,11
2922,2022-05-02 18:00:00,121,280,11,16,620,465,155,11
2923,2022-05-02 19:00:00,124,292,13,12,753,570,183,11
2924,2022-05-02 20:00:00,149,255,13,17,712,561,151,8
2925,2022-05-02 21:00:00,130,278,12,11,610,488,122,12
2926,2022-05-02 22:00:00,121,279,7,19,513,405,108,9
2927,2022-05-02 23:00:00,145,254,11,15,521,415,106,6
2928,2022-05-03 00:00:00,136,282,6,10,706,610,96,11
2929,2022-05-03 01:00:00,134,277,13,10,507,439,68,12
2930,2022-05-03 02:00:00,136,256,7,12,687,555,132,11
2931,2022-05-03 03:00:00,123,251,6,12,743,555,188,14
2932,2022-05-03 04:00:00,132,252,12,14,716,643,73,8
2933,2022-05-03 05:00:00,149,260,9,10,535,398,137,12
2934,2022-05-03 06:00:00,136,267,11,11,635,555,80,14
2935,2022-05-03 07:00:00,126,279,11,16,677,598,79,7
2936,2022-05-03 08:00:00,146,284,10,16,541,458,83,8
2937,2022-05-03 09:00:00,148,273,12,15,500,383,117,8
2938,2022-05-03 10:00:00,125,294,9,18,626,544,82,6
2939,2022-05-03 11:00:00,125,261,8,11,576,482,94,11
2940,2022-05-03 12:00:00,138,264,8,12,685,597,88,6
2941,2022-05-03 13:00:00,123,260,8,16,511,445,66,5
2942,2022-05-03 14:00:00,133,282,7,16,650,559,91,8
2943,2022-05-03 15:00:00,123,292,7,13,605,443,162,6
2944,2022-05-03 16:00:00,136,253,7,15,637,541,96,13
2945,2022-05-03 17:00:00,143,266,5,18,650,570,80,11
2946,2022-05-03 18:00:00,145,255,11,17,721,636,85,10
2947,2022-05-03 19:00:00,129,284,9,17,788,699,89,9
2948,2022-05-03 20:00:00,149,250,7,16,543,391,152,8
2949,2022-05-03 21:00:00,142,273,8,18,543,422,121,5
2950,2022-05-03 22:00:00,123,291,14,16,582,467,115,14
2951,2022-05-03 23:00:00,121,281,11,11,680,495,185,12
2952,2022-05-04 00:00:00,148,257,10,17,722,547,175,14
2953,2022-05-04 01:00:00,132,294,5,16,581,439,142,10
2954,2022-05-04 02:00:00,140,279,9,17,511,359,152,7
2955,2022-05-04 03:00:00,131,251,8,14,508,419,89,9
2956,2022-05-04 04:00:00,137,272,11,15,683,577,106,8
2957,2022-05-04 05:00:00,127,250,6,19,757,635,122,7
2958,2022-05-04 06:00:00,120,265,14,16,776,661,115,14
2959,2022-05-04 07:00:00,130,257,11,11,758,606,152,11
2960,2022-05-04 08:00:00,130,289,8,14,706,601,105,12
2961,2022-05-04 09:00:00,125,257,8,11,548,406,142,8
2962,2022-05-04 10:00:00,146,260,11,15,616,530,86,8
2963,2022-05-04 11:00:00,127,272,13,15,581,472,109,8
2964,2022-05-04 12:00:00,145,255,13,17,621,437,184,8
2965,2022-05-04 13:00:00,147,252,7,18,729,572,157,8
2966,2022-05-04 14:00:00,125,271,11,13,511,450,61,8
2967,2022-05-04 15:00:00,125,297,11,19,743,640,103,5
2968,2022-05-04 16:00:00,138,258,6,15,793,624,169,8
2969,2022-05-04 17:00:00,135,291,9,15,678,518,160,7
2970,2022-05-04 18:00:00,146,294,12,14,509,393,116,13
2971,2022-05-04 19:00:00,135,265,12,11,636,521,115,6
2972,2022-05-04 20:00:00,142,290,5,19,625,499,126,14
2973,2022-05-04 21:00:00,139,252,5,10,570,473,97,12
2974,2022-05-04 22:00:00,132,261,6,10,687,496,191,9
2975,2022-05-04 23:00:00,147,260,5,14,656,503,153,5
2976,2022-05-05 00:00:00,137,280,9,18,595,478,117,14
2977,2022-05-05 01:00:00,135,267,9,19,772,569,203,10
2978,2022-05-05 02:00:00,124,255,12,13,623,480,143,14
2979,2022-05-05 03:00:00,120,285,9,19,798,711,87,10
2980,2022-05-05 04:00:00,147,290,6,11,702,513,189,10
2981,2022-05-05 05:00:00,132,261,13,17,770,650,120,10
2982,2022-05-05 06:00:00,142,261,8,13,736,523,213,12
2983,2022-05-05 07:00:00,131,284,14,14,628,442,186,10
2984,2022-05-05 08:00:00,134,289,5,16,776,560,216,11
2985,2022-05-05 09:00:00,130,294,13,10,630,493,137,10
2986,2022-05-05 10:00:00,134,288,14,19,548,468,80,11
2987,2022-05-05 11:00:00,131,286,9,17,530,410,120,13
2988,2022-05-05 12:00:00,125,286,11,19,560,427,133,9
2989,2022-05-05 13:00:00,138,266,13,15,558,403,155,11
2990,2022-05-05 14:00:00,141,257,5,12,783,612,171,10
2991,2022-05-05 15:00:00,149,277,13,17,567,495,72,6
2992,2022-05-05 16:00:00,140,254,10,10,784,682,102,12
2993,2022-05-05 17:00:00,122,287,13,17,597,479,118,14
2994,2022-05-05 18:00:00,139,256,11,18,685,601,84,13
2995,2022-05-05 19:00:00,128,295,7,13,752,612,140,9
2996,2022-05-05 20:00:00,139,278,5,19,694,492,202,14
2997,2022-05-05 21:00:00,124,297,6,19,734,637,97,10
2998,2022-05-05 22:00:00,124,279,13,11,521,450,71,7
2999,2022-05-05 23:00:00,139,256,10,19,628,517,111,8
3000,2022-05-06 00:00:00,135,293,8,12,734,649,85,7
3001,2022-05-06 01:00:00,148,292,14,14,597,419,178,13
3002,2022-05-06 02:00:00,137,276,8,11,726,626,100,11
3003,2022-05-06 03:00:00,126,280,12,13,695,589,106,7
3004,2022-05-06 04:00:00,125,264,7,16,505,451,54,8
3005,2022-05-06 05:00:00,130,265,5,14,623,524,99,11
3006,2022-05-06 06:00:00,126,264,10,15,533,467,66,5
3007,2022-05-06 07:00:00,139,265,10,18,630,525,105,7
3008,2022-05-06 08:00:00,132,287,8,10,780,608,172,13
3009,2022-05-06 09:00:00,131,281,13,17,661,507,154,14
3010,2022-05-06 10:00:00,136,277,14,19,752,596,156,7
3011,2022-05-06 11:00:00,143,282,13,13,790,626,164,12
3012,2022-05-06 12:00:00,124,268,13,14,737,570,167,6
3013,2022-05-06 13:00:00,138,275,12,15,525,457,68,14
3014,2022-05-06 14:00:00,143,289,9,16,716,564,152,7
3015,2022-05-06 15:00:00,149,279,6,15,619,538,81,10
3016,2022-05-06 16:00:00,123,294,6,17,545,453,92,8
3017,2022-05-06 17:00:00,145,258,14,14,562,435,127,11
3018,2022-05-06 18:00:00,138,299,6,19,526,462,64,14
3019,2022-05-06 19:00:00,146,297,5,13,516,388,128,9
3020,2022-05-06 20:00:00,127,273,7,16,732,630,102,12
3021,2022-05-06 21:00:00,128,271,10,10,555,426,129,12
3022,2022-05-06 22:00:00,149,251,13,10,677,487,190,7
3023,2022-05-06 23:00:00,147,292,7,11,639,462,177,11
3024,2022-05-07 00:00:00,123,252,5,16,711,632,79,14
3025,2022-05-07 01:00:00,123,293,12,10,768,651,117,12
3026,2022-05-07 02:00:00,126,288,5,12,502,423,79,9
3027,2022-05-07 03:00:00,121,267,13,16,519,405,114,11
3028,2022-05-07 04:00:00,136,270,7,16,554,425,129,14
3029,2022-05-07 05:00:00,131,292,14,14,774,602,172,14
3030,2022-05-07 06:00:00,144,263,14,14,683,487,196,11
3031,2022-05-07 07:00:00,147,291,12,19,645,551,94,5
3032,2022-05-07 08:00:00,124,280,10,12,522,399,123,6
3033,2022-05-07 09:00:00,123,277,8,12,782,648,134,6
3034,2022-05-07 10:00:00,133,256,8,19,713,537,176,9
3035,2022-05-07 11:00:00,145,270,5,10,588,442,146,12
3036,2022-05-07 12:00:00,123,255,11,12,541,426,115,6
3037,2022-05-07 13:00:00,125,255,10,13,510,368,142,8
3038,2022-05-07 14:00:00,149,294,12,17,525,424,101,10
3039,2022-05-07 15:00:00,121,255,7,17,545,475,70,9
3040,2022-05-07 16:00:00,121,251,11,11,665,527,138,12
3041,2022-05-07 17:00:00,144,293,5,17,704,600,104,7
3042,2022-05-07 18:00:00,132,259,9,17,614,464,150,6
3043,2022-05-07 19:00:00,131,297,9,18,576,447,129,12
3044,2022-05-07 20:00:00,136,260,6,15,749,536,213,6
3045,2022-05-07 21:00:00,140,275,12,13,547,446,101,14
3046,2022-05-07 22:00:00,138,271,6,15,717,570,147,11
3047,2022-05-07 23:00:00,132,253,6,19,659,574,85,12
3048,2022-05-08 00:00:00,147,260,8,17,601,463,138,5
3049,2022-05-08 01:00:00,145,259,5,19,742,577,165,14
3050,2022-05-08 02:00:00,135,253,9,11,686,481,205,6
3051,2022-05-08 03:00:00,128,267,9,19,567,403,164,5
3052,2022-05-08 04:00:00,139,254,10,13,761,572,189,6
3053,2022-05-08 05:00:00,138,278,7,17,696,492,204,9
3054,2022-05-08 06:00:00,133,260,11,11,635,449,186,10
3055,2022-05-08 07:00:00,139,251,10,16,776,624,152,13
3056,2022-05-08 08:00:00,138,266,13,11,536,405,131,13
3057,2022-05-08 09:00:00,139,291,6,18,662,520,142,8
3058,2022-05-08 10:00:00,129,265,7,12,698,526,172,14
3059,2022-05-08 11:00:00,143,282,13,19,772,652,120,12
3060,2022-05-08 12:00:00,142,275,7,10,653,570,83,8
3061,2022-05-08 13:00:00,135,294,11,16,599,424,175,7
3062,2022-05-08 14:00:00,129,271,7,16,617,476,141,13
3063,2022-05-08 15:00:00,129,271,13,19,764,552,212,12
3064,2022-05-08 16:00:00,145,296,7,12,798,570,228,13
3065,2022-05-08 17:00:00,145,262,14,19,501,360,141,12
3066,2022-05-08 18:00:00,133,259,8,10,595,513,82,9
3067,2022-05-08 19:00:00,135,256,6,16,753,537,216,6
3068,2022-05-08 20:00:00,130,279,13,16,627,481,146,13
3069,2022-05-08 21:00:00,140,265,12,16,760,538,222,7
3070,2022-05-08 22:00:00,148,274,7,12,557,483,74,13
3071,2022-05-08 23:00:00,146,254,7,15,589,464,125,11
3072,2022-05-09 00:00:00,134,280,7,14,526,398,128,7
3073,2022-05-09 01:00:00,121,278,11,15,714,575,139,9
3074,2022-05-09 02:00:00,135,289,11,18,791,645,146,9
3075,2022-05-09 03:00:00,131,285,5,18,515,427,88,5
3076,2022-05-09 04:00:00,125,255,7,15,638,478,160,9
3077,2022-05-09 05:00:00,125,281,7,17,634,496,138,13
3078,2022-05-09 06:00:00,140,282,13,10,700,496,204,8
3079,2022-05-09 07:00:00,131,288,6,19,628,494,134,14
3080,2022-05-09 08:00:00,138,257,7,19,551,413,138,9
3081,2022-05-09 09:00:00,122,275,6,12,779,602,177,7
3082,2022-05-09 10:00:00,127,263,12,14,689,614,75,14
3083,2022-05-09 11:00:00,129,281,12,18,597,430,167,14
3084,2022-05-09 12:00:00,125,299,6,11,657,479,178,7
3085,2022-05-09 13:00:00,123,279,14,12,737,576,161,11
3086,2022-05-09 14:00:00,143,276,7,10,539,418,121,5
3087,2022-05-09 15:00:00,148,266,13,10,775,662,113,11
3088,2022-05-09 16:00:00,143,288,6,12,603,474,129,10
3089,2022-05-09 17:00:00,132,267,7,14,596,489,107,5
3090,2022-05-09 18:00:00,148,280,12,10,502,417,85,8
3091,2022-05-09 19:00:00,144,293,8,17,780,661,119,11
3092,2022-05-09 20:00:00,138,273,7,16,541,414,127,6
3093,2022-05-09 21:00:00,147,290,5,15,613,430,183,9
3094,2022-05-09 22:00:00,133,294,6,16,574,423,151,11
3095,2022-05-09 23:00:00,121,271,14,15,738,583,155,11
3096,2022-05-10 00:00:00,128,251,8,15,760,666,94,7
3097,2022-05-10 01:00:00,140,260,5,11,502,428,74,14
3098,2022-05-10 02:00:00,140,269,5,14,732,638,94,10
3099,2022-05-10 03:00:00,137,286,12,19,518,394,124,10
3100,2022-05-10 04:00:00,144,250,14,12,566,432,134,8
3101,2022-05-10 05:00:00,138,259,9,19,567,508,59,14
3102,2022-05-10 06:00:00,136,276,14,12,578,518,60,10
3103,2022-05-10 07:00:00,147,275,9,10,634,451,183,8
3104,2022-05-10 08:00:00,135,261,11,17,768,640,128,13
3105,2022-05-10 09:00:00,144,272,7,18,523,377,146,8
3106,2022-05-10 10:00:00,132,289,12,19,518,369,149,11
3107,2022-05-10 11:00:00,131,256,5,18,524,429,95,6
3108,2022-05-10 12:00:00,137,278,13,11,699,569,130,6
3109,2022-05-10 13:00:00,126,293,11,13,774,650,124,7
3110,2022-05-10 14:00:00,126,265,11,10,686,570,116,12
3111,2022-05-10 15:00:00,134,293,7,17,517,437,80,14
3112,2022-05-10 16:00:00,135,295,14,14,666,517,149,7
3113,2022-05-10 17:00:00,135,256,10,16,516,442,74,12
3114,2022-05-10 18:00:00,143,270,9,18,653,530,123,5
3115,2022-05-10 19:00:00,147,298,7,17,517,461,56,11
3116,2022-05-10 20:00:00,125,269,14,15,765,630,135,10
3117,2022-05-10 21:00:00,122,262,10,15,748,577,171,14
3118,2022-05-10 22:00:00,129,276,14,15,690,483,207,13
3119,2022-05-10 23:00:00,133,268,13,13,637,527,110,7
3120,2022-05-11 00:00:00,147,298,11,14,798,579,219,8
3121,2022-05-11 01:00:00,133,296,11,18,577,437,140,5
3122,2022-05-11 02:00:00,121,258,8,12,591,420,171,7
3123,2022-05-11 03:00:00,143,267,6,11,759,645,114,8
3124,2022-05-11 04:00:00,130,256,10,13,680,554,126,8
3125,2022-05-11 05:00:00,123,268,10,17,621,484,137,5
3126,2022-05-11 06:00:00,134,276,13,15,747,562,185,12
3127,2022-05-11 07:00:00,149,292,10,15,776,608,168,9
3128,2022-05-11 08:00:00,134,265,10,14,745,669,76,14
3129,2022-05-11 09:00:00,137,282,11,17,742,607,135,9
3130,2022-05-11 10:00:00,130,280,11,14,726,613,113,11
3131,2022-05-11 11:00:00,146,259,9,17,779,622,157,13
3132,2022-05-11 12:00:00,133,256,10,13,504,434,70,6
3133,2022-05-11 13:00:00,124,299,5,12,537,458,79,12
3134,2022-05-11 14:00:00,138,255,9,10,696,580,116,10
3135,2022-05-11 15:00:00,135,256,7,16,626,525,101,12
3136,2022-05-11 16:00:00,148,266,10,17,531,384,147,11
3137,2022-05-11 17:00:00,123,256,13,13,638,470,168,6
3138,2022-05-11 18:00:00,135,271,10,16,533,404,129,5
3139,2022-05-11 19:00:00,138,255,9,18,793,702,91,9
3140,2022-05-11 20:00:00,141,285,11,11,621,486,135,5
3141,2022-05-11 21:00:00,138,256,7,12,651,576,75,13
3142,2022-05-11 22:00:00,129,260,14,19,687,542,145,11
3143,2022-05-11 23:00:00,134,261,12,11,560,428,132,7
3144,2022-05-12 00:00:00,149,282,13,15,777,671,106,10
3145,2022-05-12 01:00:00,148,265,7,10,577,434,143,12
3146,2022-05-12 02:00:00,127,253,11,16,528,409,119,12
3147,2022-05-12 03:00:00,139,254,8,19,635,542,93,7
3148,2022-05-12 04:00:00,128,256,9,15,690,516,174,14
3149,2022-05-12 05:00:00,126,256,12,14,784,667,117,9
3150,2022-05-12 06:00:00,138,269,8,11,734,599,135,5
3151,2022-05-12 07:00:00,148,250,9,19,515,462,53,9
3152,2022-05-12 08:00:00,120,269,9,14,719,614,105,9
3153,2022-05-12 09:00:00,127,275,11,18,536,441,95,6
3154,2022-05-12 10:00:00,127,253,13,12,704,583,121,9
3155,2022-05-12 11:00:00,128,295,11,14,687,532,155,7
3156,2022-05-12 12:00:00,140,296,9,10,710,606,104,5
3157,2022-05-12 13:00:00,143,261,13,18,544,485,59,7
3158,2022-05-12 14:00:00,124,253,10,18,552,433,119,10
3159,2022-05-12 15:00:00,142,287,9,11,638,545,93,9
3160,2022-05-12 16:00:00,127,254,13,18,724,617,107,7
3161,2022-05-12 17:00:00,121,268,9,12,671,538,133,14
3162,2022-05-12 18:00:00,143,278,10,17,665,474,191,6
3163,2022-05-12 19:00:00,121,286,12,14,508,361,147,10
3164,2022-05-12 20:00:00,137,291,14,12,670,496,174,6
3165,2022-05-12 21:00:00,129,265,13,17,673,506,167,8
3166,2022-05-12 22:00:00,149,295,10,15,617,519,98,10
3167,2022-05-12 23:00:00,139,265,13,10,642,503,139,14
3168,2022-05-13 00:00:00,141,286,13,19,714,615,99,13
3169,2022-05-13 01:00:00,131,270,13,10,610,484,126,5
3170,2022-05-13 02:00:00,139,287,6,13,650,501,149,11
3171,2022-05-13 03:00:00,121,274,5,16,615,533,82,9
3172,2022-05-13 04:00:00,135,276,6,14,673,498,175,13
3173,2022-05-13 05:00:00,139,289,14,18,616,545,71,10
3174,2022-05-13 06:00:00,123,271,8,13,713,600,113,9
3175,2022-05-13 07:00:00,125,255,9,19,574,507,67,5
3176,2022-05-13 08:00:00,130,279,10,16,650,559,91,10
3177,2022-05-13 09:00:00,147,288,5,18,715,609,106,5
3178,2022-05-13 10:00:00,149,268,8,14,632,549,83,7
3179,2022-05-13 11:00:00,141,284,8,16,506,451,55,8
3180,2022-05-13 12:00:00,123,267,8,16,505,404,101,7
3181,2022-05-13 13:00:00,134,286,7,12,615,546,69,11
3182,2022-05-13 14:00:00,142,292,8,17,627,508,119,6
3183,2022-05-13 15:00:00,148,269,7,14,704,526,178,9
3184,2022-05-13 16:00:00,149,279,9,11,655,538,117,10
3185,2022-05-13 17:00:00,130,268,7,12,566,402,164,13
3186,2022-05-13 18:00:00,135,266,12,15,503,370,133,10
3187,2022-05-13 19:00:00,124,283,6,13,733,532,201,9
3188,2022-05-13 20:00:00,130,288,12,17,671,555,116,10
3189,2022-05-13 21:00:00,135,276,9,12,526,374,152,11
3190,2022-05-13 22:00:00,134,276,10,16,655,502,153,8
3191,2022-05-13 23:00:00,123,262,11,19,786,654,132,9
3192,2022-05-14 00:00:00,146,265,14,15,727,515,212,8
3193,2022-05-14 01:00:00,128,266,13,19,586,510,76,9
3194,2022-05-14 02:00:00,120,272,12,12,711,601,110,11
3195,2022-05-14 03:00:00,128,262,14,18,531,460,71,6
3196,2022-05-14 04:00:00,140,298,10,14,563,444,119,14
3197,2022-05-14 05:00:00,145,269,11,13,562,449,113,7
3198,2022-05-14 06:00:00,142,250,13,14,634,486,148,11
3199,2022-05-14 07:00:00,127,254,5,12,628,470,158,13
3200,2022-05-14 08:00:00,149,253,10,16,550,387,163,14
3201,2022-05-14 09:00:00,145,295,6,16,597,445,152,7
3202,2022-05-14 10:00:00,142,292,12,15,611,446,165,8
3203,2022-05-14 11:00:00,121,287,12,14,787,607,180,8
3204,2022-05-14 12:00:00,121,267,7,19,785,598,187,9
3205,2022-05-14 13:00:00,124,257,11,13,501,359,142,12
3206,2022-05-14 14:00:00,128,276,7,19,574,478,96,12
3207,2022-05-14 15:00:00,134,274,12,14,628,515,113,7
3208,2022-05-14 16:00:00,129,271,9,13,717,638,79,14
3209,2022-05-14 17:00:00,123,275,7,19,669,522,147,8
3210,2022-05-14 18:00:00,149,254,11,10,686,487,199,7
3211,2022-05-14 19:00:00,136,288,9,17,707,590,117,8
3212,2022-05-14 20:00:00,131,252,6,16,719,510,209,5
3213,2022-05-14 21:00:00,141,263,5,15,640,523,117,8
3214,2022-05-14 22:00:00,139,291,10,17,752,581,171,10
3215,2022-05-14 23:00:00,139,289,5,16,519,461,58,13
3216,2022-05-15 00:00:00,128,261,14,15,677,558,119,6
3217,2022-05-15 01:00:00,122,298,7,19,703,519,184,12
3218,2022-05-15 02:00:00,121,281,8,18,633,512,121,10
3219,2022-05-15 03:00:00,127,285,6,18,752,538,214,13
3220,2022-05-15 04:00:00,122,282,13,17,641,497,144,10
3221,2022-05-15 05:00:00,145,298,11,12,673,533,140,10
3222,2022-05-15 06:00:00,129,281,8,19,549,427,122,10
3223,2022-05-15 07:00:00,144,296,11,16,536,431,105,12
3224,2022-05-15 08:00:00,126,270,13,15,661,588,73,8
3225,2022-05-15 09:00:00,146,251,5,11,620,498,122,5
3226,2022-05-15 10:00:00,144,296,10,19,775,596,179,5
3227,2022-05-15 11:00:00,136,270,8,17,780,677,103,8
3228,2022-05-15 12:00:00,133,285,14,16,709,535,174,7
3229,2022-05-15 13:00:00,140,271,13,19,685,491,194,10
3230,2022-05-15 14:00:00,123,267,14,17,668,519,149,9
3231,2022-05-15 15:00:00,138,276,5,15,602,492,110,8
3232,2022-05-15 16:00:00,126,267,9,10,543,386,157,8
3233,2022-05-15 17:00:00,121,253,14,16,677,578,99,5
3234,2022-05-15 18:00:00,137,275,13,15,678,578,100,13
3235,2022-05-15 19:00:00,134,293,9,17,696,544,152,14
3236,2022-05-15 20:00:00,127,295,6,14,718,620,98,7
3237,2022-05-15 21:00:00,121,289,8,11,790,691,99,11
3238,2022-05-15 22:00:00,136,264,11,15,778,560,218,7
3239,2022-05-15 23:00:00,127,280,13,12,780,609,171,14
3240,2022-05-16 00:00:00,138,285,7,19,664,557,107,9
3241,2022-05-16 01:00:00,147,294,13,17,603,435,168,11
3242,2022-05-16 02:00:00,122,291,5,19,748,653,95,6
3243,2022-05-16 03:00:00,148,269,10,16,622,463,159,7
3244,2022-05-16 04:00:00,130,283,5,12,545,395,150,6
3245,2022-05-16 05:00:00,125,253,11,16,572,452,120,14
3246,2022-05-16 06:00:00,137,259,10,11,795,569,226,7
3247,2022-05-16 07:00:00,136,283,11,17,631,517,114,7
3248,2022-05-16 08:00:00,124,270,14,17,765,556,209,11
3249,2022-05-16 09:00:00,149,253,11,11,770,661,109,8
3250,2022-05-16 10:00:00,122,255,14,13,567,477,90,14
3251,2022-05-16 11:00:00,138,278,9,13,564,425,139,11
3252,2022-05-16 12:00:00,123,280,12,14,623,537,86,6
3253,2022-05-16 13:00:00,148,263,9,14,563,423,140,5
3254,2022-05-16 14:00:00,127,265,12,19,741,645,96,12
3255,2022-05-16 15:00:00,140,293,6,10,592,499,93,9
3256,2022-05-16 16:00:00,139,261,5,16,795,680,115,11
3257,2022-05-16 17:00:00,143,298,7,19,660,577,83,6
3258,2022-05-16 18:00:00,131,267,7,14,708,516,192,10
3259,2022-05-16 19:00:00,124,283,9,16,649,560,89,6
3260,2022-05-16 20:00:00,140,255,6,13,794,703,91,14
3261,2022-05-16 21:00:00,144,286,6,19,505,360,145,7
3262,2022-05-16 22:00:00,137,252,12,13,516,458,58,9
3263,2022-05-16 23:00:00,137,293,14,19,560,412,148,14
3264,2022-05-17 00:00:00,134,295,10,12,722,578,144,14
3265,2022-05-17 01:00:00,120,291,11,19,591,440,151,9
3266,2022-05-17 02:00:00,132,271,14,10,652,504,148,13
3267,2022-05-17 03:00:00,140,298,13,17,515,383,132,11
3268,2022-05-17 04:00:00,141,273,12,16,717,587,130,5
3269,2022-05-17 05:00:00,136,259,5,18,739,626,113,10
3270,2022-05-17 06:00:00,140,289,11,15,788,601,187,8
3271,2022-05-17 07:00:00,134,284,12,12,701,555,146,11
3272,2022-05-17 08:00:00,139,294,12,11,557,400,157,8
3273,2022-05-17 09:00:00,142,280,10,10,637,552,85,9
3274,2022-05-17 10:00:00,140,252,6,15,526,400,126,9
3275,2022-05-17 11:00:00,136,289,8,14,675,513,162,12
3276,2022-05-17 12:00:00,131,281,10,19,787,661,126,7
3277,2022-05-17 13:00:00,131,276,8,15,575,406,169,10
3278,2022-05-17 14:00:00,126,286,10,11,755,565,190,10
3279,2022-05-17 15:00:00,127,259,13,15,655,542,113,10
3280,2022-05-17 16:00:00,120,258,7,13,660,475,185,11
3281,2022-05-17 17:00:00,121,266,12,18,657,582,75,14
3282,2022-05-17 18:00:00,136,253,10,14,789,564,225,9
3283,2022-05-17 19:00:00,130,281,11,16,580,430,150,9
3284,2022-05-17 20:00:00,123,285,8,14,547,402,145,12
3285,2022-05-17 21:00:00,123,250,11,12,677,571,106,14
3286,2022-05-17 22:00:00,139,298,11,16,519,419,100,13
3287,2022-05-17 23:00:00,141,277,6,19,509,361,148,14
3288,2022-05-18 00:00:00,129,285,5,14,635,547,88,12
3289,2022-05-18 01:00:00,122,289,6,14,617,518,99,14
3290,2022-05-18 02:00:00,122,294,13,16,778,643,135,10
3291,2022-05-18 03:00:00,148,271,5,10,592,484,108,13
3292,2022-05-18 04:00:00,122,299,13,13,724,582,142,6
3293,2022-05-18 05:00:00,125,287,8,19,574,430,144,13
3294,2022-05-18 06:00:00,127,266,6,11,691,539,152,12
3295,2022-05-18 07:00:00,136,255,14,14,537,420,117,6
3296,2022-05-18 08:00:00,129,292,7,11,702,615,87,6
3297,2022-05-18 09:00:00,124,280,13,14,755,570,185,11
3298,2022-05-18 10:00:00,124,261,11,18,668,513,155,6
3299,2022-05-18 11:00:00,143,254,11,14,763,593,170,12
3300,2022-05-18 12:00:00,141,271,13,14,582,408,174,9
3301,2022-05-18 13:00:00,134,278,9,13,790,659,131,9
3302,2022-05-18 14:00:00,143,274,14,19,772,545,227,8
3303,2022-05-18 15:00:00,138,294,11,17,698,620,78,13
3304,2022-05-18 16:00:00,137,271,9,14,618,546,72,9
3305,2022-05-18 17:00:00,138,273,7,16,513,404,109,12
3306,2022-05-18 18:00:00,126,283,11,14,553,471,82,12
3307,2022-05-18 19:00:00,144,275,6,15,662,536,126,13
3308,2022-05-18 20:00:00,144,273,12,19,585,425,160,11
3309,2022-05-18 21:00:00,134,279,6,19,732,533,199,11
3310,2022-05-18 22:00:00,145,284,14,13,714,619,95,12
3311,2022-05-18 23:00:00,133,253,13,10,654,585,69,12
3312,2022-05-19 00:00:00,124,250,8,15,517,390,127,5
3313,2022-05-19 01:00:00,147,291,6,18,662,499,163,9
3314,2022-05-19 02:00:00,146,266,12,14,669,519,150,7
3315,2022-05-19 03:00:00,128,253,11,12,672,489,183,13
3316,2022-05-19 04:00:00,139,277,5,18,504,357,147,11
3317,2022-05-19 05:00:00,148,265,12,12,714,622,92,12
3318,2022-05-19 06:00:00,145,292,14,17,576,488,88,5
3319,2022-05-19 07:00:00,137,261,13,11,551,416,135,6
3320,2022-05-19 08:00:00,125,293,9,13,613,429,184,5
3321,2022-05-19 09:00:00,138,294,8,18,681,521,160,11
3322,2022-05-19 10:00:00,126,250,11,11,705,605,100,7
3323,2022-05-19 11:00:00,121,270,12,16,527,377,150,5
3324,2022-05-19 12:00:00,144,274,10,15,797,613,184,14
3325,2022-05-19 13:00:00,135,272,6,12,598,498,100,13
3326,2022-05-19 14:00:00,149,257,13,10,678,497,181,6
3327,2022-05-19 15:00:00,121,255,7,19,750,670,80,13
3328,2022-05-19 16:00:00,145,260,9,19,551,493,58,10
3329,2022-05-19 17:00:00,120,296,14,19,784,624,160,9
3330,2022-05-19 18:00:00,148,262,14,15,737,659,78,10
3331,2022-05-19 19:00:00,127,260,12,12,568,435,133,7
3332,2022-05-19 20:00:00,145,262,14,19,718,597,121,11
3333,2022-05-19 21:00:00,125,261,8,13,749,570,179,13
3334,2022-05-19 22:00:00,139,286,6,11,795,598,197,14
3335,2022-05-19 23:00:00,142,279,10,13,541,470,71,14
3336,2022-05-20 00:00:00,121,253,5,12,586,452,134,13
3337,2022-05-20 01:00:00,149,252,12,13,613,519,94,5
3338,2022-05-20 02:00:00,141,259,9,10,654,478,176,8
3339,2022-05-20 03:00:00,143,278,7,17,566,399,167,5
3340,2022-05-20 04:00:00,146,284,10,15,652,553,99,12
3341,2022-05-20 05:00:00,144,250,5,14,587,419,168,11
3342,2022-05-20 06:00:00,147,288,11,17,656,553,103,9
3343,2022-05-20 07:00:00,134,296,6,19,616,473,143,9
3344,2022-05-20 08:00:00,141,274,6,12,798,694,104,7
3345,2022-05-20 09:00:00,148,272,9,17,708,564,144,12
3346,2022-05-20 10:00:00,133,251,13,12,704,568,136,6
3347,2022-05-20 11:00:00,146,274,11,10,516,376,140,10
3348,2022-05-20 12:00:00,135,293,13,17,636,477,159,7
3349,2022-05-20 13:00:00,141,263,13,15,559,483,76,5
3350,2022-05-20 14:00:00,134,282,12,16,789,587,202,5
3351,2022-05-20 15:00:00,141,264,7,12,755,575,180,11
3352,2022-05-20 16:00:00,134,251,9,10,724,538,186,12
3353,2022-05-20 17:00:00,140,263,13,11,608,515,93,14
3354,2022-05-20 18:00:00,138,254,13,15,726,589,137,8
3355,2022-05-20 19:00:00,137,281,14,12,798,637,161,11
3356,2022-05-20 20:00:00,141,285,8,13,519,421,98,11
3357,2022-05-20 21:00:00,142,292,5,19,660,586,74,6
3358,2022-05-20 22:00:00,149,282,12,13,667,558,109,8
3359,2022-05-20 23:00:00,120,252,10,19,659,591,68,12
3360,2022-05-21 00:00:00,135,288,9,10,631,531,100,8
3361,2022-05-21 01:00:00,147,263,14,18,515,423,92,11
3362,2022-05-21 02:00:00,120,279,9,19,596,483,113,5
3363,2022-05-21 03:00:00,139,288,5,12,515,438,77,6
3364,2022-05-21 04:00:00,145,255,10,12,556,499,57,11
3365,2022-05-21 05:00:00,124,299,14,15,660,558,102,9
3366,2022-05-21 06:00:00,133,293,14,15,560,496,64,14
3367,2022-05-21 07:00:00,129,256,7,10,517,394,123,6
3368,2022-05-21 08:00:00,120,274,13,17,754,548,206,9
3369,2022-05-21 09:00:00,126,272,8,11,574,448,126,9
3370,2022-05-21 10:00:00,145,254,12,14,566,406,160,5
3371,2022-05-21 11:00:00,134,287,8,14,731,585,146,8
3372,2022-05-21 12:00:00,138,294,13,15,757,558,199,14
3373,2022-05-21 13:00:00,135,290,14,14,650,567,83,9
3374,2022-05-21 14:00:00,128,295,10,17,687,481,206,6
3375,2022-05-21 15:00:00,134,262,14,13,692,592,100,8
3376,2022-05-21 16:00:00,147,264,7,18,656,530,126,5
3377,2022-05-21 17:00:00,139,263,9,13,641,454,187,13
3378,2022-05-21 18:00:00,124,260,7,18,516,397,119,7
3379,2022-05-21 19:00:00,148,252,9,12,771,586,185,7
3380,2022-05-21 20:00:00,121,263,11,16,730,606,124,14
3381,2022-05-21 21:00:00,129,261,7,15,640,560,80,9
3382,2022-05-21 22:00:00,145,295,11,19,594,476,118,12
3383,2022-05-21 23:00:00,126,289,14,12,672,601,71,13
3384,2022-05-22 00:00:00,130,257,10,18,516,445,71,9
3385,2022-05-22 01:00:00,143,289,10,10,705,622,83,5
3386,2022-05-22 02:00:00,121,253,11,12,627,530,97,14
3387,2022-05-22 03:00:00,127,275,11,12,727,533,194,7
3388,2022-05-22 04:00:00,130,263,7,16,713,531,182,7
3389,2022-05-22 05:00:00,145,254,14,14,668,551,117,10
3390,2022-05-22 06:00:00,131,270,5,11,516,409,107,13
3391,2022-05-22 07:00:00,121,259,12,16,734,521,213,10
3392,2022-05-22 08:00:00,149,295,6,19,564,414,150,14
3393,2022-05-22 09:00:00,139,286,12,16,534,451,83,6
3394,2022-05-22 10:00:00,143,296,9,12,685,528,157,10
3395,2022-05-22 11:00:00,127,267,6,11,688,587,101,12
3396,2022-05-22 12:00:00,129,253,11,10,752,551,201,6
3397,2022-05-22 13:00:00,145,259,6,15,506,432,74,8
3398,2022-05-22 14:00:00,126,258,8,13,695,531,164,8
3399,2022-05-22 15:00:00,148,267,11,11,644,494,150,12
3400,2022-05-22 16:00:00,128,256,10,19,521,427,94,10
3401,2022-05-22 17:00:00,137,262,11,13,764,643,121,8
3402,2022-05-22 18:00:00,126,287,11,13,678,608,70,6
3403,2022-05-22 19:00:00,136,254,7,16,765,598,167,7
3404,2022-05-22 20:00:00,139,274,7,10,688,595,93,7
3405,2022-05-22 21:00:00,124,276,5,12,533,418,115,12
3406,2022-05-22 22:00:00,140,298,13,18,674,524,150,7
3407,2022-05-22 23:00:00,134,268,6,11,720,596,124,14
3408,2022-05-23 00:00:00,146,284,9,19,593,483,110,7
3409,2022-05-23 01:00:00,147,288,13,16,634,549,85,5
3410,2022-05-23 02:00:00,142,293,13,13,772,633,139,5
3411,2022-05-23 03:00:00,122,299,8,18,682,524,158,12
3412,2022-05-23 04:00:00,140,265,10,15,614,458,156,9
3413,2022-05-23 05:00:00,129,253,12,14,526,454,72,11
3414,2022-05-23 06:00:00,126,297,8,16,698,531,167,13
3415,2022-05-23 07:00:00,123,294,7,16,757,543,214,11
3416,2022-05-23 08:00:00,135,299,7,17,760,567,193,13
3417,2022-05-23 09:00:00,133,281,13,15,519,397,122,13
3418,2022-05-23 10:00:00,131,259,6,13,522,394,128,6
3419,2022-05-23 11:00:00,124,276,7,12,609,461,148,11
3420,2022-05-23 12:00:00,131,287,7,17,503,381,122,6
3421,2022-05-23 13:00:00,130,277,6,14,786,650,136,5
3422,2022-05-23 14:00:00,140,298,6,10,697,515,182,10
3423,2022-05-23 15:00:00,139,264,13,18,582,470,112,14
3424,2022-05-23 16:00:00,121,256,8,11,717,609,108,6
3425,2022-05-23 17:00:00,126,289,10,11,610,548,62,7
3426,2022-05-23 18:00:00,120,280,6,14,700,565,135,13
3427,2022-05-23 19:00:00,127,285,6,18,500,385,115,7
3428,2022-05-23 20:00:00,144,291,10,14,656,541,115,12
3429,2022-05-23 21:00:00,139,265,14,11,654,548,106,7
3430,2022-05-23 22:00:00,136,260,8,15,767,539,228,10
3431,2022-05-23 23:00:00,140,279,7,10,745,607,138,11
3432,2022-05-24 00:00:00,138,254,13,18,632,488,144,6
3433,2022-05-24 01:00:00,140,269,6,14,549,473,76,7
3434,2022-05-24 02:00:00,141,272,11,11,532,392,140,10
3435,2022-05-24 03:00:00,141,298,14,13,536,444,92,13
3436,2022-05-24 04:00:00,143,271,6,16,507,422,85,6
3437,2022-05-24 05:00:00,131,277,5,14,632,461,171,8
3438,2022-05-24 06:00:00,127,258,5,19,584,425,159,9
3439,2022-05-24 07:00:00,143,281,13,17,569,486,83,9
3440,2022-05-24 08:00:00,140,264,14,17,686,486,200,11
3441,2022-05-24 09:00:00,143,256,7,14,757,614,143,10
3442,2022-05-24 10:00:00,146,272,9,10,517,427,90,6
3443,2022-05-24 11:00:00,132,253,8,11,500,437,63,12
3444,2022-05-24 12:00:00,124,256,11,12,770,604,166,14
3445,2022-05-24 13:00:00,131,275,11,15,656,504,152,5
3446,2022-05-24 14:00:00,131,298,5,10,640,476,164,9
3447,2022-05-24 15:00:00,138,266,6,15,627,514,113,7
3448,2022-05-24 16:00:00,140,280,11,17,649,528,121,11
3449,2022-05-24 17:00:00,128,271,14,19,564,455,109,14
3450,2022-05-24 18:00:00,131,288,14,13,518,402,116,9
3451,2022-05-24 19:00:00,132,291,14,10,668,486,182,9
3452,2022-05-24 20:00:00,147,273,9,10,668,572,96,8
3453,2022-05-24 21:00:00,129,289,8,12,506,422,84,12
3454,2022-05-24 22:00:00,131,276,12,18,550,451,99,9
3455,2022-05-24 23:00:00,137,251,10,19,610,477,133,7
3456,2022-05-25 00:00:00,136,279,7,11,615,434,181,14
3457,2022-05-25 01:00:00,130,280,9,13,764,565,199,5
3458,2022-05-25 02:00:00,123,299,8,11,513,412,101,9
3459,2022-05-25 03:00:00,146,257,9,15,561,488,73,12
3460,2022-05-25 04:00:00,131,254,11,12,590,509,81,5
3461,2022-05-25 05:00:00,147,279,9,15,758,560,198,12
3462,2022-05-25 06:00:00,137,277,11,14,595,447,148,6
3463,2022-05-25 07:00:00,121,261,8,17,542,441,101,12
3464,2022-05-25 08:00:00,130,274,5,12,711,600,111,10
3465,2022-05-25 09:00:00,139,293,13,13,642,493,149,11
3466,2022-05-25 10:00:00,130,252,7,14,786,641,145,10
3467,2022-05-25 11:00:00,129,272,9,18,568,465,103,14
3468,2022-05-25 12:00:00,126,291,11,12,650,520,130,14
3469,2022-05-25 13:00:00,134,258,13,15,705,626,79,14
3470,2022-05-25 14:00:00,128,279,13,11,500,386,114,6
3471,2022-05-25 15:00:00,147,260,14,11,530,413,117,12
3472,2022-05-25 16:00:00,134,285,14,14,670,483,187,10
3473,2022-05-25 17:00:00,137,274,7,11,555,481,74,5
3474,2022-05-25 18:00:00,137,267,9,13,670,598,72,8
3475,2022-05-25 19:00:00,145,297,5,16,671,520,151,13
3476,2022-05-25 20:00:00,135,292,9,16,625,467,158,14
3477,2022-05-25 21:00:00,147,295,12,18,755,549,206,7
3478,2022-05-25 22:00:00,139,273,8,11,768,597,171,12
3479,2022-05-25 23:00:00,120,253,12,18,562,444,118,12
3480,2022-05-26 00:00:00,144,261,11,12,743,602,141,10
3481,2022-05-26 01:00:00,145,293,6,16,749,596,153,8
3482,2022-05-26 02:00:00,140,269,5,15,740,581,159,7
3483,2022-05-26 03:00:00,131,297,11,13,690,616,74,8
3484,2022-05-26 04:00:00,136,297,5,19,699,606,93,6
3485,2022-05-26 05:00:00,140,283,11,16,643,538,105,10
3486,2022-05-26 06:00:00,138,271,11,16,599,424,175,9
3487,2022-05-26 07:00:00,142,284,12,17,758,532,226,5
3488,2022-05-26 08:00:00,134,291,7,17,768,684,84,9
3489,2022-05-26 09:00:00,149,256,10,17,577,469,108,14
3490,2022-05-26 10:00:00,126,258,14,14,596,520,76,9
3491,2022-05-26 11:00:00,140,297,8,18,760,596,164,7
3492,2022-05-26 12:00:00,126,284,7,12,744,600,144,11
3493,2022-05-26 13:00:00,132,260,10,14,504,407,97,6
3494,2022-05-26 14:00:00,140,257,5,15,601,449,152,14
3495,2022-05-26 15:00:00,122,267,13,13,702,621,81,6
3496,2022-05-26 16:00:00,147,296,14,17,742,543,199,9
3497,2022-05-26 17:00:00,147,270,11,13,784,664,120,9
3498,2022-05-26 18:00:00,136,260,7,12,627,535,92,10
3499,2022-05-26 19:00:00,129,268,12,19,720,557,163,7
3500,2022-05-26 20:00:00,122,292,6,18,650,569,81,13
3501,2022-05-26 21:00:00,120,287,10,10,768,582,186,12
3502,2022-05-26 22:00:00,129,288,7,18,574,474,100,8
3503,2022-05-26 23:00:00,127,283,8,11,787,595,192,14
3504,2022-05-27 00:00:00,138,276,7,10,773,547,226,14
3505,2022-05-27 01:00:00,123,270,11,18,744,545,199,6
3506,2022-05-27 02:00:00,142,274,10,13,584,413,171,11
3507,2022-05-27 03:00:00,133,281,6,16,580,442,138,8
3508,2022-05-27 04:00:00,130,291,7,18,795,577,218,8
3509,2022-05-27 05:00:00,128,254,9,14,659,551,108,8
3510,2022-05-27 06:00:00,126,287,12,15,665,475,190,13
3511,2022-05-27 07:00:00,131,269,10,15,517,363,154,7
3512,2022-05-27 08:00:00,144,272,14,14,614,509,105,10
3513,2022-05-27 09:00:00,134,273,13,19,634,484,150,5
3514,2022-05-27 10:00:00,126,289,9,15,554,472,82,7
3515,2022-05-27 11:00:00,135,286,9,10,601,530,71,13
3516,2022-05-27 12:00:00,124,274,14,12,756,669,87,13
3517,2022-05-27 13:00:00,149,297,5,10,728,535,193,9
3518,2022-05-27 14:00:00,133,250,10,15,597,453,144,12
3519,2022-05-27 15:00:00,122,271,8,13,706,593,113,6
3520,2022-05-27 16:00:00,144,288,5,18,634,454,180,9
3521,2022-05-27 17:00:00,139,279,14,18,739,662,77,6
3522,2022-05-27 18:00:00,132,266,7,15,667,515,152,10
3523,2022-05-27 19:00:00,123,259,8,15,707,559,148,10
3524,2022-05-27 20:00:00,140,263,6,11,663,477,186,13
3525,2022-05-27 21:00:00,135,259,5,17,506,427,79,10
3526,2022-05-27 22:00:00,149,259,12,18,716,600,116,14
3527,2022-05-27 23:00:00,128,286,7,13,621,476,145,7
3528,2022-05-28 00:00:00,142,299,13,13,764,596,168,11
3529,2022-05-28 01:00:00,136,293,14,12,585,519,66,8
3530,2022-05-28 02:00:00,129,269,11,10,661,543,118,8
3531,2022-05-28 03:00:00,146,271,8,14,696,504,192,8
3532,2022-05-28 04:00:00,149,280,10,16,668,503,165,6
3533,2022-05-28 05:00:00,144,296,14,14,709,512,197,13
3534,2022-05-28 06:00:00,145,298,14,18,722,515,207,14
3535,2022-05-28 07:00:00,139,297,6,11,633,548,85,13
3536,2022-05-28 08:00:00,147,251,10,18,617,504,113,14
3537,2022-05-28 09:00:00,125,294,8,13,709,511,198,6
3538,2022-05-28 10:00:00,139,287,14,14,543,414,129,6
3539,2022-05-28 11:00:00,149,266,11,15,675,496,179,9
3540,2022-05-28 12:00:00,136,296,5,18,540,473,67,6
3541,2022-05-28 13:00:00,129,268,11,10,511,376,135,9
3542,2022-05-28 14:00:00,138,297,13,18,649,520,129,10
3543,2022-05-28 15:00:00,130,250,11,17,624,468,156,12
3544,2022-05-28 16:00:00,146,299,14,18,794,620,174,5
3545,2022-05-28 17:00:00,142,287,5,17,546,416,130,13
3546,2022-05-28 18:00:00,120,294,10,19,697,600,97,13
3547,2022-05-28 19:00:00,144,299,9,17,749,627,122,10
3548,2022-05-28 20:00:00,130,288,10,11,577,507,70,13
3549,2022-05-28 21:00:00,143,285,5,13,589,468,121,12
3550,2022-05-28 22:00:00,124,291,7,11,594,473,121,13
3551,2022-05-28 23:00:00,137,273,9,18,684,603,81,13
3552,2022-05-29 00:00:00,126,272,9,12,504,391,113,11
3553,2022-05-29 01:00:00,149,293,12,10,771,658,113,11
3554,2022-05-29 02:00:00,141,289,7,14,768,656,112,11
3555,2022-05-29 03:00:00,121,255,5,11,557,464,93,14
3556,2022-05-29 04:00:00,126,256,14,18,573,414,159,9
3557,2022-05-29 05:00:00,147,267,5,18,796,598,198,11
3558,2022-05-29 06:00:00,142,281,10,19,720,646,74,11
3559,2022-05-29 07:00:00,142,290,11,16,739,535,204,5
3560,2022-05-29 08:00:00,139,298,11,16,771,632,139,14
3561,2022-05-29 09:00:00,135,284,10,19,560,395,165,14
3562,2022-05-29 10:00:00,124,297,14,11,675,521,154,5
3563,2022-05-29 11:00:00,148,296,5,18,670,484,186,6
3564,2022-05-29 12:00:00,147,254,5,18,795,668,127,9
3565,2022-05-29 13:00:00,138,265,12,11,753,588,165,14
3566,2022-05-29 14:00:00,134,266,8,16,604,432,172,14
3567,2022-05-29 15:00:00,135,298,14,12,666,506,160,6
3568,2022-05-29 16:00:00,125,277,12,11,551,454,97,12
3569,2022-05-29 17:00:00,149,277,10,15,645,559,86,14
3570,2022-05-29 18:00:00,147,264,9,14,574,408,166,10
3571,2022-05-29 19:00:00,128,297,8,11,662,467,195,9
3572,2022-05-29 20:00:00,141,282,8,19,653,541,112,7
3573,2022-05-29 21:00:00,131,255,10,13,772,663,109,11
3574,2022-05-29 22:00:00,128,258,7,19,704,615,89,14
3575,2022-05-29 23:00:00,139,273,5,17,787,700,87,8
3576,2022-05-30 00:00:00,126,254,6,16,718,621,97,10
3577,2022-05-30 01:00:00,139,265,9,14,516,393,123,6
3578,2022-05-30 02:00:00,131,274,8,12,613,505,108,6
3579,2022-05-30 03:00:00,143,299,13,13,797,603,194,11
3580,2022-05-30 04:00:00,131,295,8,18,638,451,187,6
3581,2022-05-30 05:00:00,139,299,13,14,603,534,69,6
3582,2022-05-30 06:00:00,148,281,9,19,661,579,82,7
3583,2022-05-30 07:00:00,132,260,7,14,689,536,153,5
3584,2022-05-30 08:00:00,143,276,7,15,769,663,106,8
3585,2022-05-30 09:00:00,126,261,11,10,734,543,191,13
3586,2022-05-30 10:00:00,126,277,14,13,533,386,147,12
3587,2022-05-30 11:00:00,132,276,11,14,634,556,78,13
3588,2022-05-30 12:00:00,139,286,9,11,648,554,94,11
3589,2022-05-30 13:00:00,149,291,9,12,637,530,107,5
3590,2022-05-30 14:00:00,148,278,8,19,691,505,186,7
3591,2022-05-30 15:00:00,125,290,10,10,679,607,72,14
3592,2022-05-30 16:00:00,144,259,14,18,759,627,132,11
3593,2022-05-30 17:00:00,132,258,6,15,687,496,191,6
3594,2022-05-30 18:00:00,142,289,12,17,604,447,157,8
3595,2022-05-30 19:00:00,133,284,10,11,564,443,121,5
3596,2022-05-30 20:00:00,146,275,6,11,718,640,78,9
3597,2022-05-30 21:00:00,129,274,10,11,512,371,141,14
3598,2022-05-30 22:00:00,139,258,12,10,797,567,230,9
3599,2022-05-30 23:00:00,132,259,6,10,540,450,90,14
3600,2022-05-31 00:00:00,127,271,13,14,641,529,112,14
3601,2022-05-31 01:00:00,132,257,14,19,523,465,58,10
3602,2022-05-31 02:00:00,137,283,10,12,550,403,147,14
3603,2022-05-31 03:00:00,148,258,14,11,788,632,156,11
3604,2022-05-31 04:00:00,123,284,10,11,724,578,146,5
3605,2022-05-31 05:00:00,136,253,10,13,659,487,172,8
3606,2022-05-31 06:00:00,122,267,5,13,709,507,202,11
3607,2022-05-31 07:00:00,135,296,8,15,505,356,149,11
3608,2022-05-31 08:00:00,124,274,8,14,754,663,91,14
3609,2022-05-31 09:00:00,130,255,6,17,523,403,120,11
3610,2022-05-31 10:00:00,132,275,14,14,795,611,184,7
3611,2022-05-31 11:00:00,133,299,14,11,723,614,109,11
3612,2022-05-31 12:00:00,128,252,7,17,696,522,174,9
3613,2022-05-31 13:00:00,120,260,14,11,550,441,109,12
3614,2022-05-31 14:00:00,128,281,6,10,656,488,168,13
3615,2022-05-31 15:00:00,133,277,11,17,558,495,63,7
3616,2022-05-31 16:00:00,132,297,9,10,767,543,224,9
3617,2022-05-31 17:00:00,136,275,13,12,563,442,121,11
3618,2022-05-31 18:00:00,139,255,5,15,611,436,175,6
3619,2022-05-31 19:00:00,124,262,11,10,636,511,125,9
3620,2022-05-31 20:00:00,143,270,11,19,662,468,194,8
3621,2022-05-31 21:00:00,128,286,5,11,756,614,142,12
3622,2022-05-31 22:00:00,135,271,8,13,579,438,141,14
3623,2022-05-31 23:00:00,142,298,5,19,588,424,164,7
3624,2022-06-01 00:00:00,141,271,8,15,585,492,93,6
3625,2022-06-01 01:00:00,138,260,7,17,787,589,198,13
3626,2022-06-01 02:00:00,144,255,10,11,582,521,61,7
3627,2022-06-01 03:00:00,127,295,13,16,589,473,116,13
3628,2022-06-01 04:00:00,138,287,6,10,712,603,109,8
3629,2022-06-01 05:00:00,130,272,10,18,542,431,111,6
3630,2022-06-01 06:00:00,131,295,10,12,570,416,154,9
3631,2022-06-01 07:00:00,134,296,12,18,651,486,165,5
3632,2022-06-01 08:00:00,141,284,13,13,708,542,166,9
3633,2022-06-01 09:00:00,125,265,13,16,556,465,91,5
3634,2022-06-01 10:00:00,128,270,9,10,682,545,137,5
3635,2022-06-01 11:00:00,130,278,8,15,757,598,159,8
3636,2022-06-01 12:00:00,130,267,14,10,794,580,214,14
3637,2022-06-01 13:00:00,131,281,10,19,718,554,164,11
3638,2022-06-01 14:00:00,127,299,6,16,757,636,121,14
3639,2022-06-01 15:00:00,133,287,7,19,704,583,121,8
3640,2022-06-01 16:00:00,141,297,11,15,797,701,96,11
3641,2022-06-01 17:00:00,143,287,8,17,534,458,76,5
3642,2022-06-01 18:00:00,125,275,9,12,760,627,133,11
3643,2022-06-01 19:00:00,126,295,12,15,604,496,108,5
3644,2022-06-01 20:00:00,143,261,7,16,631,441,190,11
3645,2022-06-01 21:00:00,120,278,10,19,783,701,82,9
3646,2022-06-01 22:00:00,141,276,7,13,656,556,100,7
3647,2022-06-01 23:00:00,144,268,9,10,548,487,61,8
3648,2022-06-02 00:00:00,122,298,10,18,678,580,98,14
3649,2022-06-02 01:00:00,134,277,14,15,515,420,95,12
3650,2022-06-02 02:00:00,147,274,6,14,677,569,108,7
3651,2022-06-02 03:00:00,145,266,8,13,629,522,107,7
3652,2022-06-02 04:00:00,139,259,7,13,592,456,136,11
3653,2022-06-02 05:00:00,146,283,10,16,527,396,131,13
3654,2022-06-02 06:00:00,146,252,7,15,540,454,86,11
3655,2022-06-02 07:00:00,148,296,8,10,532,435,97,5
3656,2022-06-02 08:00:00,138,286,5,15,613,509,104,9
3657,2022-06-02 09:00:00,144,266,10,16,554,486,68,8
3658,2022-06-02 10:00:00,130,280,8,16,687,582,105,9
3659,2022-06-02 11:00:00,120,281,10,14,715,512,203,10
3660,2022-06-02 12:00:00,147,280,8,10,602,431,171,12
3661,2022-06-02 13:00:00,147,254,5,12,545,423,122,11
3662,2022-06-02 14:00:00,133,265,14,17,704,598,106,9
3663,2022-06-02 15:00:00,138,296,12,13,774,694,80,7
3664,2022-06-02 16:00:00,120,266,12,13,656,495,161,14
3665,2022-06-02 17:00:00,141,256,10,15,632,525,107,9
3666,2022-06-02 18:00:00,149,261,12,12,546,474,72,7
3667,2022-06-02 19:00:00,144,288,5,18,701,540,161,13
3668,2022-06-02 20:00:00,136,263,8,10,722,545,177,5
3669,2022-06-02 21:00:00,126,277,13,15,708,505,203,7
3670,2022-06-02 22:00:00,126,263,9,15,565,486,79,5
3671,2022-06-02 23:00:00,123,293,10,16,778,631,147,5
3672,2022-06-03 00:00:00,126,292,12,12,601,442,159,6
3673,2022-06-03 01:00:00,145,283,10,17,722,619,103,9
3674,2022-06-03 02:00:00,134,267,13,12,795,602,193,13
3675,2022-06-03 03:00:00,131,262,14,11,731,578,153,6
3676,2022-06-03 04:00:00,142,288,5,10,751,649,102,5
3677,2022-06-03 05:00:00,126,275,14,12,727,625,102,13
3678,2022-06-03 06:00:00,126,263,13,17,656,532,124,8
3679,2022-06-03 07:00:00,132,264,9,18,755,546,209,13
3680,2022-06-03 08:00:00,121,293,6,12,764,564,200,5
3681,2022-06-03 09:00:00,147,257,5,13,623,485,138,10
3682,2022-06-03 10:00:00,143,285,13,17,731,613,118,13
3683,2022-06-03 11:00:00,136,293,13,18,663,514,149,6
3684,2022-06-03 12:00:00,121,250,10,19,504,367,137,13
3685,2022-06-03 13:00:00,138,282,7,10,657,547,110,8
3686,2022-06-03 14:00:00,132,276,10,17,729,652,77,7
3687,2022-06-03 15:00:00,142,256,12,15,675,587,88,5
3688,2022-06-03 16:00:00,138,250,11,10,639,567,72,5
3689,2022-06-03 17:00:00,130,259,12,18,546,483,63,13
3690,2022-06-03 18:00:00,136,290,11,10,755,566,189,13
3691,2022-06-03 19:00:00,139,279,6,16,545,488,57,6
3692,2022-06-03 20:00:00,140,253,5,19,765,649,116,5
3693,2022-06-03 21:00:00,144,257,5,15,612,513,99,8
3694,2022-06-03 22:00:00,145,294,13,11,688,525,163,7
3695,2022-06-03 23:00:00,141,273,13,18,682,531,151,14
3696,2022-06-04 00:00:00,120,273,7,14,507,407,100,10
3697,2022-06-04 01:00:00,126,258,10,13,708,562,146,5
3698,2022-06-04 02:00:00,120,293,13,17,729,562,167,10
3699,2022-06-04 03:00:00,122,269,7,18,543,485,58,6
3700,2022-06-04 04:00:00,122,267,14,16,720,576,144,13
3701,2022-06-04 05:00:00,134,265,10,12,748,526,222,5
3702,2022-06-04 06:00:00,137,289,9,18,798,623,175,5
3703,2022-06-04 07:00:00,139,257,11,13,798,587,211,5
3704,2022-06-04 08:00:00,147,294,14,16,774,610,164,14
3705,2022-06-04 09:00:00,147,254,12,18,733,628,105,12
3706,2022-06-04 10:00:00,125,259,11,12,524,442,82,5
3707,2022-06-04 11:00:00,121,271,5,15,700,623,77,10
3708,2022-06-04 12:00:00,140,271,5,14,607,447,160,5
3709,2022-06-04 13:00:00,131,272,9,10,560,460,100,14
3710,2022-06-04 14:00:00,137,257,9,18,734,567,167,5
3711,2022-06-04 15:00:00,137,260,10,16,629,524,105,9
3712,2022-06-04 16:00:00,125,293,6,18,518,443,75,9
3713,2022-06-04 17:00:00,122,294,10,16,602,493,109,12
3714,2022-06-04 18:00:00,123,266,7,14,603,428,175,11
3715,2022-06-04 19:00:00,138,285,9,13,506,385,121,14
3716,2022-06-04 20:00:00,142,264,13,10,715,564,151,13
3717,2022-06-04 21:00:00,133,277,6,12,615,465,150,13
3718,2022-06-04 22:00:00,133,252,5,10,573,476,97,12
3719,2022-06-04 23:00:00,130,275,14,13,709,531,178,6
3720,2022-06-05 00:00:00,125,276,12,15,516,452,64,6
3721,2022-06-05 01:00:00,121,290,6,17,575,488,87,7
3722,2022-06-05 02:00:00,133,282,14,14,708,531,177,5
3723,2022-06-05 03:00:00,122,264,7,16,643,528,115,7
3724,2022-06-05 04:00:00,139,286,7,10,720,573,147,11
3725,2022-06-05 05:00:00,134,257,7,14,670,473,197,7
3726,2022-06-05 06:00:00,145,253,13,14,600,444,156,7
3727,2022-06-05 07:00:00,144,276,7,12,566,475,91,6
3728,2022-06-05 08:00:00,144,278,14,12,512,376,136,5
3729,2022-06-05 09:00:00,143,298,5,16,728,551,177,8
3730,2022-06-05 10:00:00,122,267,10,13,582,449,133,5
3731,2022-06-05 11:00:00,138,283,12,15,634,503,131,9
3732,2022-06-05 12:00:00,139,251,8,16,614,452,162,12
3733,2022-06-05 13:00:00,130,282,8,11,575,432,143,7
3734,2022-06-05 14:00:00,146,277,13,11,665,589,76,12
3735,2022-06-05 15:00:00,120,273,13,15,758,623,135,8
3736,2022-06-05 16:00:00,137,261,8,19,619,470,149,9
3737,2022-06-05 17:00:00,127,256,13,11,653,560,93,7
3738,2022-06-05 18:00:00,149,271,13,18,554,402,152,10
3739,2022-06-05 19:00:00,138,278,11,16,783,698,85,13
3740,2022-06-05 20:00:00,122,275,12,15,676,601,75,8
3741,2022-06-05 21:00:00,144,273,12,17,514,366,148,10
3742,2022-06-05 22:00:00,133,267,11,18,700,623,77,8
3743,2022-06-05 23:00:00,138,292,10,13,756,629,127,10
3744,2022-06-06 00:00:00,138,286,12,18,716,547,169,13
3745,2022-06-06 01:00:00,125,256,12,19,642,555,87,8
3746,2022-06-06 02:00:00,136,288,12,16,742,530,212,6
3747,2022-06-06 03:00:00,147,266,10,19,578,446,132,6
3748,2022-06-06 04:00:00,141,266,7,12,634,507,127,5
3749,2022-06-06 05:00:00,129,283,8,14,646,519,127,8
3750,2022-06-06 06:00:00,122,264,5,10,645,559,86,9
3751,2022-06-06 07:00:00,120,268,13,11,684,603,81,6
3752,2022-06-06 08:00:00,136,287,12,12,717,627,90,5
3753,2022-06-06 09:00:00,122,253,8,14,691,550,141,10
3754,2022-06-06 10:00:00,134,297,11,19,798,697,101,6
3755,2022-06-06 11:00:00,120,278,7,10,508,450,58,8
3756,2022-06-06 12:00:00,147,273,13,18,584,421,163,5
3757,2022-06-06 13:00:00,126,263,11,15,525,450,75,12
3758,2022-06-06 14:00:00,133,291,7,16,579,432,147,6
3759,2022-06-06 15:00:00,128,296,12,11,643,554,89,5
3760,2022-06-06 16:00:00,147,299,9,12,535,473,62,11
3761,2022-06-06 17:00:00,133,265,13,13,634,524,110,7
3762,2022-06-06 18:00:00,137,292,10,17,747,646,101,6
3763,2022-06-06 19:00:00,142,270,11,11,520,457,63,10
3764,2022-06-06 20:00:00,140,297,8,14,738,519,219,7
3765,2022-06-06 21:00:00,130,263,9,12,558,474,84,11
3766,2022-06-06 22:00:00,145,259,7,15,646,522,124,7
3767,2022-06-06 23:00:00,135,265,13,17,752,654,98,8
3768,2022-06-07 00:00:00,131,254,10,14,559,396,163,7
3769,2022-06-07 01:00:00,149,267,8,18,643,526,117,9
3770,2022-06-07 02:00:00,133,252,13,10,582,494,88,10
3771,2022-06-07 03:00:00,130,263,7,17,521,370,151,6
3772,2022-06-07 04:00:00,120,275,12,12,505,408,97,9
3773,2022-06-07 05:00:00,130,274,9,15,517,372,145,14
3774,2022-06-07 06:00:00,146,255,13,12,715,597,118,13
3775,2022-06-07 07:00:00,122,273,7,18,597,428,169,13
3776,2022-06-07 08:00:00,130,288,6,13,764,550,214,10
3777,2022-06-07 09:00:00,148,294,5,16,662,559,103,5
3778,2022-06-07 10:00:00,143,286,12,11,538,473,65,7
3779,2022-06-07 11:00:00,141,289,13,14,592,490,102,7
3780,2022-06-07 12:00:00,129,281,5,19,668,586,82,5
3781,2022-06-07 13:00:00,144,254,8,13,797,658,139,6
3782,2022-06-07 14:00:00,124,260,7,19,793,668,125,12
3783,2022-06-07 15:00:00,124,283,7,14,616,522,94,10
3784,2022-06-07 16:00:00,148,297,9,17,590,425,165,13
3785,2022-06-07 17:00:00,125,262,14,19,678,573,105,9
3786,2022-06-07 18:00:00,128,266,14,18,553,463,90,13
3787,2022-06-07 19:00:00,142,286,7,18,706,596,110,7
3788,2022-06-07 20:00:00,121,269,13,14,679,550,129,8
3789,2022-06-07 21:00:00,139,281,13,10,611,458,153,6
3790,2022-06-07 22:00:00,133,289,8,13,661,585,76,11
3791,2022-06-07 23:00:00,149,262,9,16,664,564,100,12
3792,2022-06-08 00:00:00,126,298,11,13,593,505,88,7
3793,2022-06-08 01:00:00,124,277,7,11,688,521,167,6
3794,2022-06-08 02:00:00,140,297,12,11,557,465,92,6
3795,2022-06-08 03:00:00,121,268,10,15,698,519,179,12
3796,2022-06-08 04:00:00,142,281,9,18,702,497,205,11
3797,2022-06-08 05:00:00,124,284,10,13,688,580,108,14
3798,2022-06-08 06:00:00,148,274,6,14,602,462,140,8
3799,2022-06-08 07:00:00,138,273,8,10,725,591,134,12
3800,2022-06-08 08:00:00,136,275,6,19,618,535,83,12
3801,2022-06-08 09:00:00,136,270,12,11,658,562,96,7
3802,2022-06-08 10:00:00,136,293,7,15,778,683,95,14
3803,2022-06-08 11:00:00,146,273,9,17,706,586,120,8
3804,2022-06-08 12:00:00,121,254,8,18,598,435,163,8
3805,2022-06-08 13:00:00,131,289,13,19,577,490,87,9
3806,2022-06-08 14:00:00,145,278,6,12,740,619,121,11
3807,2022-06-08 15:00:00,124,262,7,17,574,428,146,8
3808,2022-06-08 16:00:00,145,250,9,14,545,427,118,8
3809,2022-06-08 17:00:00,122,277,13,10,528,399,129,8
3810,2022-06-08 18:00:00,145,273,14,18,748,595,153,14
3811,2022-06-08 19:00:00,125,277,9,17,736,587,149,10
3812,2022-06-08 20:00:00,147,293,8,17,636,464,172,12
3813,2022-06-08 21:00:00,138,261,13,16,573,448,125,10
3814,2022-06-08 22:00:00,143,255,13,13,577,491,86,14
3815,2022-06-08 23:00:00,129,299,7,14,737,596,141,7
3816,2022-06-09 00:00:00,138,294,12,18,635,469,166,6
3817,2022-06-09 01:00:00,132,255,7,17,519,411,108,7
3818,2022-06-09 02:00:00,144,260,8,11,770,644,126,11
3819,2022-06-09 03:00:00,132,266,10,17,705,615,90,11
3820,2022-06-09 04:00:00,127,271,7,15,701,627,74,9
3821,2022-06-09 05:00:00,131,266,6,14,618,485,133,12
3822,2022-06-09 06:00:00,135,266,10,14,695,499,196,10
3823,2022-06-09 07:00:00,121,267,12,14,700,535,165,7
3824,2022-06-09 08:00:00,144,270,10,12,536,428,108,8
3825,2022-06-09 09:00:00,139,257,5,12,627,482,145,5
3826,2022-06-09 10:00:00,125,291,8,15,599,450,149,9
3827,2022-06-09 11:00:00,134,290,14,13,639,559,80,6
3828,2022-06-09 12:00:00,147,274,8,12,721,521,200,12
3829,2022-06-09 13:00:00,133,299,14,11,631,470,161,8
3830,2022-06-09 14:00:00,141,280,6,10,560,421,139,9
3831,2022-06-09 15:00:00,121,271,12,14,513,404,109,10
3832,2022-06-09 16:00:00,144,282,5,11,599,483,116,7
3833,2022-06-09 17:00:00,139,274,12,17,688,482,206,9
3834,2022-06-09 18:00:00,125,261,6,19,543,450,93,8
3835,2022-06-09 19:00:00,137,257,5,10,651,548,103,13
3836,2022-06-09 20:00:00,139,256,10,14,520,423,97,7
3837,2022-06-09 21:00:00,129,250,6,17,584,440,144,7
3838,2022-06-09 22:00:00,142,296,12,17,524,456,68,9
3839,2022-06-09 23:00:00,130,255,5,19,740,572,168,11
3840,2022-06-10 00:00:00,138,258,12,13,759,614,145,10
3841,2022-06-10 01:00:00,148,253,6,18,575,445,130,14
3842,2022-06-10 02:00:00,135,287,8,14,626,491,135,14
3843,2022-06-10 03:00:00,120,250,14,16,769,598,171,5
3844,2022-06-10 04:00:00,122,261,14,19,651,504,147,5
3845,2022-06-10 05:00:00,124,291,9,15,703,543,160,7
3846,2022-06-10 06:00:00,149,291,7,11,547,395,152,12
3847,2022-06-10 07:00:00,143,291,6,18,600,429,171,11
3848,2022-06-10 08:00:00,128,290,11,16,528,384,144,12
3849,2022-06-10 09:00:00,135,254,11,15,779,560,219,8
3850,2022-06-10 10:00:00,134,285,14,17,712,569,143,12
3851,2022-06-10 11:00:00,127,272,14,17,537,383,154,13
3852,2022-06-10 12:00:00,127,268,10,10,726,646,80,12
3853,2022-06-10 13:00:00,129,268,9,11,712,522,190,6
3854,2022-06-10 14:00:00,133,261,13,10,759,604,155,7
3855,2022-06-10 15:00:00,130,294,7,11,735,617,118,10
3856,2022-06-10 16:00:00,120,295,13,16,528,398,130,10
3857,2022-06-10 17:00:00,126,267,8,16,682,535,147,10
3858,2022-06-10 18:00:00,134,261,14,15,520,391,129,9
3859,2022-06-10 19:00:00,147,268,6,14,598,509,89,14
3860,2022-06-10 20:00:00,132,263,10,15,627,488,139,12
3861,2022-06-10 21:00:00,131,298,11,10,724,589,135,8
3862,2022-06-10 22:00:00,147,280,11,14,728,535,193,13
3863,2022-06-10 23:00:00,131,281,14,16,672,590,82,7
3864,2022-06-11 00:00:00,149,273,8,12,559,466,93,13
3865,2022-06-11 01:00:00,149,278,12,14,589,479,110,7
3866,2022-06-11 02:00:00,134,260,8,19,541,450,91,9
3867,2022-06-11 03:00:00,136,282,14,13,742,566,176,7
3868,2022-06-11 04:00:00,141,258,10,13,687,557,130,12
3869,2022-06-11 05:00:00,132,290,14,12,704,552,152,6
3870,2022-06-11 06:00:00,144,286,13,15,736,604,132,12
3871,2022-06-11 07:00:00,131,258,11,13,504,450,54,6
3872,2022-06-11 08:00:00,131,292,10,16,660,581,79,5
3873,2022-06-11 09:00:00,121,295,8,18,789,646,143,7
3874,2022-06-11 10:00:00,123,273,8,19,701,582,119,6
3875,2022-06-11 11:00:00,134,298,9,10,725,523,202,5
3876,2022-06-11 12:00:00,129,290,14,12,737,568,169,11
3877,2022-06-11 13:00:00,138,254,10,19,699,542,157,12
3878,2022-06-11 14:00:00,128,256,8,13,671,481,190,7
3879,2022-06-11 15:00:00,123,271,11,16,645,475,170,14
3880,2022-06-11 16:00:00,140,281,7,13,696,531,165,6
3881,2022-06-11 17:00:00,135,299,7,17,522,460,62,6
3882,2022-06-11 18:00:00,145,272,12,12,696,527,169,7
3883,2022-06-11 19:00:00,148,265,13,18,729,576,153,10
3884,2022-06-11 20:00:00,126,254,9,11,717,589,128,11
3885,2022-06-11 21:00:00,123,299,9,18,603,510,93,10
3886,2022-06-11 22:00:00,144,291,10,11,764,543,221,13
3887,2022-06-11 23:00:00,147,262,12,18,683,531,152,11
3888,2022-06-12 00:00:00,123,278,7,18,569,465,104,9
3889,2022-06-12 01:00:00,135,292,13,18,725,649,76,6
3890,2022-06-12 02:00:00,121,251,9,16,538,391,147,5
3891,2022-06-12 03:00:00,137,251,11,17,523,449,74,10
3892,2022-06-12 04:00:00,149,281,6,13,788,662,126,9
3893,2022-06-12 05:00:00,128,261,13,19,759,610,149,5
3894,2022-06-12 06:00:00,128,296,14,18,516,449,67,5
3895,2022-06-12 07:00:00,120,257,13,15,700,499,201,8
3896,2022-06-12 08:00:00,131,270,6,12,766,641,125,10
3897,2022-06-12 09:00:00,124,286,7,13,699,610,89,11
3898,2022-06-12 10:00:00,131,274,7,17,708,592,116,9
3899,2022-06-12 11:00:00,149,251,10,18,511,449,62,8
3900,2022-06-12 12:00:00,129,252,8,11,778,594,184,8
3901,2022-06-12 13:00:00,136,258,8,12,635,467,168,10
3902,2022-06-12 14:00:00,138,270,13,19,584,426,158,14
3903,2022-06-12 15:00:00,138,270,11,15,517,391,126,5
3904,2022-06-12 16:00:00,131,267,5,14,689,569,120,10
3905,2022-06-12 17:00:00,120,290,6,11,578,505,73,9
3906,2022-06-12 18:00:00,149,291,10,15,658,514,144,14
3907,2022-06-12 19:00:00,134,256,14,19,727,529,198,12
3908,2022-06-12 20:00:00,135,270,12,11,711,628,83,11
3909,2022-06-12 21:00:00,131,267,12,16,567,455,112,9
3910,2022-06-12 22:00:00,123,289,10,18,733,517,216,5
3911,2022-06-12 23:00:00,138,285,6,10,660,571,89,13
3912,2022-06-13 00:00:00,139,270,9,16,713,596,117,12
3913,2022-06-13 01:00:00,144,296,10,18,652,534,118,6
3914,2022-06-13 02:00:00,123,284,13,16,775,554,221,5
3915,2022-06-13 03:00:00,145,271,8,11,549,491,58,9
3916,2022-06-13 04:00:00,120,277,10,15,788,699,89,5
3917,2022-06-13 05:00:00,131,298,11,15,628,447,181,12
3918,2022-06-13 06:00:00,124,250,7,10,750,611,139,11
3919,2022-06-13 07:00:00,125,271,12,11,783,559,224,7
3920,2022-06-13 08:00:00,133,291,10,18,731,554,177,9
3921,2022-06-13 09:00:00,136,264,13,16,693,516,177,7
3922,2022-06-13 10:00:00,133,255,5,17,746,655,91,6
3923,2022-06-13 11:00:00,129,253,9,10,743,656,87,8
3924,2022-06-13 12:00:00,120,296,14,19,618,515,103,6
3925,2022-06-13 13:00:00,141,275,11,17,511,382,129,5
3926,2022-06-13 14:00:00,134,268,6,12,506,416,90,11
3927,2022-06-13 15:00:00,130,295,9,17,759,664,95,6
3928,2022-06-13 16:00:00,140,279,14,17,506,402,104,11
3929,2022-06-13 17:00:00,144,255,6,17,746,570,176,10
3930,2022-06-13 18:00:00,121,276,13,17,616,521,95,12
3931,2022-06-13 19:00:00,135,269,13,13,760,620,140,7
3932,2022-06-13 20:00:00,120,278,5,16,510,420,90,11
3933,2022-06-13 21:00:00,144,287,8,13,642,510,132,8
3934,2022-06-13 22:00:00,137,263,7,19,678,491,187,9
3935,2022-06-13 23:00:00,142,263,12,10,607,519,88,14
3936,2022-06-14 00:00:00,139,256,13,10,746,524,222,9
3937,2022-06-14 01:00:00,123,258,12,16,585,505,80,10
3938,2022-06-14 02:00:00,132,288,11,17,636,468,168,9
3939,2022-06-14 03:00:00,126,296,8,16,756,674,82,10
3940,2022-06-14 04:00:00,135,265,8,10,728,639,89,9
3941,2022-06-14 05:00:00,133,273,5,18,637,515,122,7
3942,2022-06-14 06:00:00,130,294,13,10,577,507,70,8
3943,2022-06-14 07:00:00,140,295,7,11,750,550,200,12
3944,2022-06-14 08:00:00,140,291,8,16,678,477,201,7
3945,2022-06-14 09:00:00,122,281,14,17,556,398,158,11
3946,2022-06-14 10:00:00,131,290,12,15,570,466,104,5
3947,2022-06-14 11:00:00,135,292,12,15,672,584,88,6
3948,2022-06-14 12:00:00,144,252,14,16,511,443,68,6
3949,2022-06-14 13:00:00,147,279,6,14,660,502,158,12
3950,2022-06-14 14:00:00,128,281,6,17,712,631,81,8
3951,2022-06-14 15:00:00,124,292,9,13,640,529,111,10
3952,2022-06-14 16:00:00,144,271,5,14,579,410,169,6
3953,2022-06-14 17:00:00,147,275,13,19,636,552,84,5
3954,2022-06-14 18:00:00,146,280,9,16,708,521,187,9
3955,2022-06-14 19:00:00,128,252,14,10,759,652,107,8
3956,2022-06-14 20:00:00,138,274,11,11,706,525,181,5
3957,2022-06-14 21:00:00,127,276,14,18,719,589,130,12
3958,2022-06-14 22:00:00,143,287,14,14,727,553,174,12
3959,2022-06-14 23:00:00,120,277,12,18,621,435,186,9
3960,2022-06-15 00:00:00,142,261,11,16,584,493,91,7
3961,2022-06-15 01:00:00,149,259,6,18,564,417,147,12
3962,2022-06-15 02:00:00,133,282,8,15,734,615,119,14
3963,2022-06-15 03:00:00,126,278,9,17,519,400,119,10
3964,2022-06-15 04:00:00,136,278,10,11,758,589,169,10
3965,2022-06-15 05:00:00,125,293,5,14,649,466,183,7
3966,2022-06-15 06:00:00,131,253,14,10,541,423,118,12
3967,2022-06-15 07:00:00,134,292,13,13,528,440,88,7
3968,2022-06-15 08:00:00,149,287,6,13,650,458,192,8
3969,2022-06-15 09:00:00,122,297,10,16,768,628,140,13
3970,2022-06-15 10:00:00,138,262,11,16,620,435,185,6
3971,2022-06-15 11:00:00,132,257,6,12,662,562,100,13
3972,2022-06-15 12:00:00,128,274,7,13,741,556,185,11
3973,2022-06-15 13:00:00,123,279,12,13,671,590,81,12
3974,2022-06-15 14:00:00,128,265,11,13,675,507,168,13
3975,2022-06-15 15:00:00,137,295,13,13,616,450,166,7
3976,2022-06-15 16:00:00,142,250,12,15,567,476,91,9
3977,2022-06-15 17:00:00,149,263,10,16,579,414,165,5
3978,2022-06-15 18:00:00,140,283,12,15,523,377,146,10
3979,2022-06-15 19:00:00,131,251,5,15,770,637,133,12
3980,2022-06-15 20:00:00,124,277,11,11,563,486,77,9
3981,2022-06-15 21:00:00,140,272,12,18,739,631,108,14
3982,2022-06-15 22:00:00,145,275,8,18,679,516,163,10
3983,2022-06-15 23:00:00,128,299,12,17,665,512,153,10
3984,2022-06-16 00:00:00,148,250,8,10,756,562,194,9
3985,2022-06-16 01:00:00,125,267,14,11,786,704,82,5
3986,2022-06-16 02:00:00,120,265,10,14,642,467,175,9
3987,2022-06-16 03:00:00,134,299,11,12,676,531,145,9
3988,2022-06-16 04:00:00,126,266,11,18,731,618,113,11
3989,2022-06-16 05:00:00,146,288,6,15,580,518,62,6
3990,2022-06-16 06:00:00,143,271,6,18,618,522,96,5
3991,2022-06-16 07:00:00,122,271,5,15,617,508,109,13
3992,2022-06-16 08:00:00,146,271,5,14,636,531,105,13
3993,2022-06-16 09:00:00,139,282,13,12,650,569,81,6
3994,2022-06-16 10:00:00,129,255,8,14,572,470,102,14
3995,2022-06-16 11:00:00,123,285,14,15,672,474,198,8
3996,2022-06-16 12:00:00,141,277,6,11,755,539,216,6
3997,2022-06-16 13:00:00,144,290,9,17,637,522,115,13
3998,2022-06-16 14:00:00,133,275,11,17,587,488,99,13
3999,2022-06-16 15:00:00,144,296,5,19,718,525,193,11
4000,2022-06-16 16:00:00,126,251,6,16,602,443,159,8
4001,2022-06-16 17:00:00,127,277,10,18,788,622,166,5
4002,2022-06-16 18:00:00,133,257,8,12,753,667,86,6
4003,2022-06-16 19:00:00,135,288,6,12,658,528,130,9
4004,2022-06-16 20:00:00,146,284,6,19,580,462,118,9
4005,2022-06-16 21:00:00,121,252,11,15,609,463,146,14
4006,2022-06-16 22:00:00,131,290,6,18,591,508,83,6
4007,2022-06-16 23:00:00,134,277,5,15,518,445,73,7
4008,2022-06-17 00:00:00,130,297,13,11,599,422,177,5
4009,2022-06-17 01:00:00,140,260,13,15,530,403,127,13
4010,2022-06-17 02:00:00,122,257,9,15,560,419,141,9
4011,2022-06-17 03:00:00,141,281,13,18,567,412,155,10
4012,2022-06-17 04:00:00,120,294,10,17,648,555,93,8
4013,2022-06-17 05:00:00,133,293,13,10,752,551,201,10
4014,2022-06-17 06:00:00,127,274,6,11,586,428,158,10
4015,2022-06-17 07:00:00,128,293,14,11,603,516,87,7
4016,2022-06-17 08:00:00,132,283,14,13,582,468,114,13
4017,2022-06-17 09:00:00,145,265,12,10,672,552,120,14
4018,2022-06-17 10:00:00,122,281,12,19,703,500,203,8
4019,2022-06-17 11:00:00,136,256,10,15,739,581,158,14
4020,2022-06-17 12:00:00,122,266,8,18,725,571,154,14
4021,2022-06-17 13:00:00,136,268,6,10,602,423,179,10
4022,2022-06-17 14:00:00,128,253,7,14,630,458,172,5
4023,2022-06-17 15:00:00,132,269,10,17,748,657,91,5
4024,2022-06-17 16:00:00,133,285,11,19,655,562,93,5
4025,2022-06-17 17:00:00,142,251,5,17,545,410,135,6
4026,2022-06-17 18:00:00,149,284,6,14,540,388,152,11
4027,2022-06-17 19:00:00,132,282,8,14,581,443,138,6
4028,2022-06-17 20:00:00,124,258,12,15,680,506,174,7
4029,2022-06-17 21:00:00,136,294,8,12,730,607,123,9
4030,2022-06-17 22:00:00,121,278,5,17,540,422,118,11
4031,2022-06-17 23:00:00,121,253,13,12,783,675,108,11
4032,2022-06-18 00:00:00,141,274,6,12,531,472,59,14
4033,2022-06-18 01:00:00,134,257,6,14,659,465,194,9
4034,2022-06-18 02:00:00,149,260,8,15,769,552,217,7
4035,2022-06-18 03:00:00,125,273,11,18,668,474,194,14
4036,2022-06-18 04:00:00,124,293,13,15,546,393,153,13
4037,2022-06-18 05:00:00,131,275,5,12,724,556,168,10
4038,2022-06-18 06:00:00,141,288,5,11,712,500,212,9
4039,2022-06-18 07:00:00,125,268,14,17,645,460,185,11
4040,2022-06-18 08:00:00,132,281,7,12,677,553,124,14
4041,2022-06-18 09:00:00,125,258,14,15,521,382,139,8
4042,2022-06-18 10:00:00,135,293,5,13,779,559,220,5
4043,2022-06-18 11:00:00,147,253,9,18,634,543,91,14
4044,2022-06-18 12:00:00,130,276,13,11,585,442,143,6
4045,2022-06-18 13:00:00,134,291,13,19,674,539,135,13
4046,2022-06-18 14:00:00,149,296,10,16,758,669,89,12
4047,2022-06-18 15:00:00,122,276,5,10,694,539,155,8
4048,2022-06-18 16:00:00,135,250,12,11,577,479,98,7
4049,2022-06-18 17:00:00,145,283,6,14,560,410,150,8
4050,2022-06-18 18:00:00,120,282,6,13,752,592,160,9
4051,2022-06-18 19:00:00,123,286,6,14,722,553,169,7
4052,2022-06-18 20:00:00,144,284,14,19,720,598,122,12
4053,2022-06-18 21:00:00,136,294,8,18,671,498,173,7
4054,2022-06-18 22:00:00,126,287,9,13,646,538,108,5
4055,2022-06-18 23:00:00,129,268,11,17,765,578,187,12
4056,2022-06-19 00:00:00,131,299,11,11,755,543,212,9
4057,2022-06-19 01:00:00,121,251,12,13,563,427,136,13
4058,2022-06-19 02:00:00,143,257,10,15,674,486,188,11
4059,2022-06-19 03:00:00,140,270,10,13,686,518,168,14
4060,2022-06-19 04:00:00,147,266,9,18,780,669,111,10
4061,2022-06-19 05:00:00,122,269,12,17,732,651,81,8
4062,2022-06-19 06:00:00,124,270,7,14,789,697,92,6
4063,2022-06-19 07:00:00,149,250,11,11,795,589,206,11
4064,2022-06-19 08:00:00,124,270,11,18,641,573,68,7
4065,2022-06-19 09:00:00,129,293,8,13,514,409,105,5
4066,2022-06-19 10:00:00,146,288,14,11,740,533,207,14
4067,2022-06-19 11:00:00,128,293,11,19,558,405,153,7
4068,2022-06-19 12:00:00,126,261,10,14,759,649,110,7
4069,2022-06-19 13:00:00,141,270,7,13,794,670,124,9
4070,2022-06-19 14:00:00,142,256,8,13,681,485,196,11
4071,2022-06-19 15:00:00,126,274,10,15,618,443,175,7
4072,2022-06-19 16:00:00,128,277,9,19,503,427,76,11
4073,2022-06-19 17:00:00,129,276,10,16,791,607,184,11
4074,2022-06-19 18:00:00,141,284,11,14,660,579,81,6
4075,2022-06-19 19:00:00,146,296,11,16,792,636,156,13
4076,2022-06-19 20:00:00,131,259,13,11,724,543,181,5
4077,2022-06-19 21:00:00,142,260,5,14,544,411,133,6
4078,2022-06-19 22:00:00,120,261,12,13,596,463,133,14
4079,2022-06-19 23:00:00,126,274,9,12,544,459,85,11
4080,2022-06-20 00:00:00,134,270,12,14,646,556,90,5
4081,2022-06-20 01:00:00,144,267,8,11,556,492,64,11
4082,2022-06-20 02:00:00,123,296,7,16,569,422,147,10
4083,2022-06-20 03:00:00,142,292,13,19,787,551,236,14
4084,2022-06-20 04:00:00,138,295,6,12,521,445,76,11
4085,2022-06-20 05:00:00,133,273,5,15,619,449,170,12
4086,2022-06-20 06:00:00,121,294,5,11,784,694,90,12
4087,2022-06-20 07:00:00,134,274,10,13,557,443,114,6
4088,2022-06-20 08:00:00,139,280,5,10,705,614,91,6
4089,2022-06-20 09:00:00,149,276,13,17,527,462,65,7
4090,2022-06-20 10:00:00,142,296,14,11,617,483,134,8
4091,2022-06-20 11:00:00,140,252,7,13,725,533,192,9
4092,2022-06-20 12:00:00,142,255,5,19,504,441,63,13
4093,2022-06-20 13:00:00,141,282,8,13,674,588,86,8
4094,2022-06-20 14:00:00,141,261,11,10,616,498,118,14
4095,2022-06-20 15:00:00,122,286,12,15,777,698,79,7
4096,2022-06-20 16:00:00,129,251,6,14,545,437,108,13
4097,2022-06-20 17:00:00,135,286,12,10,566,485,81,5
4098,2022-06-20 18:00:00,124,259,7,17,679,600,79,5
4099,2022-06-20 19:00:00,122,287,14,12,760,605,155,13
4100,2022-06-20 20:00:00,143,264,12,10,554,404,150,13
4101,2022-06-20 21:00:00,145,266,14,13,763,597,166,5
4102,2022-06-20 22:00:00,131,267,12,17,757,558,199,11
4103,2022-06-20 23:00:00,125,277,10,16,539,468,71,9
4104,2022-06-21 00:00:00,122,288,9,19,677,485,192,13
4105,2022-06-21 01:00:00,139,258,6,13,777,588,189,7
4106,2022-06-21 02:00:00,144,271,10,13,658,535,123,14
4107,2022-06-21 03:00:00,128,268,13,18,776,576,200,13
4108,2022-06-21 04:00:00,120,271,12,11,505,407,98,9
4109,2022-06-21 05:00:00,137,279,5,15,580,511,69,5
4110,2022-06-21 06:00:00,135,261,12,19,747,653,94,14
4111,2022-06-21 07:00:00,134,285,8,14,519,375,144,7
4112,2022-06-21 08:00:00,131,261,5,18,701,584,117,9
4113,2022-06-21 09:00:00,138,261,11,13,746,548,198,6
4114,2022-06-21 10:00:00,121,254,6,19,637,495,142,6
4115,2022-06-21 11:00:00,133,258,13,18,513,405,108,10
4116,2022-06-21 12:00:00,144,269,6,12,777,664,113,10
4117,2022-06-21 13:00:00,125,257,14,14,779,624,155,14
4118,2022-06-21 14:00:00,137,280,7,13,595,490,105,9
4119,2022-06-21 15:00:00,125,254,5,17,529,466,63,10
4120,2022-06-21 16:00:00,134,276,13,15,563,473,90,7
4121,2022-06-21 17:00:00,144,267,14,18,515,397,118,11
4122,2022-06-21 18:00:00,130,271,12,19,599,480,119,5
4123,2022-06-21 19:00:00,131,251,11,15,504,375,129,12
4124,2022-06-21 20:00:00,140,260,6,19,641,554,87,10
4125,2022-06-21 21:00:00,144,275,6,11,798,562,236,13
4126,2022-06-21 22:00:00,127,271,9,19,687,496,191,6
4127,2022-06-21 23:00:00,149,267,13,16,543,425,118,10
4128,2022-06-22 00:00:00,134,281,5,16,555,472,83,11
4129,2022-06-22 01:00:00,144,268,10,11,602,538,64,11
4130,2022-06-22 02:00:00,126,295,6,12,706,620,86,10
4131,2022-06-22 03:00:00,138,265,13,15,670,541,129,9
4132,2022-06-22 04:00:00,121,279,6,12,739,531,208,12
4133,2022-06-22 05:00:00,144,299,6,10,590,425,165,12
4134,2022-06-22 06:00:00,137,291,6,14,776,638,138,9
4135,2022-06-22 07:00:00,143,262,6,18,732,629,103,9
4136,2022-06-22 08:00:00,132,266,11,13,612,486,126,6
4137,2022-06-22 09:00:00,131,279,8,17,608,437,171,6
4138,2022-06-22 10:00:00,149,294,13,12,651,568,83,11
4139,2022-06-22 11:00:00,135,250,8,11,641,451,190,6
4140,2022-06-22 12:00:00,124,271,6,10,540,451,89,13
4141,2022-06-22 13:00:00,144,293,11,17,570,468,102,8
4142,2022-06-22 14:00:00,128,257,5,16,793,557,236,9
4143,2022-06-22 15:00:00,145,286,13,14,611,495,116,10
4144,2022-06-22 16:00:00,123,250,13,14,696,544,152,12
4145,2022-06-22 17:00:00,139,270,11,11,559,436,123,5
4146,2022-06-22 18:00:00,134,263,10,16,721,547,174,7
4147,2022-06-22 19:00:00,124,296,11,11,690,506,184,8
4148,2022-06-22 20:00:00,149,280,13,16,581,474,107,11
4149,2022-06-22 21:00:00,144,280,13,13,706,571,135,12
4150,2022-06-22 22:00:00,137,296,5,19,750,591,159,6
4151,2022-06-22 23:00:00,125,282,5,12,573,429,144,9
4152,2022-06-23 00:00:00,140,262,5,18,775,654,121,10
4153,2022-06-23 01:00:00,132,275,13,13,690,582,108,13
4154,2022-06-23 02:00:00,121,273,7,13,752,542,210,6
4155,2022-06-23 03:00:00,131,251,7,11,714,518,196,14
4156,2022-06-23 04:00:00,124,297,11,12,683,551,132,13
4157,2022-06-23 05:00:00,146,288,8,13,675,604,71,7
4158,2022-06-23 06:00:00,135,280,10,16,670,542,128,12
4159,2022-06-23 07:00:00,145,259,10,11,605,525,80,12
4160,2022-06-23 08:00:00,147,278,10,17,754,539,215,10
4161,2022-06-23 09:00:00,138,263,13,18,772,544,228,14
4162,2022-06-23 10:00:00,127,285,11,13,618,540,78,8
4163,2022-06-23 11:00:00,132,278,13,10,594,469,125,13
4164,2022-06-23 12:00:00,129,264,12,15,695,563,132,7
4165,2022-06-23 13:00:00,135,278,8,18,741,661,80,10
4166,2022-06-23 14:00:00,139,289,5,10,770,602,168,10
4167,2022-06-23 15:00:00,148,252,13,13,517,423,94,8
4168,2022-06-23 16:00:00,124,286,13,15,755,661,94,5
4169,2022-06-23 17:00:00,132,288,6,19,661,594,67,10
4170,2022-06-23 18:00:00,127,273,11,11,536,385,151,11
4171,2022-06-23 19:00:00,129,292,10,11,780,631,149,14
4172,2022-06-23 20:00:00,141,282,10,18,684,538,146,9
4173,2022-06-23 21:00:00,131,259,13,10,724,582,142,5
4174,2022-06-23 22:00:00,139,277,14,14,587,483,104,6
4175,2022-06-23 23:00:00,146,274,10,17,561,424,137,11
4176,2022-06-24 00:00:00,131,292,5,11,602,485,117,10
4177,2022-06-24 01:00:00,148,297,5,14,528,388,140,7
4178,2022-06-24 02:00:00,136,250,13,15,544,407,137,10
4179,2022-06-24 03:00:00,128,299,11,19,540,418,122,8
4180,2022-06-24 04:00:00,121,274,6,14,720,550,170,8
4181,2022-06-24 05:00:00,145,276,5,18,540,484,56,5
4182,2022-06-24 06:00:00,139,278,13,19,540,459,81,8
4183,2022-06-24 07:00:00,120,277,9,10,793,614,179,13
4184,2022-06-24 08:00:00,138,273,6,19,532,414,118,5
4185,2022-06-24 09:00:00,140,272,13,13,573,487,86,12
4186,2022-06-24 10:00:00,143,288,10,17,522,420,102,10
4187,2022-06-24 11:00:00,127,296,12,15,585,459,126,6
4188,2022-06-24 12:00:00,142,271,13,11,686,548,138,5
4189,2022-06-24 13:00:00,120,286,13,14,513,364,149,11
4190,2022-06-24 14:00:00,129,289,9,19,663,500,163,5
4191,2022-06-24 15:00:00,129,267,13,14,758,660,98,8
4192,2022-06-24 16:00:00,124,297,7,16,655,572,83,5
4193,2022-06-24 17:00:00,127,288,10,11,797,699,98,12
4194,2022-06-24 18:00:00,132,252,6,11,598,482,116,7
4195,2022-06-24 19:00:00,149,296,8,13,713,606,107,8
4196,2022-06-24 20:00:00,127,289,5,15,681,595,86,13
4197,2022-06-24 21:00:00,137,284,7,15,646,555,91,10
4198,2022-06-24 22:00:00,143,290,8,19,539,404,135,8
4199,2022-06-24 23:00:00,128,253,12,19,617,465,152,6
4200,2022-06-25 00:00:00,120,260,7,15,798,708,90,11
4201,2022-06-25 01:00:00,139,290,9,18,660,503,157,9
4202,2022-06-25 02:00:00,149,271,11,14,682,510,172,11
4203,2022-06-25 03:00:00,128,253,9,17,548,403,145,9
4204,2022-06-25 04:00:00,135,268,6,14,756,591,165,5
4205,2022-06-25 05:00:00,134,289,8,14,502,378,124,11
4206,2022-06-25 06:00:00,121,269,9,19,549,389,160,12
4207,2022-06-25 07:00:00,137,280,5,15,525,450,75,9
4208,2022-06-25 08:00:00,137,268,11,14,662,564,98,14
4209,2022-06-25 09:00:00,140,296,6,16,789,566,223,14
4210,2022-06-25 10:00:00,131,274,10,16,665,564,101,14
4211,2022-06-25 11:00:00,135,266,5,13,703,554,149,8
4212,2022-06-25 12:00:00,139,299,12,16,646,454,192,10
4213,2022-06-25 13:00:00,136,275,14,11,793,560,233,12
4214,2022-06-25 14:00:00,138,259,14,12,618,545,73,13
4215,2022-06-25 15:00:00,133,261,5,10,567,431,136,11
4216,2022-06-25 16:00:00,123,281,9,19,697,604,93,5
4217,2022-06-25 17:00:00,130,256,11,12,584,430,154,13
4218,2022-06-25 18:00:00,133,280,6,18,736,562,174,12
4219,2022-06-25 19:00:00,139,294,10,19,696,601,95,10
4220,2022-06-25 20:00:00,129,268,11,13,763,676,87,13
4221,2022-06-25 21:00:00,125,281,12,14,581,411,170,10
4222,2022-06-25 22:00:00,133,284,12,14,628,561,67,11
4223,2022-06-25 23:00:00,131,285,6,18,515,425,90,8
4224,2022-06-26 00:00:00,130,288,7,11,524,375,149,9
4225,2022-06-26 01:00:00,128,282,12,11,614,506,108,5
4226,2022-06-26 02:00:00,136,284,9,18,509,407,102,10
4227,2022-06-26 03:00:00,146,263,7,17,558,458,100,10
4228,2022-06-26 04:00:00,131,259,6,17,790,596,194,10
4229,2022-06-26 05:00:00,128,266,7,13,714,582,132,7
4230,2022-06-26 06:00:00,135,290,6,13,639,496,143,8
4231,2022-06-26 07:00:00,131,264,8,17,571,405,166,5
4232,2022-06-26 08:00:00,144,295,14,15,692,589,103,6
4233,2022-06-26 09:00:00,138,274,11,18,631,522,109,6
4234,2022-06-26 10:00:00,125,267,10,17,767,641,126,10
4235,2022-06-26 11:00:00,123,292,10,17,736,552,184,8
4236,2022-06-26 12:00:00,138,266,6,18,572,478,94,12
4237,2022-06-26 13:00:00,145,261,12,11,622,509,113,12
4238,2022-06-26 14:00:00,149,274,9,16,559,422,137,8
4239,2022-06-26 15:00:00,122,265,14,14,516,402,114,11
4240,2022-06-26 16:00:00,133,263,10,13,577,426,151,9
4241,2022-06-26 17:00:00,140,270,11,10,535,403,132,6
4242,2022-06-26 18:00:00,133,276,5,11,745,658,87,6
4243,2022-06-26 19:00:00,140,269,11,17,581,449,132,13
4244,2022-06-26 20:00:00,135,287,7,18,758,577,181,11
4245,2022-06-26 21:00:00,132,272,7,15,514,391,123,10
4246,2022-06-26 22:00:00,126,298,7,14,578,513,65,5
4247,2022-06-26 23:00:00,147,279,11,10,694,534,160,11
4248,2022-06-27 00:00:00,148,286,10,12,509,404,105,13
4249,2022-06-27 01:00:00,135,273,5,12,551,434,117,9
4250,2022-06-27 02:00:00,132,270,11,11,670,568,102,13
4251,2022-06-27 03:00:00,132,273,14,12,763,564,199,10
4252,2022-06-27 04:00:00,138,259,8,11,697,508,189,11
4253,2022-06-27 05:00:00,147,284,10,15,671,569,102,14
4254,2022-06-27 06:00:00,140,284,7,14,665,495,170,11
4255,2022-06-27 07:00:00,137,271,8,12,661,497,164,11
4256,2022-06-27 08:00:00,130,295,10,13,698,585,113,10
4257,2022-06-27 09:00:00,127,259,5,11,587,525,62,5
4258,2022-06-27 10:00:00,129,273,7,19,619,454,165,12
4259,2022-06-27 11:00:00,142,283,9,15,636,489,147,13
4260,2022-06-27 12:00:00,125,295,12,10,797,641,156,12
4261,2022-06-27 13:00:00,149,284,14,11,630,564,66,6
4262,2022-06-27 14:00:00,145,263,7,11,533,460,73,10
4263,2022-06-27 15:00:00,144,271,12,13,504,363,141,13
4264,2022-06-27 16:00:00,127,263,7,11,718,521,197,8
4265,2022-06-27 17:00:00,125,269,14,14,793,688,105,14
4266,2022-06-27 18:00:00,143,283,9,14,563,412,151,14
4267,2022-06-27 19:00:00,129,282,11,11,576,423,153,12
4268,2022-06-27 20:00:00,123,254,11,11,650,457,193,6
4269,2022-06-27 21:00:00,122,286,10,16,793,663,130,9
4270,2022-06-27 22:00:00,137,280,7,10,595,426,169,8
4271,2022-06-27 23:00:00,137,277,7,13,764,618,146,14
4272,2022-06-28 00:00:00,121,286,6,11,785,599,186,14
4273,2022-06-28 01:00:00,123,252,8,13,747,654,93,7
4274,2022-06-28 02:00:00,144,270,14,19,686,494,192,8
4275,2022-06-28 03:00:00,123,274,13,16,695,552,143,14
4276,2022-06-28 04:00:00,146,280,10,14,529,454,75,10
4277,2022-06-28 05:00:00,127,287,7,13,716,565,151,12
4278,2022-06-28 06:00:00,125,290,14,12,653,575,78,6
4279,2022-06-28 07:00:00,146,278,6,15,654,574,80,8
4280,2022-06-28 08:00:00,132,274,12,11,740,595,145,5
4281,2022-06-28 09:00:00,133,259,8,15,502,368,134,6
4282,2022-06-28 10:00:00,120,260,7,11,784,586,198,9
4283,2022-06-28 11:00:00,137,290,14,19,606,517,89,14
4284,2022-06-28 12:00:00,123,293,12,10,647,498,149,13
4285,2022-06-28 13:00:00,128,292,11,17,601,472,129,12
4286,2022-06-28 14:00:00,125,292,14,18,788,658,130,6
4287,2022-06-28 15:00:00,133,265,9,17,677,569,108,10
4288,2022-06-28 16:00:00,125,268,8,11,522,456,66,10
4289,2022-06-28 17:00:00,140,251,11,17,703,533,170,12
4290,2022-06-28 18:00:00,142,252,12,12,696,574,122,10
4291,2022-06-28 19:00:00,141,273,9,11,787,556,231,13
4292,2022-06-28 20:00:00,121,291,14,17,657,480,177,9
4293,2022-06-28 21:00:00,139,263,6,17,656,556,100,8
4294,2022-06-28 22:00:00,135,257,7,14,523,401,122,11
4295,2022-06-28 23:00:00,132,255,11,10,508,358,150,8
4296,2022-06-29 00:00:00,129,265,8,18,573,454,119,11
4297,2022-06-29 01:00:00,142,297,5,13,640,518,122,6
4298,2022-06-29 02:00:00,134,250,11,13,758,677,81,8
4299,2022-06-29 03:00:00,131,252,6,15,524,432,92,13
4300,2022-06-29 04:00:00,144,297,10,13,513,435,78,6
4301,2022-06-29 05:00:00,122,282,5,14,782,548,234,10
4302,2022-06-29 06:00:00,126,257,8,14,724,522,202,7
4303,2022-06-29 07:00:00,141,274,11,14,548,431,117,10
4304,2022-06-29 08:00:00,132,269,9,16,629,512,117,12
4305,2022-06-29 09:00:00,120,298,7,18,570,509,61,14
4306,2022-06-29 10:00:00,145,266,10,17,563,506,57,12
4307,2022-06-29 11:00:00,141,271,9,14,537,476,61,6
4308,2022-06-29 12:00:00,131,259,12,15,752,621,131,6
4309,2022-06-29 13:00:00,144,286,14,10,776,689,87,7
4310,2022-06-29 14:00:00,131,278,11,16,787,603,184,8
4311,2022-06-29 15:00:00,132,250,12,12,551,388,163,6
4312,2022-06-29 16:00:00,138,279,6,16,745,623,122,10
4313,2022-06-29 17:00:00,126,295,14,15,531,397,134,8
4314,2022-06-29 18:00:00,137,299,6,13,529,378,151,11
4315,2022-06-29 19:00:00,144,288,5,17,681,548,133,5
4316,2022-06-29 20:00:00,133,267,7,10,523,411,112,10
4317,2022-06-29 21:00:00,131,259,13,16,636,535,101,14
4318,2022-06-29 22:00:00,140,274,9,15,551,385,166,5
4319,2022-06-29 23:00:00,139,282,14,13,514,420,94,10
4320,2022-06-30 00:00:00,146,276,5,18,596,492,104,10
4321,2022-06-30 01:00:00,149,252,5,15,594,515,79,11
4322,2022-06-30 02:00:00,143,270,13,11,568,474,94,6
4323,2022-06-30 03:00:00,141,287,6,17,542,454,88,8
4324,2022-06-30 04:00:00,133,254,5,16,673,503,170,11
4325,2022-06-30 05:00:00,134,284,13,13,649,555,94,8
4326,2022-06-30 06:00:00,124,291,10,13,565,500,65,10
4327,2022-06-30 07:00:00,125,278,11,18,743,642,101,9
4328,2022-06-30 08:00:00,130,296,11,19,770,556,214,7
4329,2022-06-30 09:00:00,126,287,5,15,751,540,211,8
4330,2022-06-30 10:00:00,146,256,11,18,714,640,74,7
4331,2022-06-30 11:00:00,143,299,6,10,541,394,147,8
4332,2022-06-30 12:00:00,133,256,13,17,788,604,184,12
4333,2022-06-30 13:00:00,121,270,13,14,608,500,108,10
4334,2022-06-30 14:00:00,133,292,6,12,780,644,136,8
4335,2022-06-30 15:00:00,147,278,12,17,590,496,94,12
4336,2022-06-30 16:00:00,125,258,11,17,674,558,116,6
4337,2022-06-30 17:00:00,125,293,10,18,611,512,99,11
4338,2022-06-30 18:00:00,130,256,10,19,775,635,140,9
4339,2022-06-30 19:00:00,123,275,10,12,774,655,119,5
4340,2022-06-30 20:00:00,125,272,10,14,621,551,70,7
4341,2022-06-30 21:00:00,137,260,13,13,787,613,174,11
4342,2022-06-30 22:00:00,141,272,11,19,771,575,196,11
4343,2022-06-30 23:00:00,127,260,10,11,568,398,170,9
4344,2022-07-01 00:00:00,121,282,10,17,677,489,188,7
4345,2022-07-01 01:00:00,141,259,7,12,748,587,161,11
4346,2022-07-01 02:00:00,123,257,6,18,559,403,156,5
4347,2022-07-01 03:00:00,148,267,13,16,614,433,181,12
4348,2022-07-01 04:00:00,142,271,7,12,525,463,62,8
4349,2022-07-01 05:00:00,120,295,11,12,512,428,84,13
4350,2022-07-01 06:00:00,121,259,10,14,779,589,190,5
4351,2022-07-01 07:00:00,123,259,13,18,560,439,121,5
4352,2022-07-01 08:00:00,147,269,5,14,593,499,94,7
4353,2022-07-01 09:00:00,135,284,12,15,640,510,130,7
4354,2022-07-01 10:00:00,145,299,11,14,792,698,94,12
4355,2022-07-01 11:00:00,137,270,12,12,634,502,132,9
4356,2022-07-01 12:00:00,128,288,10,14,723,537,186,8
4357,2022-07-01 13:00:00,138,276,8,16,749,644,105,10
4358,2022-07-01 14:00:00,144,267,8,12,677,594,83,13
4359,2022-07-01 15:00:00,127,280,6,12,654,484,170,11
4360,2022-07-01 16:00:00,127,265,6,16,558,427,131,6
4361,2022-07-01 17:00:00,146,275,10,13,797,692,105,14
4362,2022-07-01 18:00:00,139,299,10,10,745,552,193,12
4363,2022-07-01 19:00:00,126,289,6,19,681,553,128,12
4364,2022-07-01 20:00:00,129,264,8,11,781,662,119,11
4365,2022-07-01 21:00:00,134,254,9,18,773,590,183,5
4366,2022-07-01 22:00:00,147,299,11,17,609,460,149,13
4367,2022-07-01 23:00:00,140,279,9,15,638,488,150,11
4368,2022-07-02 00:00:00,144,289,8,12,508,437,71,12
4369,2022-07-02 01:00:00,129,263,9,14,781,628,153,7
4370,2022-07-02 02:00:00,131,254,13,15,708,520,188,13
4371,2022-07-02 03:00:00,147,254,9,16,674,478,196,13
4372,2022-07-02 04:00:00,125,262,8,18,770,618,152,13
4373,2022-07-02 05:00:00,124,288,12,10,666,537,129,10
4374,2022-07-02 06:00:00,128,278,5,18,766,675,91,11
4375,2022-07-02 07:00:00,136,267,14,19,786,636,150,11
4376,2022-07-02 08:00:00,128,284,8,17,763,595,168,14
4377,2022-07-02 09:00:00,145,266,5,16,639,553,86,12
4378,2022-07-02 10:00:00,133,265,11,10,666,500,166,6
4379,2022-07-02 11:00:00,134,250,14,18,712,562,150,13
4380,2022-07-02 12:00:00,142,274,14,17,733,655,78,5
4381,2022-07-02 13:00:00,125,291,11,15,791,593,198,12
4382,2022-07-02 14:00:00,127,262,11,13,559,427,132,13
4383,2022-07-02 15:00:00,141,265,12,16,524,408,116,14
4384,2022-07-02 16:00:00,124,250,11,14,796,642,154,8
4385,2022-07-02 17:00:00,137,294,9,13,728,645,83,6
4386,2022-07-02 18:00:00,137,278,5,16,674,594,80,13
4387,2022-07-02 19:00:00,126,256,7,19,571,504,67,6
4388,2022-07-02 20:00:00,129,261,10,16,754,602,152,13
4389,2022-07-02 21:00:00,120,259,7,10,796,679,117,9
4390,2022-07-02 22:00:00,127,252,8,18,772,640,132,6
4391,2022-07-02 23:00:00,149,274,11,16,529,437,92,13
4392,2022-07-03 00:00:00,136,297,14,14,758,584,174,10
4393,2022-07-03 01:00:00,140,278,14,10,750,535,215,11
4394,2022-07-03 02:00:00,121,271,9,10,517,446,71,9
4395,2022-07-03 03:00:00,148,267,12,10,799,603,196,14
4396,2022-07-03 04:00:00,144,258,10,17,676,510,166,6
4397,2022-07-03 05:00:00,141,299,6,17,659,500,159,5
4398,2022-07-03 06:00:00,142,258,9,10,737,596,141,8
4399,2022-07-03 07:00:00,137,253,5,14,582,448,134,10
4400,2022-07-03 08:00:00,146,289,8,12,652,494,158,9
4401,2022-07-03 09:00:00,135,270,13,15,529,378,151,14
4402,2022-07-03 10:00:00,123,266,5,11,774,659,115,13
4403,2022-07-03 11:00:00,120,286,10,16,702,565,137,8
4404,2022-07-03 12:00:00,146,287,9,13,676,524,152,7
4405,2022-07-03 13:00:00,138,265,9,17,786,565,221,5
4406,2022-07-03 14:00:00,122,261,14,18,625,512,113,7
4407,2022-07-03 15:00:00,126,285,11,15,680,509,171,13
4408,2022-07-03 16:00:00,125,299,13,10,686,519,167,5
4409,2022-07-03 17:00:00,147,260,11,15,676,509,167,8
4410,2022-07-03 18:00:00,144,291,11,11,667,592,75,8
4411,2022-07-03 19:00:00,139,289,13,12,600,448,152,8
4412,2022-07-03 20:00:00,121,270,8,10,558,473,85,9
4413,2022-07-03 21:00:00,124,299,8,17,660,487,173,12
4414,2022-07-03 22:00:00,138,251,13,14,665,562,103,12
4415,2022-07-03 23:00:00,126,286,12,11,745,663,82,7
4416,2022-07-04 00:00:00,133,287,10,11,739,633,106,5
4417,2022-07-04 01:00:00,135,257,11,13,789,638,151,10
4418,2022-07-04 02:00:00,148,285,8,11,765,612,153,9
4419,2022-07-04 03:00:00,121,295,6,13,717,535,182,8
4420,2022-07-04 04:00:00,134,279,9,16,593,435,158,9
4421,2022-07-04 05:00:00,135,293,7,12,538,412,126,7
4422,2022-07-04 06:00:00,132,272,12,14,684,527,157,11
4423,2022-07-04 07:00:00,125,290,5,14,644,473,171,13
4424,2022-07-04 08:00:00,130,278,12,11,700,507,193,5
4425,2022-07-04 09:00:00,146,284,10,19,639,564,75,5
4426,2022-07-04 10:00:00,124,296,11,18,567,484,83,5
4427,2022-07-04 11:00:00,131,278,13,12,730,630,100,5
4428,2022-07-04 12:00:00,139,274,10,17,509,394,115,6
4429,2022-07-04 13:00:00,126,256,12,17,624,490,134,13
4430,2022-07-04 14:00:00,124,274,5,14,699,509,190,7
4431,2022-07-04 15:00:00,140,291,13,10,541,470,71,11
4432,2022-07-04 16:00:00,128,298,8,15,748,528,220,13
4433,2022-07-04 17:00:00,133,273,6,10,798,637,161,13
4434,2022-07-04 18:00:00,132,268,8,16,784,662,122,11
4435,2022-07-04 19:00:00,145,264,14,11,799,718,81,9
4436,2022-07-04 20:00:00,125,262,8,17,740,616,124,12
4437,2022-07-04 21:00:00,120,264,13,10,769,604,165,6
4438,2022-07-04 22:00:00,135,250,13,11,656,482,174,9
4439,2022-07-04 23:00:00,123,287,5,10,520,385,135,13
4440,2022-07-05 00:00:00,127,294,9,13,742,548,194,5
4441,2022-07-05 01:00:00,148,295,14,16,559,414,145,12
4442,2022-07-05 02:00:00,144,297,5,12,674,558,116,5
4443,2022-07-05 03:00:00,130,292,12,14,553,476,77,6
4444,2022-07-05 04:00:00,141,253,10,15,511,422,89,14
4445,2022-07-05 05:00:00,125,297,5,14,583,497,86,5
4446,2022-07-05 06:00:00,132,278,11,15,709,501,208,11
4447,2022-07-05 07:00:00,125,270,9,19,633,496,137,13
4448,2022-07-05 08:00:00,134,281,8,18,612,530,82,13
4449,2022-07-05 09:00:00,131,265,10,11,634,551,83,8
4450,2022-07-05 10:00:00,120,251,10,16,583,438,145,11
4451,2022-07-05 11:00:00,144,256,11,18,602,511,91,13
4452,2022-07-05 12:00:00,123,281,5,18,532,464,68,9
4453,2022-07-05 13:00:00,126,296,13,13,657,553,104,13
4454,2022-07-05 14:00:00,122,274,11,12,563,444,119,9
4455,2022-07-05 15:00:00,145,291,13,12,552,406,146,8
4456,2022-07-05 16:00:00,147,251,12,15,528,418,110,7
4457,2022-07-05 17:00:00,144,269,6,19,570,479,91,8
4458,2022-07-05 18:00:00,140,284,5,10,645,505,140,9
4459,2022-07-05 19:00:00,147,296,12,16,735,534,201,8
4460,2022-07-05 20:00:00,139,282,5,10,794,686,108,8
4461,2022-07-05 21:00:00,146,299,8,10,797,650,147,6
4462,2022-07-05 22:00:00,148,253,9,18,768,612,156,8
4463,2022-07-05 23:00:00,147,251,9,15,685,499,186,12
4464,2022-07-06 00:00:00,147,294,14,10,799,700,99,8
4465,2022-07-06 01:00:00,133,254,14,14,562,497,65,12
4466,2022-07-06 02:00:00,132,255,7,11,788,682,106,13
4467,2022-07-06 03:00:00,126,269,12,10,663,549,114,8
4468,2022-07-06 04:00:00,142,265,7,16,642,561,81,13
4469,2022-07-06 05:00:00,142,281,8,12,756,624,132,8
4470,2022-07-06 06:00:00,147,285,8,10,792,587,205,9
4471,2022-07-06 07:00:00,133,288,8,10,698,591,107,9
4472,2022-07-06 08:00:00,126,250,11,12,679,522,157,9
4473,2022-07-06 09:00:00,146,261,9,10,540,431,109,11
4474,2022-07-06 10:00:00,136,284,14,15,676,474,202,9
4475,2022-07-06 11:00:00,140,295,10,19,560,421,139,9
4476,2022-07-06 12:00:00,143,252,8,14,649,524,125,11
4477,2022-07-06 13:00:00,136,277,8,13,702,494,208,14
4478,2022-07-06 14:00:00,120,285,13,18,583,444,139,6
4479,2022-07-06 15:00:00,120,254,12,18,717,560,157,7
4480,2022-07-06 16:00:00,134,277,12,17,566,500,66,14
4481,2022-07-06 17:00:00,131,291,8,15,592,478,114,8
4482,2022-07-06 18:00:00,149,253,14,15,562,412,150,14
4483,2022-07-06 19:00:00,129,276,9,18,631,548,83,13
4484,2022-07-06 20:00:00,130,298,7,11,758,629,129,7
4485,2022-07-06 21:00:00,122,286,11,15,543,441,102,5
4486,2022-07-06 22:00:00,134,252,11,18,767,638,129,9
4487,2022-07-06 23:00:00,138,270,11,17,677,494,183,13
4488,2022-07-07 00:00:00,147,270,9,14,635,475,160,7
4489,2022-07-07 01:00:00,129,267,6,12,567,445,122,7
4490,2022-07-07 02:00:00,137,296,7,10,547,396,151,9
4491,2022-07-07 03:00:00,132,269,13,18,527,436,91,6
4492,2022-07-07 04:00:00,143,294,7,15,745,634,111,8
4493,2022-07-07 05:00:00,146,294,14,17,652,476,176,8
4494,2022-07-07 06:00:00,120,298,11,19,578,449,129,14
4495,2022-07-07 07:00:00,124,274,10,15,771,682,89,14
4496,2022-07-07 08:00:00,126,272,14,16,746,529,217,9
4497,2022-07-07 09:00:00,120,258,10,17,694,490,204,10
4498,2022-07-07 10:00:00,127,285,9,16,556,496,60,12
4499,2022-07-07 11:00:00,139,279,11,15,624,482,142,10
4500,2022-07-07 12:00:00,145,270,13,12,671,526,145,8
4501,2022-07-07 13:00:00,127,263,9,15,632,445,187,10
4502,2022-07-07 14:00:00,132,256,12,16,539,396,143,12
4503,2022-07-07 15:00:00,123,289,9,13,772,565,207,11
4504,2022-07-07 16:00:00,132,297,7,11,717,537,180,11
4505,2022-07-07 17:00:00,123,279,12,14,741,663,78,9
4506,2022-07-07 18:00:00,140,263,10,16,545,422,123,8
4507,2022-07-07 19:00:00,132,252,14,16,685,490,195,8
4508,2022-07-07 20:00:00,141,283,11,12,765,617,148,12
4509,2022-07-07 21:00:00,128,264,8,17,594,436,158,6
4510,2022-07-07 22:00:00,138,286,5,13,684,505,179,8
4511,2022-07-07 23:00:00,125,294,12,14,721,520,201,5
4512,2022-07-08 00:00:00,140,279,13,10,761,610,151,5
4513,2022-07-08 01:00:00,141,299,5,16,524,427,97,7
4514,2022-07-08 02:00:00,134,274,5,10,600,473,127,6
4515,2022-07-08 03:00:00,142,256,5,10,722,523,199,6
4516,2022-07-08 04:00:00,121,281,8,19,541,445,96,14
4517,2022-07-08 05:00:00,127,295,9,11,696,578,118,11
4518,2022-07-08 06:00:00,144,296,5,12,733,642,91,7
4519,2022-07-08 07:00:00,132,289,7,17,663,520,143,9
4520,2022-07-08 08:00:00,144,273,9,15,700,570,130,10
4521,2022-07-08 09:00:00,129,286,14,13,546,485,61,10
4522,2022-07-08 10:00:00,140,253,7,17,748,542,206,13
4523,2022-07-08 11:00:00,146,287,8,13,741,557,184,5
4524,2022-07-08 12:00:00,139,264,9,18,592,438,154,11
4525,2022-07-08 13:00:00,126,288,13,16,744,642,102,8
4526,2022-07-08 14:00:00,131,275,7,17,506,411,95,5
4527,2022-07-08 15:00:00,133,282,9,10,506,368,138,10
4528,2022-07-08 16:00:00,133,290,10,13,730,553,177,10
4529,2022-07-08 17:00:00,122,271,11,12,773,610,163,12
4530,2022-07-08 18:00:00,148,262,6,17,526,469,57,5
4531,2022-07-08 19:00:00,124,264,14,17,680,531,149,9
4532,2022-07-08 20:00:00,148,276,10,12,761,607,154,13
4533,2022-07-08 21:00:00,129,257,7,12,657,480,177,11
4534,2022-07-08 22:00:00,149,275,8,11,517,453,64,10
4535,2022-07-08 23:00:00,133,270,5,12,506,359,147,12
4536,2022-07-09 00:00:00,121,293,5,14,750,566,184,8
4537,2022-07-09 01:00:00,135,253,7,18,711,579,132,9
4538,2022-07-09 02:00:00,144,273,13,10,657,476,181,5
4539,2022-07-09 03:00:00,131,278,12,16,763,659,104,9
4540,2022-07-09 04:00:00,131,269,5,11,578,444,134,7
4541,2022-07-09 05:00:00,123,266,12,11,641,499,142,8
4542,2022-07-09 06:00:00,145,250,5,15,500,441,59,10
4543,2022-07-09 07:00:00,121,253,10,12,600,430,170,5
4544,2022-07-09 08:00:00,132,292,13,18,653,475,178,9
4545,2022-07-09 09:00:00,145,292,9,13,546,461,85,14
4546,2022-07-09 10:00:00,148,271,9,11,636,474,162,14
4547,2022-07-09 11:00:00,123,268,11,10,617,487,130,14
4548,2022-07-09 12:00:00,125,280,11,13,712,550,162,13
4549,2022-07-09 13:00:00,134,253,11,14,601,428,173,14
4550,2022-07-09 14:00:00,126,286,10,10,686,535,151,13
4551,2022-07-09 15:00:00,142,264,9,14,732,636,96,5
4552,2022-07-09 16:00:00,136,250,8,17,574,437,137,6
4553,2022-07-09 17:00:00,122,271,11,12,632,469,163,6
4554,2022-07-09 18:00:00,147,298,11,17,639,515,124,11
4555,2022-07-09 19:00:00,149,267,11,15,751,529,222,8
4556,2022-07-09 20:00:00,130,281,9,11,618,505,113,6
4557,2022-07-09 21:00:00,139,273,11,14,716,601,115,8
4558,2022-07-09 22:00:00,139,289,13,17,586,454,132,14
4559,2022-07-09 23:00:00,120,287,13,16,689,565,124,5
4560,2022-07-10 00:00:00,122,263,8,19,518,465,53,11
4561,2022-07-10 01:00:00,142,280,11,17,551,480,71,9
4562,2022-07-10 02:00:00,148,271,12,18,774,607,167,5
4563,2022-07-10 03:00:00,122,289,11,15,621,503,118,6
4564,2022-07-10 04:00:00,131,292,6,16,547,415,132,10
4565,2022-07-10 05:00:00,134,267,10,14,588,459,129,14
4566,2022-07-10 06:00:00,131,274,12,12,701,524,177,13
4567,2022-07-10 07:00:00,133,288,11,11,709,609,100,14
4568,2022-07-10 08:00:00,144,292,14,13,751,631,120,5
4569,2022-07-10 09:00:00,141,255,13,15,771,681,90,6
4570,2022-07-10 10:00:00,123,261,10,16,513,384,129,14
4571,2022-07-10 11:00:00,143,278,10,15,606,451,155,7
4572,2022-07-10 12:00:00,138,277,6,14,793,616,177,8
4573,2022-07-10 13:00:00,133,263,10,14,526,432,94,14
4574,2022-07-10 14:00:00,138,293,8,16,561,498,63,14
4575,2022-07-10 15:00:00,146,296,5,10,554,396,158,8
4576,2022-07-10 16:00:00,126,277,10,18,781,658,123,7
4577,2022-07-10 17:00:00,147,288,11,13,664,537,127,9
4578,2022-07-10 18:00:00,128,273,7,15,614,500,114,13
4579,2022-07-10 19:00:00,129,283,14,14,537,379,158,13
4580,2022-07-10 20:00:00,122,267,6,18,686,507,179,7
4581,2022-07-10 21:00:00,124,290,9,15,627,463,164,5
4582,2022-07-10 22:00:00,128,253,6,12,544,427,117,14
4583,2022-07-10 23:00:00,129,262,12,11,660,519,141,10
4584,2022-07-11 00:00:00,140,280,8,18,560,403,157,12
4585,2022-07-11 01:00:00,142,258,14,14,687,595,92,12
4586,2022-07-11 02:00:00,130,296,7,13,535,425,110,11
4587,2022-07-11 03:00:00,121,289,14,18,507,452,55,14
4588,2022-07-11 04:00:00,133,263,6,16,694,552,142,12
4589,2022-07-11 05:00:00,128,252,12,17,544,482,62,8
4590,2022-07-11 06:00:00,137,282,7,10,662,502,160,13
4591,2022-07-11 07:00:00,134,264,14,19,700,507,193,12
4592,2022-07-11 08:00:00,148,276,14,17,767,613,154,7
4593,2022-07-11 09:00:00,120,267,12,18,759,651,108,12
4594,2022-07-11 10:00:00,148,299,8,11,740,531,209,14
4595,2022-07-11 11:00:00,136,251,14,11,791,700,91,9
4596,2022-07-11 12:00:00,130,283,10,17,648,486,162,12
4597,2022-07-11 13:00:00,146,287,8,13,591,446,145,10
4598,2022-07-11 14:00:00,132,275,14,19,769,581,188,14
4599,2022-07-11 15:00:00,133,275,12,17,726,533,193,7
4600,2022-07-11 16:00:00,127,298,5,19,722,605,117,6
4601,2022-07-11 17:00:00,134,279,6,16,578,431,147,6
4602,2022-07-11 18:00:00,123,287,11,19,550,480,70,13
4603,2022-07-11 19:00:00,132,283,5,13,512,370,142,13
4604,2022-07-11 20:00:00,141,252,9,16,608,493,115,10
4605,2022-07-11 21:00:00,133,283,12,17,627,519,108,7
4606,2022-07-11 22:00:00,140,280,6,18,700,508,192,10
4607,2022-07-11 23:00:00,133,263,12,10,629,541,88,10
4608,2022-07-12 00:00:00,123,271,11,12,782,609,173,8
4609,2022-07-12 01:00:00,120,276,10,13,547,424,123,10
4610,2022-07-12 02:00:00,132,296,8,10,622,499,123,6
4611,2022-07-12 03:00:00,148,256,13,10,595,427,168,7
4612,2022-07-12 04:00:00,133,282,12,15,718,512,206,11
4613,2022-07-12 05:00:00,129,255,11,14,502,428,74,11
4614,2022-07-12 06:00:00,131,261,13,15,576,415,161,11
4615,2022-07-12 07:00:00,145,261,13,19,629,488,141,8
4616,2022-07-12 08:00:00,146,299,5,14,797,611,186,6
4617,2022-07-12 09:00:00,136,284,7,16,701,604,97,11
4618,2022-07-12 10:00:00,130,252,6,14,630,471,159,9
4619,2022-07-12 11:00:00,128,290,13,14,679,569,110,8
4620,2022-07-12 12:00:00,128,254,6,10,776,645,131,11
4621,2022-07-12 13:00:00,142,267,9,15,524,393,131,6
4622,2022-07-12 14:00:00,120,253,14,15,686,606,80,10
4623,2022-07-12 15:00:00,129,257,12,18,752,546,206,10
4624,2022-07-12 16:00:00,130,273,9,16,791,644,147,7
4625,2022-07-12 17:00:00,143,263,5,16,618,442,176,9
4626,2022-07-12 18:00:00,128,278,6,11,548,410,138,12
4627,2022-07-12 19:00:00,127,271,5,16,695,605,90,12
4628,2022-07-12 20:00:00,131,288,8,10,709,554,155,14
4629,2022-07-12 21:00:00,148,285,9,10,722,527,195,11
4630,2022-07-12 22:00:00,122,251,5,13,668,503,165,5
4631,2022-07-12 23:00:00,133,266,9,16,696,565,131,9
4632,2022-07-13 00:00:00,125,261,11,18,562,489,73,6
4633,2022-07-13 01:00:00,137,288,12,14,751,604,147,10
4634,2022-07-13 02:00:00,129,293,13,12,554,490,64,7
4635,2022-07-13 03:00:00,137,295,11,12,594,424,170,5
4636,2022-07-13 04:00:00,133,277,13,19,651,478,173,7
4637,2022-07-13 05:00:00,124,270,6,17,647,464,183,11
4638,2022-07-13 06:00:00,135,276,12,15,696,577,119,10
4639,2022-07-13 07:00:00,142,259,6,13,579,472,107,10
4640,2022-07-13 08:00:00,127,253,13,14,541,386,155,8
4641,2022-07-13 09:00:00,135,297,13,19,760,623,137,9
4642,2022-07-13 10:00:00,123,265,10,12,729,586,143,14
4643,2022-07-13 11:00:00,148,252,12,12,712,638,74,9
4644,2022-07-13 12:00:00,141,289,5,16,659,586,73,12
4645,2022-07-13 13:00:00,146,283,14,15,548,485,63,10
4646,2022-07-13 14:00:00,140,259,10,18,654,469,185,9
4647,2022-07-13 15:00:00,129,291,8,14,547,439,108,13
4648,2022-07-13 16:00:00,140,254,10,13,680,587,93,5
4649,2022-07-13 17:00:00,130,256,11,11,640,524,116,8
4650,2022-07-13 18:00:00,122,270,5,12,599,534,65,12
4651,2022-07-13 19:00:00,144,287,8,18,785,593,192,14
4652,2022-07-13 20:00:00,144,256,13,10,550,477,73,12
4653,2022-07-13 21:00:00,137,273,10,13,583,493,90,14
4654,2022-07-13 22:00:00,147,256,10,14,516,407,109,9
4655,2022-07-13 23:00:00,133,254,9,10,711,536,175,9
4656,2022-07-14 00:00:00,149,261,6,18,509,430,79,10
4657,2022-07-14 01:00:00,126,257,9,19,635,451,184,12
4658,2022-07-14 02:00:00,139,254,13,14,718,518,200,11
4659,2022-07-14 03:00:00,123,251,9,17,793,680,113,9
4660,2022-07-14 04:00:00,135,254,9,17,637,557,80,14
4661,2022-07-14 05:00:00,131,291,12,19,643,496,147,9
4662,2022-07-14 06:00:00,131,264,10,12,540,448,92,9
4663,2022-07-14 07:00:00,143,283,10,19,721,564,157,14
4664,2022-07-14 08:00:00,139,284,8,14,748,672,76,14
4665,2022-07-14 09:00:00,133,271,6,15,561,429,132,6
4666,2022-07-14 10:00:00,127,266,11,14,783,656,127,14
4667,2022-07-14 11:00:00,123,277,11,18,502,380,122,9
4668,2022-07-14 12:00:00,128,273,7,18,674,543,131,12
4669,2022-07-14 13:00:00,134,273,13,17,759,537,222,12
4670,2022-07-14 14:00:00,142,288,14,19,781,582,199,11
4671,2022-07-14 15:00:00,130,270,8,11,592,528,64,10
4672,2022-07-14 16:00:00,148,277,13,13,669,500,169,12
4673,2022-07-14 17:00:00,148,270,7,16,654,563,91,10
4674,2022-07-14 18:00:00,138,264,6,17,619,555,64,7
4675,2022-07-14 19:00:00,129,294,12,17,597,460,137,12
4676,2022-07-14 20:00:00,132,285,10,14,706,634,72,13
4677,2022-07-14 21:00:00,121,299,12,18,594,477,117,10
4678,2022-07-14 22:00:00,124,297,14,19,614,507,107,8
4679,2022-07-14 23:00:00,138,284,14,17,576,481,95,12
4680,2022-07-15 00:00:00,143,254,8,17,549,404,145,8
4681,2022-07-15 01:00:00,134,267,13,17,575,501,74,7
4682,2022-07-15 02:00:00,132,291,8,18,765,680,85,10
4683,2022-07-15 03:00:00,137,283,13,14,628,459,169,8
4684,2022-07-15 04:00:00,122,298,14,13,695,558,137,10
4685,2022-07-15 05:00:00,121,277,5,14,779,691,88,13
4686,2022-07-15 06:00:00,143,270,8,13,658,483,175,13
4687,2022-07-15 07:00:00,138,258,10,16,750,553,197,11
4688,2022-07-15 08:00:00,140,295,10,12,754,662,92,6
4689,2022-07-15 09:00:00,141,284,10,16,607,466,141,5
4690,2022-07-15 10:00:00,141,277,8,17,793,572,221,7
4691,2022-07-15 11:00:00,142,279,10,19,555,481,74,9
4692,2022-07-15 12:00:00,132,292,10,17,567,407,160,11
4693,2022-07-15 13:00:00,144,268,11,11,510,368,142,13
4694,2022-07-15 14:00:00,145,270,11,12,566,429,137,11
4695,2022-07-15 15:00:00,147,282,12,18,572,469,103,14
4696,2022-07-15 16:00:00,141,257,14,15,574,432,142,9
4697,2022-07-15 17:00:00,126,254,9,17,689,564,125,14
4698,2022-07-15 18:00:00,141,280,10,10,733,513,220,14
4699,2022-07-15 19:00:00,120,286,10,11,729,530,199,11
4700,2022-07-15 20:00:00,148,264,10,19,637,458,179,12
4701,2022-07-15 21:00:00,148,251,12,11,757,590,167,5
4702,2022-07-15 22:00:00,131,257,13,17,647,553,94,5
4703,2022-07-15 23:00:00,135,296,8,10,651,481,170,7
4704,2022-07-16 00:00:00,145,264,8,13,772,642,130,10
4705,2022-07-16 01:00:00,131,270,10,19,626,541,85,9
4706,2022-07-16 02:00:00,134,254,12,11,742,636,106,9
4707,2022-07-16 03:00:00,127,265,8,11,695,543,152,11
4708,2022-07-16 04:00:00,130,254,8,15,791,613,178,12
4709,2022-07-16 05:00:00,127,296,6,19,780,597,183,11
4710,2022-07-16 06:00:00,148,265,6,16,696,506,190,10
4711,2022-07-16 07:00:00,137,284,7,11,589,447,142,11
4712,2022-07-16 08:00:00,129,275,7,14,629,469,160,6
4713,2022-07-16 09:00:00,130,265,6,13,761,674,87,10
4714,2022-07-16 10:00:00,139,296,5,17,621,499,122,7
4715,2022-07-16 11:00:00,131,293,8,10,531,402,129,11
4716,2022-07-16 12:00:00,135,281,14,12,673,556,117,14
4717,2022-07-16 13:00:00,144,299,7,19,591,482,109,7
4718,2022-07-16 14:00:00,124,271,9,17,784,620,164,7
4719,2022-07-16 15:00:00,145,257,6,11,665,475,190,14
4720,2022-07-16 16:00:00,141,258,14,13,602,503,99,12
4721,2022-07-16 17:00:00,137,259,5,19,610,465,145,9
4722,2022-07-16 18:00:00,133,275,9,18,581,453,128,10
4723,2022-07-16 19:00:00,132,283,9,19,776,581,195,5
4724,2022-07-16 20:00:00,127,264,7,18,601,435,166,14
4725,2022-07-16 21:00:00,124,261,8,14,567,413,154,6
4726,2022-07-16 22:00:00,135,263,12,17,770,637,133,14
4727,2022-07-16 23:00:00,126,281,13,12,670,560,110,5
4728,2022-07-17 00:00:00,133,274,6,10,777,654,123,6
4729,2022-07-17 01:00:00,131,269,14,19,755,617,138,7
4730,2022-07-17 02:00:00,132,251,12,17,661,472,189,13
4731,2022-07-17 03:00:00,136,282,10,11,750,613,137,14
4732,2022-07-17 04:00:00,142,265,8,14,699,573,126,10
4733,2022-07-17 05:00:00,137,285,5,18,500,355,145,6
4734,2022-07-17 06:00:00,143,267,7,12,605,428,177,12
4735,2022-07-17 07:00:00,142,296,9,13,648,580,68,9
4736,2022-07-17 08:00:00,125,267,5,10,675,535,140,5
4737,2022-07-17 09:00:00,138,292,13,17,717,629,88,5
4738,2022-07-17 10:00:00,135,290,11,13,703,492,211,8
4739,2022-07-17 11:00:00,133,271,11,17,643,529,114,14
4740,2022-07-17 12:00:00,121,298,6,14,746,593,153,8
4741,2022-07-17 13:00:00,127,297,14,11,721,528,193,5
4742,2022-07-17 14:00:00,124,298,14,18,519,407,112,6
4743,2022-07-17 15:00:00,123,271,14,13,650,532,118,6
4744,2022-07-17 16:00:00,149,297,11,19,673,555,118,14
4745,2022-07-17 17:00:00,127,296,7,19,798,635,163,8
4746,2022-07-17 18:00:00,135,270,8,12,693,540,153,10
4747,2022-07-17 19:00:00,147,286,9,13,520,401,119,12
4748,2022-07-17 20:00:00,148,293,14,10,739,619,120,11
4749,2022-07-17 21:00:00,143,280,7,14,780,554,226,10
4750,2022-07-17 22:00:00,137,267,11,16,515,462,53,13
4751,2022-07-17 23:00:00,126,279,11,17,595,464,131,14
4752,2022-07-18 00:00:00,120,299,9,16,598,475,123,12
4753,2022-07-18 01:00:00,148,265,11,13,558,473,85,8
4754,2022-07-18 02:00:00,120,294,5,19,787,594,193,10
4755,2022-07-18 03:00:00,129,279,12,16,629,482,147,13
4756,2022-07-18 04:00:00,126,266,13,10,506,431,75,13
4757,2022-07-18 05:00:00,144,282,7,10,781,621,160,8
4758,2022-07-18 06:00:00,146,292,11,13,781,692,89,8
4759,2022-07-18 07:00:00,120,287,5,19,788,638,150,10
4760,2022-07-18 08:00:00,136,284,5,16,747,583,164,14
4761,2022-07-18 09:00:00,131,272,7,14,640,550,90,7
4762,2022-07-18 10:00:00,137,261,13,18,773,663,110,8
4763,2022-07-18 11:00:00,120,289,9,17,527,404,123,14
4764,2022-07-18 12:00:00,131,284,7,10,704,591,113,14
4765,2022-07-18 13:00:00,124,276,13,16,549,420,129,14
4766,2022-07-18 14:00:00,124,255,8,11,671,490,181,7
4767,2022-07-18 15:00:00,137,272,5,19,790,698,92,12
4768,2022-07-18 16:00:00,143,275,13,12,675,543,132,9
4769,2022-07-18 17:00:00,148,293,9,18,796,577,219,5
4770,2022-07-18 18:00:00,129,264,6,19,593,420,173,14
4771,2022-07-18 19:00:00,146,291,7,19,689,483,206,10
4772,2022-07-18 20:00:00,141,254,11,12,666,488,178,5
4773,2022-07-18 21:00:00,135,286,11,12,654,540,114,5
4774,2022-07-18 22:00:00,143,273,8,18,794,655,139,6
4775,2022-07-18 23:00:00,126,277,11,16,561,462,99,14
4776,2022-07-19 00:00:00,144,277,12,16,658,472,186,6
4777,2022-07-19 01:00:00,143,272,5,11,503,449,54,6
4778,2022-07-19 02:00:00,125,299,13,10,569,429,140,14
4779,2022-07-19 03:00:00,143,293,5,12,771,680,91,11
4780,2022-07-19 04:00:00,140,270,14,11,650,505,145,13
4781,2022-07-19 05:00:00,136,270,13,11,722,612,110,13
4782,2022-07-19 06:00:00,137,265,13,16,746,617,129,12
4783,2022-07-19 07:00:00,139,282,5,19,789,637,152,11
4784,2022-07-19 08:00:00,126,288,13,12,582,444,138,14
4785,2022-07-19 09:00:00,132,292,6,11,541,450,91,11
4786,2022-07-19 10:00:00,120,256,13,18,612,454,158,14
4787,2022-07-19 11:00:00,121,297,8,13,698,497,201,7
4788,2022-07-19 12:00:00,138,280,14,19,504,368,136,13
4789,2022-07-19 13:00:00,139,295,6,18,566,501,65,12
4790,2022-07-19 14:00:00,126,274,6,11,529,438,91,10
4791,2022-07-19 15:00:00,136,266,5,16,745,632,113,13
4792,2022-07-19 16:00:00,124,273,8,10,790,650,140,14
4793,2022-07-19 17:00:00,138,276,10,11,697,527,170,12
4794,2022-07-19 18:00:00,131,293,13,10,787,620,167,8
4795,2022-07-19 19:00:00,125,250,6,13,671,548,123,13
4796,2022-07-19 20:00:00,132,257,13,17,751,671,80,7
4797,2022-07-19 21:00:00,120,250,14,12,749,553,196,12
4798,2022-07-19 22:00:00,139,278,9,17,504,353,151,13
4799,2022-07-19 23:00:00,126,273,6,14,507,384,123,8
4800,2022-07-20 00:00:00,134,287,11,17,664,578,86,12
4801,2022-07-20 01:00:00,129,272,9,18,597,420,177,14
4802,2022-07-20 02:00:00,123,287,12,19,641,530,111,13
4803,2022-07-20 03:00:00,126,275,10,12,522,462,60,14
4804,2022-07-20 04:00:00,147,275,12,15,687,551,136,6
4805,2022-07-20 05:00:00,120,277,12,13,663,515,148,11
4806,2022-07-20 06:00:00,143,294,8,16,553,471,82,10
4807,2022-07-20 07:00:00,133,283,10,15,516,381,135,11
4808,2022-07-20 08:00:00,124,291,9,13,619,473,146,9
4809,2022-07-20 09:00:00,127,263,9,15,521,402,119,12
4810,2022-07-20 10:00:00,129,258,6,19,535,444,91,11
4811,2022-07-20 11:00:00,144,253,14,15,635,486,149,11
4812,2022-07-20 12:00:00,135,260,14,19,515,365,150,13
4813,2022-07-20 13:00:00,122,253,12,11,786,675,111,12
4814,2022-07-20 14:00:00,138,262,13,13,619,541,78,5
4815,2022-07-20 15:00:00,138,262,7,18,770,581,189,10
4816,2022-07-20 16:00:00,148,263,11,16,632,552,80,9
4817,2022-07-20 17:00:00,147,259,7,15,753,675,78,8
4818,2022-07-20 18:00:00,128,270,14,16,731,628,103,9
4819,2022-07-20 19:00:00,125,277,6,12,654,585,69,13
4820,2022-07-20 20:00:00,145,284,14,11,771,652,119,8
4821,2022-07-20 21:00:00,123,263,12,13,746,589,157,9
4822,2022-07-20 22:00:00,136,251,8,11,733,623,110,12
4823,2022-07-20 23:00:00,126,291,14,10,564,467,97,7
4824,2022-07-21 00:00:00,135,260,12,11,628,498,130,7
4825,2022-07-21 01:00:00,146,291,6,10,511,410,101,9
4826,2022-07-21 02:00:00,130,283,10,10,505,386,119,9
4827,2022-07-21 03:00:00,146,290,14,15,565,475,90,9
4828,2022-07-21 04:00:00,129,260,10,16,629,493,136,13
4829,2022-07-21 05:00:00,124,273,11,10,736,641,95,14
4830,2022-07-21 06:00:00,127,275,9,18,737,628,109,6
4831,2022-07-21 07:00:00,134,260,10,15,751,584,167,8
4832,2022-07-21 08:00:00,146,258,8,17,588,471,117,8
4833,2022-07-21 09:00:00,137,259,10,18,520,383,137,8
4834,2022-07-21 10:00:00,133,265,6,18,528,418,110,9
4835,2022-07-21 11:00:00,146,272,14,11,517,399,118,12
4836,2022-07-21 12:00:00,128,274,6,18,518,374,144,14
4837,2022-07-21 13:00:00,147,296,9,19,663,495,168,7
4838,2022-07-21 14:00:00,130,286,9,18,729,587,142,13
4839,2022-07-21 15:00:00,140,255,7,13,690,542,148,8
4840,2022-07-21 16:00:00,149,257,11,14,593,480,113,7
4841,2022-07-21 17:00:00,143,257,12,17,509,441,68,5
4842,2022-07-21 18:00:00,129,295,12,17,547,485,62,7
4843,2022-07-21 19:00:00,147,296,6,10,686,484,202,11
4844,2022-07-21 20:00:00,138,286,6,14,727,591,136,7
4845,2022-07-21 21:00:00,122,290,8,19,523,454,69,10
4846,2022-07-21 22:00:00,142,276,12,17,763,652,111,14
4847,2022-07-21 23:00:00,145,288,13,16,605,429,176,6
4848,2022-07-22 00:00:00,121,253,7,19,725,606,119,9
4849,2022-07-22 01:00:00,146,290,11,12,642,543,99,8
4850,2022-07-22 02:00:00,124,284,5,12,521,430,91,11
4851,2022-07-22 03:00:00,132,276,5,10,744,587,157,13
4852,2022-07-22 04:00:00,123,282,14,18,775,688,87,7
4853,2022-07-22 05:00:00,149,261,14,10,733,596,137,7
4854,2022-07-22 06:00:00,132,272,5,11,733,518,215,10
4855,2022-07-22 07:00:00,143,255,14,13,521,419,102,13
4856,2022-07-22 08:00:00,132,271,8,10,742,610,132,6
4857,2022-07-22 09:00:00,122,256,11,12,506,408,98,12
4858,2022-07-22 10:00:00,138,266,11,15,772,678,94,13
4859,2022-07-22 11:00:00,139,295,14,17,648,512,136,8
4860,2022-07-22 12:00:00,126,291,5,13,515,386,129,8
4861,2022-07-22 13:00:00,141,273,6,17,707,557,150,7
4862,2022-07-22 14:00:00,143,282,10,11,608,427,181,9
4863,2022-07-22 15:00:00,130,282,14,19,529,421,108,13
4864,2022-07-22 16:00:00,129,261,14,16,746,665,81,13
4865,2022-07-22 17:00:00,135,292,10,13,692,496,196,13
4866,2022-07-22 18:00:00,129,266,10,13,680,506,174,13
4867,2022-07-22 19:00:00,139,281,12,10,706,555,151,11
4868,2022-07-22 20:00:00,142,262,5,18,517,373,144,7
4869,2022-07-22 21:00:00,120,284,14,14,774,674,100,13
4870,2022-07-22 22:00:00,130,268,14,15,782,632,150,13
4871,2022-07-22 23:00:00,136,283,10,19,731,513,218,13
4872,2022-07-23 00:00:00,129,258,7,12,672,591,81,10
4873,2022-07-23 01:00:00,149,296,10,15,709,514,195,5
4874,2022-07-23 02:00:00,145,260,11,18,718,515,203,7
4875,2022-07-23 03:00:00,121,258,13,14,689,498,191,12
4876,2022-07-23 04:00:00,133,272,8,14,679,572,107,11
4877,2022-07-23 05:00:00,148,263,9,13,607,489,118,7
4878,2022-07-23 06:00:00,128,284,6,17,755,544,211,14
4879,2022-07-23 07:00:00,128,263,12,15,626,454,172,13
4880,2022-07-23 08:00:00,131,261,6,15,540,392,148,13
4881,2022-07-23 09:00:00,142,266,6,19,723,527,196,7
4882,2022-07-23 10:00:00,137,277,13,11,671,486,185,8
4883,2022-07-23 11:00:00,143,255,14,18,723,521,202,10
4884,2022-07-23 12:00:00,122,293,8,11,548,437,111,13
4885,2022-07-23 13:00:00,135,294,8,14,552,495,57,6
4886,2022-07-23 14:00:00,144,291,11,11,543,476,67,5
4887,2022-07-23 15:00:00,134,270,8,17,721,637,84,8
4888,2022-07-23 16:00:00,120,267,6,18,699,540,159,13
4889,2022-07-23 17:00:00,134,273,6,14,765,645,120,12
4890,2022-07-23 18:00:00,130,266,7,10,784,696,88,9
4891,2022-07-23 19:00:00,125,289,8,15,632,511,121,10
4892,2022-07-23 20:00:00,136,253,14,12,584,459,125,12
4893,2022-07-23 21:00:00,134,299,6,14,538,413,125,11
4894,2022-07-23 22:00:00,127,276,13,16,590,507,83,6
4895,2022-07-23 23:00:00,129,293,6,13,609,527,82,13
4896,2022-07-24 00:00:00,121,297,7,18,669,490,179,12
4897,2022-07-24 01:00:00,124,295,13,18,631,483,148,13
4898,2022-07-24 02:00:00,143,256,9,17,786,651,135,13
4899,2022-07-24 03:00:00,127,299,13,12,790,572,218,12
4900,2022-07-24 04:00:00,137,253,12,15,598,449,149,7
4901,2022-07-24 05:00:00,149,289,5,18,513,452,61,7
4902,2022-07-24 06:00:00,129,251,14,18,501,385,116,9
4903,2022-07-24 07:00:00,139,290,9,14,673,562,111,13
4904,2022-07-24 08:00:00,125,270,14,14,617,523,94,6
4905,2022-07-24 09:00:00,129,265,12,19,666,525,141,12
4906,2022-07-24 10:00:00,128,295,8,18,613,465,148,5
4907,2022-07-24 11:00:00,133,263,13,18,786,669,117,5
4908,2022-07-24 12:00:00,140,281,14,16,733,565,168,11
4909,2022-07-24 13:00:00,134,264,12,16,659,591,68,8
4910,2022-07-24 14:00:00,149,252,7,11,597,419,178,11
4911,2022-07-24 15:00:00,130,298,10,14,720,549,171,10
4912,2022-07-24 16:00:00,143,265,11,12,572,455,117,12
4913,2022-07-24 17:00:00,149,254,7,19,770,638,132,9
4914,2022-07-24 18:00:00,131,264,10,11,678,526,152,8
4915,2022-07-24 19:00:00,125,294,12,19,789,612,177,11
4916,2022-07-24 20:00:00,131,277,6,13,589,520,69,6
4917,2022-07-24 21:00:00,121,283,10,19,591,431,160,9
4918,2022-07-24 22:00:00,138,262,13,11,533,454,79,7
4919,2022-07-24 23:00:00,140,251,6,16,797,575,222,11
4920,2022-07-25 00:00:00,143,270,8,16,620,516,104,5
4921,2022-07-25 01:00:00,130,267,13,14,736,582,154,5
4922,2022-07-25 02:00:00,124,271,11,12,553,436,117,8
4923,2022-07-25 03:00:00,135,291,10,16,795,594,201,14
4924,2022-07-25 04:00:00,127,250,12,19,564,428,136,8
4925,2022-07-25 05:00:00,148,250,6,11,514,420,94,9
4926,2022-07-25 06:00:00,128,277,10,13,662,551,111,11
4927,2022-07-25 07:00:00,122,250,5,15,736,611,125,9
4928,2022-07-25 08:00:00,129,287,14,17,589,526,63,6
4929,2022-07-25 09:00:00,126,262,9,10,513,442,71,11
4930,2022-07-25 10:00:00,139,255,10,17,624,502,122,11
4931,2022-07-25 11:00:00,132,288,13,15,771,691,80,11
4932,2022-07-25 12:00:00,129,251,6,11,616,472,144,6
4933,2022-07-25 13:00:00,130,267,5,17,612,534,78,8
4934,2022-07-25 14:00:00,132,284,6,10,562,462,100,14
4935,2022-07-25 15:00:00,131,287,13,15,644,555,89,9
4936,2022-07-25 16:00:00,142,288,14,10,786,685,101,5
4937,2022-07-25 17:00:00,136,290,5,12,690,562,128,10
4938,2022-07-25 18:00:00,127,263,12,18,706,536,170,10
4939,2022-07-25 19:00:00,148,275,9,12,608,457,151,10
4940,2022-07-25 20:00:00,131,293,10,11,574,417,157,9
4941,2022-07-25 21:00:00,122,257,8,16,656,579,77,14
4942,2022-07-25 22:00:00,120,275,13,11,622,537,85,13
4943,2022-07-25 23:00:00,121,292,6,15,560,434,126,8
4944,2022-07-26 00:00:00,128,294,6,12,705,609,96,7
4945,2022-07-26 01:00:00,128,252,9,11,698,561,137,14
4946,2022-07-26 02:00:00,132,290,7,16,638,504,134,11
4947,2022-07-26 03:00:00,149,259,11,10,545,480,65,12
4948,2022-07-26 04:00:00,124,261,8,11,690,541,149,5
4949,2022-07-26 05:00:00,144,270,13,19,569,486,83,9
4950,2022-07-26 06:00:00,123,273,12,19,725,626,99,10
4951,2022-07-26 07:00:00,128,260,12,14,539,459,80,10
4952,2022-07-26 08:00:00,120,296,12,16,581,499,82,5
4953,2022-07-26 09:00:00,124,278,6,15,792,577,215,5
4954,2022-07-26 10:00:00,135,291,13,19,627,496,131,8
4955,2022-07-26 11:00:00,148,276,14,12,583,430,153,7
4956,2022-07-26 12:00:00,145,284,14,13,518,366,152,7
4957,2022-07-26 13:00:00,149,289,6,16,711,584,127,5
4958,2022-07-26 14:00:00,135,250,14,12,546,388,158,7
4959,2022-07-26 15:00:00,132,252,8,11,584,484,100,11
4960,2022-07-26 16:00:00,141,271,14,12,781,652,129,7
4961,2022-07-26 17:00:00,140,260,14,11,711,511,200,6
4962,2022-07-26 18:00:00,128,288,13,14,796,608,188,6
4963,2022-07-26 19:00:00,136,285,9,18,528,374,154,14
4964,2022-07-26 20:00:00,137,290,6,19,645,570,75,13
4965,2022-07-26 21:00:00,120,290,8,19,542,435,107,5
4966,2022-07-26 22:00:00,140,273,6,15,789,660,129,5
4967,2022-07-26 23:00:00,131,271,10,19,733,622,111,10
4968,2022-07-27 00:00:00,148,281,11,11,701,597,104,6
4969,2022-07-27 01:00:00,145,291,6,10,692,594,98,9
4970,2022-07-27 02:00:00,122,294,8,15,627,478,149,13
4971,2022-07-27 03:00:00,123,265,14,19,617,516,101,6
4972,2022-07-27 04:00:00,149,281,14,18,728,614,114,7
4973,2022-07-27 05:00:00,145,289,8,19,676,558,118,14
4974,2022-07-27 06:00:00,127,296,5,15,787,567,220,7
4975,2022-07-27 07:00:00,138,290,8,18,623,464,159,8
4976,2022-07-27 08:00:00,136,260,5,13,539,432,107,13
4977,2022-07-27 09:00:00,136,257,11,14,616,513,103,14
4978,2022-07-27 10:00:00,139,289,13,16,767,660,107,12
4979,2022-07-27 11:00:00,133,259,9,17,745,571,174,6
4980,2022-07-27 12:00:00,146,253,8,11,617,490,127,14
4981,2022-07-27 13:00:00,129,262,6,11,574,450,124,10
4982,2022-07-27 14:00:00,139,267,11,14,675,474,201,11
4983,2022-07-27 15:00:00,137,281,13,12,713,532,181,11
4984,2022-07-27 16:00:00,134,257,9,15,586,512,74,10
4985,2022-07-27 17:00:00,135,276,14,13,630,489,141,7
4986,2022-07-27 18:00:00,130,270,10,14,791,578,213,10
4987,2022-07-27 19:00:00,142,251,9,17,600,485,115,10
4988,2022-07-27 20:00:00,128,254,9,10,577,421,156,12
4989,2022-07-27 21:00:00,131,262,7,19,726,625,101,7
4990,2022-07-27 22:00:00,144,299,12,14,539,470,69,10
4991,2022-07-27 23:00:00,122,285,13,15,567,460,107,14
4992,2022-07-28 00:00:00,134,283,9,16,600,444,156,11
4993,2022-07-28 01:00:00,141,276,6,10,651,547,104,13
4994,2022-07-28 02:00:00,132,294,9,14,554,473,81,10
4995,2022-07-28 03:00:00,138,267,5,10,576,460,116,10
4996,2022-07-28 04:00:00,141,255,7,12,747,539,208,7
4997,2022-07-28 05:00:00,130,286,13,12,699,602,97,8
4998,2022-07-28 06:00:00,146,289,10,14,677,555,122,14
4999,2022-07-28 07:00:00,123,291,12,14,666,497,169,5
5000,2022-07-28 08:00:00,125,290,13,11,623,547,76,9
5001,2022-07-28 09:00:00,145,274,10,17,560,407,153,9
5002,2022-07-28 10:00:00,141,252,9,10,727,627,100,11
5003,2022-07-28 11:00:00,132,285,14,19,669,598,71,12
5004,2022-07-28 12:00:00,139,250,9,12,799,710,89,11
5005,2022-07-28 13:00:00,125,290,10,15,622,447,175,6
5006,2022-07-28 14:00:00,120,262,13,10,626,514,112,9
5007,2022-07-28 15:00:00,123,296,11,14,790,559,231,10
5008,2022-07-28 16:00:00,141,255,9,11,603,475,128,7
5009,2022-07-28 17:00:00,126,270,7,12,519,399,120,7
5010,2022-07-28 18:00:00,123,259,5,12,605,495,110,6
5011,2022-07-28 19:00:00,136,292,8,17,595,441,154,11
5012,2022-07-28 20:00:00,141,269,5,15,595,511,84,7
5013,2022-07-28 21:00:00,125,253,6,19,678,475,203,10
5014,2022-07-28 22:00:00,120,270,6,12,606,455,151,8
5015,2022-07-28 23:00:00,131,270,11,17,518,453,65,10
5016,2022-07-29 00:00:00,124,272,7,10,581,424,157,5
5017,2022-07-29 01:00:00,143,251,11,13,639,548,91,13
5018,2022-07-29 02:00:00,122,257,10,11,666,529,137,11
5019,2022-07-29 03:00:00,127,262,5,13,660,521,139,12
5020,2022-07-29 04:00:00,146,268,12,12,699,601,98,8
5021,2022-07-29 05:00:00,128,290,5,14,589,470,119,12
5022,2022-07-29 06:00:00,141,251,13,12,591,478,113,11
5023,2022-07-29 07:00:00,120,265,10,19,558,397,161,13
5024,2022-07-29 08:00:00,131,282,5,13,595,482,113,5
5025,2022-07-29 09:00:00,141,289,6,15,557,470,87,7
5026,2022-07-29 10:00:00,148,256,9,14,536,452,84,8
5027,2022-07-29 11:00:00,140,258,12,16,560,477,83,7
5028,2022-07-29 12:00:00,141,276,7,15,711,588,123,14
5029,2022-07-29 13:00:00,135,283,13,11,631,541,90,6
5030,2022-07-29 14:00:00,124,250,12,17,561,457,104,6
5031,2022-07-29 15:00:00,135,286,7,19,756,664,92,5
5032,2022-07-29 16:00:00,146,289,5,15,574,481,93,8
5033,2022-07-29 17:00:00,129,278,9,14,530,453,77,7
5034,2022-07-29 18:00:00,122,252,6,18,728,580,148,8
5035,2022-07-29 19:00:00,126,295,6,10,735,598,137,6
5036,2022-07-29 20:00:00,131,275,6,11,588,492,96,10
5037,2022-07-29 21:00:00,124,297,11,15,562,477,85,13
5038,2022-07-29 22:00:00,131,269,12,19,561,446,115,14
5039,2022-07-29 23:00:00,127,282,10,10,539,446,93,14
5040,2022-07-30 00:00:00,126,287,8,17,793,607,186,9
5041,2022-07-30 01:00:00,148,259,5,13,532,410,122,8
5042,2022-07-30 02:00:00,132,263,11,12,534,409,125,7
5043,2022-07-30 03:00:00,144,259,12,16,761,596,165,8
5044,2022-07-30 04:00:00,132,286,6,19,683,562,121,8
5045,2022-07-30 05:00:00,147,260,10,15,703,492,211,6
5046,2022-07-30 06:00:00,147,257,14,17,582,517,65,14
5047,2022-07-30 07:00:00,122,272,5,17,691,527,164,12
5048,2022-07-30 08:00:00,131,276,14,16,615,500,115,14
5049,2022-07-30 09:00:00,143,289,5,15,745,526,219,7
5050,2022-07-30 10:00:00,131,268,13,16,796,676,120,8
5051,2022-07-30 11:00:00,136,294,6,19,579,447,132,6
5052,2022-07-30 12:00:00,136,278,14,15,711,583,128,5
5053,2022-07-30 13:00:00,147,260,8,10,510,373,137,8
5054,2022-07-30 14:00:00,135,274,6,17,701,499,202,12
5055,2022-07-30 15:00:00,144,298,9,15,691,605,86,9
5056,2022-07-30 16:00:00,137,254,13,18,701,496,205,6
5057,2022-07-30 17:00:00,149,287,11,18,772,549,223,5
5058,2022-07-30 18:00:00,149,273,14,16,681,537,144,10
5059,2022-07-30 19:00:00,122,268,7,16,773,557,216,7
5060,2022-07-30 20:00:00,131,287,13,16,772,601,171,5
5061,2022-07-30 21:00:00,141,299,8,14,773,684,89,11
5062,2022-07-30 22:00:00,135,290,9,15,512,415,97,7
5063,2022-07-30 23:00:00,130,270,6,12,625,491,134,13
5064,2022-07-31 00:00:00,132,290,14,16,700,595,105,9
5065,2022-07-31 01:00:00,140,262,7,13,706,623,83,7
5066,2022-07-31 02:00:00,124,259,11,16,712,600,112,13
5067,2022-07-31 03:00:00,125,254,13,10,629,518,111,12
5068,2022-07-31 04:00:00,122,258,10,12,765,543,222,7
5069,2022-07-31 05:00:00,141,259,13,14,653,461,192,14
5070,2022-07-31 06:00:00,148,263,7,19,682,525,157,7
5071,2022-07-31 07:00:00,136,261,10,17,643,551,92,8
5072,2022-07-31 08:00:00,140,293,10,10,778,548,230,9
5073,2022-07-31 09:00:00,124,264,5,10,792,702,90,7
5074,2022-07-31 10:00:00,133,259,11,19,799,666,133,9
5075,2022-07-31 11:00:00,130,256,5,13,548,450,98,12
5076,2022-07-31 12:00:00,122,278,10,12,606,495,111,6
5077,2022-07-31 13:00:00,125,262,13,15,572,420,152,8
5078,2022-07-31 14:00:00,143,270,6,11,637,527,110,8
5079,2022-07-31 15:00:00,135,292,7,10,716,638,78,10
5080,2022-07-31 16:00:00,131,296,14,14,671,489,182,9
5081,2022-07-31 17:00:00,134,274,7,17,725,586,139,5
5082,2022-07-31 18:00:00,133,294,13,16,606,475,131,11
5083,2022-07-31 19:00:00,142,277,8,14,790,635,155,9
5084,2022-07-31 20:00:00,147,292,12,19,705,529,176,6
5085,2022-07-31 21:00:00,125,260,14,19,698,599,99,9
5086,2022-07-31 22:00:00,136,298,10,10,513,444,69,8
5087,2022-07-31 23:00:00,142,263,13,10,727,563,164,6
5088,2022-08-01 00:00:00,126,288,6,11,726,574,152,13
5089,2022-08-01 01:00:00,120,258,7,16,576,479,97,6
5090,2022-08-01 02:00:00,127,289,13,12,770,691,79,10
5091,2022-08-01 03:00:00,145,275,5,15,789,557,232,5
5092,2022-08-01 04:00:00,134,277,10,10,725,580,145,6
5093,2022-08-01 05:00:00,122,255,13,16,573,404,169,9
5094,2022-08-01 06:00:00,146,284,6,14,640,532,108,13
5095,2022-08-01 07:00:00,141,273,8,16,697,601,96,12
5096,2022-08-01 08:00:00,142,295,8,15,695,618,77,8
5097,2022-08-01 09:00:00,129,283,14,19,665,475,190,6
5098,2022-08-01 10:00:00,144,286,12,18,623,448,175,6
5099,2022-08-01 11:00:00,121,288,9,12,546,460,86,10
5100,2022-08-01 12:00:00,123,281,12,14,723,600,123,12
5101,2022-08-01 13:00:00,143,261,8,12,573,474,99,7
5102,2022-08-01 14:00:00,149,284,14,12,643,569,74,11
5103,2022-08-01 15:00:00,121,272,9,19,680,563,117,7
5104,2022-08-01 16:00:00,148,293,8,16,511,404,107,10
5105,2022-08-01 17:00:00,122,293,13,13,779,570,209,6
5106,2022-08-01 18:00:00,132,297,11,13,677,476,201,7
5107,2022-08-01 19:00:00,149,280,8,15,651,498,153,9
5108,2022-08-01 20:00:00,135,297,11,19,507,413,94,11
5109,2022-08-01 21:00:00,149,291,5,14,753,644,109,12
5110,2022-08-01 22:00:00,149,284,7,10,707,510,197,8
5111,2022-08-01 23:00:00,141,290,10,15,612,488,124,14
5112,2022-08-02 00:00:00,130,285,8,14,791,569,222,11
5113,2022-08-02 01:00:00,139,288,5,10,688,487,201,14
5114,2022-08-02 02:00:00,120,258,13,10,695,522,173,10
5115,2022-08-02 03:00:00,149,252,11,13,735,604,131,8
5116,2022-08-02 04:00:00,147,270,7,16,503,366,137,13
5117,2022-08-02 05:00:00,143,291,8,17,701,522,179,8
5118,2022-08-02 06:00:00,141,276,12,16,559,461,98,14
5119,2022-08-02 07:00:00,143,280,5,17,660,500,160,9
5120,2022-08-02 08:00:00,139,271,11,17,627,549,78,14
5121,2022-08-02 09:00:00,135,258,11,10,647,465,182,8
5122,2022-08-02 10:00:00,120,298,9,12,523,395,128,12
5123,2022-08-02 11:00:00,133,260,12,16,644,455,189,7
5124,2022-08-02 12:00:00,137,257,9,16,503,428,75,8
5125,2022-08-02 13:00:00,135,298,8,15,555,424,131,10
5126,2022-08-02 14:00:00,133,287,6,17,528,464,64,6
5127,2022-08-02 15:00:00,123,275,7,16,610,488,122,9
5128,2022-08-02 16:00:00,147,258,11,14,601,442,159,10
5129,2022-08-02 17:00:00,127,287,9,12,518,450,68,10
5130,2022-08-02 18:00:00,149,286,8,10,508,453,55,5
5131,2022-08-02 19:00:00,133,289,9,14,647,527,120,13
5132,2022-08-02 20:00:00,146,277,8,13,663,541,122,13
5133,2022-08-02 21:00:00,138,293,9,16,655,543,112,12
5134,2022-08-02 22:00:00,132,283,11,11,703,616,87,6
5135,2022-08-02 23:00:00,145,251,10,18,670,570,100,12
5136,2022-08-03 00:00:00,143,286,10,15,648,535,113,10
5137,2022-08-03 01:00:00,125,278,5,15,658,501,157,7
5138,2022-08-03 02:00:00,149,276,10,17,572,435,137,13
5139,2022-08-03 03:00:00,127,288,10,13,606,454,152,10
5140,2022-08-03 04:00:00,146,282,7,15,691,587,104,14
5141,2022-08-03 05:00:00,141,297,8,17,684,551,133,8
5142,2022-08-03 06:00:00,125,283,12,17,533,410,123,5
5143,2022-08-03 07:00:00,147,254,5,19,767,686,81,8
5144,2022-08-03 08:00:00,129,298,7,13,544,391,153,8
5145,2022-08-03 09:00:00,135,263,12,14,652,577,75,8
5146,2022-08-03 10:00:00,142,293,10,14,594,440,154,13
5147,2022-08-03 11:00:00,137,276,12,15,518,426,92,6
5148,2022-08-03 12:00:00,133,294,7,19,654,543,111,9
5149,2022-08-03 13:00:00,126,292,12,12,616,451,165,7
5150,2022-08-03 14:00:00,136,260,14,14,588,482,106,10
5151,2022-08-03 15:00:00,149,290,11,10,787,625,162,11
5152,2022-08-03 16:00:00,134,282,9,13,514,451,63,14
5153,2022-08-03 17:00:00,128,267,12,10,561,449,112,7
5154,2022-08-03 18:00:00,130,253,13,10,693,586,107,5
5155,2022-08-03 19:00:00,139,296,9,15,798,716,82,5
5156,2022-08-03 20:00:00,139,256,10,10,793,575,218,9
5157,2022-08-03 21:00:00,132,272,10,16,532,383,149,10
5158,2022-08-03 22:00:00,130,265,12,16,698,553,145,9
5159,2022-08-03 23:00:00,144,267,14,19,649,509,140,10
5160,2022-08-04 00:00:00,123,299,11,19,544,436,108,12
5161,2022-08-04 01:00:00,123,280,8,10,663,562,101,9
5162,2022-08-04 02:00:00,129,283,7,14,651,458,193,8
5163,2022-08-04 03:00:00,140,276,7,14,770,557,213,8
5164,2022-08-04 04:00:00,126,255,9,12,613,468,145,7
5165,2022-08-04 05:00:00,130,269,9,18,555,391,164,7
5166,2022-08-04 06:00:00,120,252,5,18,712,513,199,14
5167,2022-08-04 07:00:00,138,253,9,16,567,475,92,10
5168,2022-08-04 08:00:00,121,264,11,13,755,557,198,7
5169,2022-08-04 09:00:00,128,275,7,16,619,456,163,12
5170,2022-08-04 10:00:00,125,268,9,12,564,452,112,7
5171,2022-08-04 11:00:00,123,282,13,11,531,379,152,5
5172,2022-08-04 12:00:00,134,257,11,15,753,625,128,13
5173,2022-08-04 13:00:00,124,298,11,18,755,617,138,5
5174,2022-08-04 14:00:00,147,281,13,18,550,472,78,8
5175,2022-08-04 15:00:00,126,286,11,10,588,451,137,7
5176,2022-08-04 16:00:00,120,287,10,18,613,507,106,5
5177,2022-08-04 17:00:00,121,294,9,16,552,419,133,7
5178,2022-08-04 18:00:00,137,271,14,15,776,629,147,11
5179,2022-08-04 19:00:00,138,276,11,11,609,428,181,6
5180,2022-08-04 20:00:00,130,272,12,13,614,484,130,10
5181,2022-08-04 21:00:00,140,251,13,17,751,542,209,6
5182,2022-08-04 22:00:00,126,287,7,13,681,540,141,5
5183,2022-08-04 23:00:00,128,271,11,11,690,563,127,14
5184,2022-08-05 00:00:00,139,286,9,14,689,589,100,13
5185,2022-08-05 01:00:00,124,296,13,13,502,451,51,11
5186,2022-08-05 02:00:00,144,267,14,18,747,556,191,6
5187,2022-08-05 03:00:00,134,259,9,15,556,456,100,5
5188,2022-08-05 04:00:00,122,269,7,10,516,408,108,7
5189,2022-08-05 05:00:00,142,264,8,15,692,499,193,12
5190,2022-08-05 06:00:00,139,288,10,15,699,604,95,8
5191,2022-08-05 07:00:00,146,298,6,15,506,368,138,10
5192,2022-08-05 08:00:00,121,268,11,13,635,465,170,8
5193,2022-08-05 09:00:00,142,292,12,19,785,612,173,10
5194,2022-08-05 10:00:00,135,287,13,13,777,605,172,10
5195,2022-08-05 11:00:00,126,280,5,12,688,607,81,9
5196,2022-08-05 12:00:00,136,291,14,13,696,495,201,6
5197,2022-08-05 13:00:00,136,271,14,12,704,575,129,13
5198,2022-08-05 14:00:00,148,270,12,15,642,547,95,11
5199,2022-08-05 15:00:00,124,267,11,14,529,376,153,9
5200,2022-08-05 16:00:00,146,251,7,17,640,519,121,10
5201,2022-08-05 17:00:00,130,263,11,12,618,448,170,11
5202,2022-08-05 18:00:00,131,297,5,19,561,498,63,9
5203,2022-08-05 19:00:00,147,286,10,14,522,419,103,14
5204,2022-08-05 20:00:00,131,277,7,17,575,402,173,5
5205,2022-08-05 21:00:00,129,258,13,16,582,460,122,6
5206,2022-08-05 22:00:00,137,252,6,15,663,514,149,9
5207,2022-08-05 23:00:00,139,267,7,13,642,452,190,9
5208,2022-08-06 00:00:00,139,255,5,14,588,459,129,6
5209,2022-08-06 01:00:00,133,298,13,17,639,544,95,5
5210,2022-08-06 02:00:00,139,276,7,14,732,514,218,12
5211,2022-08-06 03:00:00,127,272,14,11,587,492,95,5
5212,2022-08-06 04:00:00,136,286,13,18,582,417,165,10
5213,2022-08-06 05:00:00,122,256,11,17,530,372,158,9
5214,2022-08-06 06:00:00,140,259,13,12,775,592,183,12
5215,2022-08-06 07:00:00,125,267,7,13,633,554,79,7
5216,2022-08-06 08:00:00,132,274,10,16,527,386,141,5
5217,2022-08-06 09:00:00,129,272,13,11,587,499,88,13
5218,2022-08-06 10:00:00,137,293,8,19,770,563,207,8
5219,2022-08-06 11:00:00,142,290,11,13,501,359,142,12
5220,2022-08-06 12:00:00,120,263,9,15,663,465,198,9
5221,2022-08-06 13:00:00,134,255,13,10,552,386,166,12
5222,2022-08-06 14:00:00,149,266,13,15,685,555,130,8
5223,2022-08-06 15:00:00,127,294,14,12,594,504,90,14
5224,2022-08-06 16:00:00,140,280,10,16,565,436,129,12
5225,2022-08-06 17:00:00,123,267,12,15,745,659,86,7
5226,2022-08-06 18:00:00,145,285,13,13,748,582,166,6
5227,2022-08-06 19:00:00,124,292,6,18,707,579,128,11
5228,2022-08-06 20:00:00,127,280,7,11,562,413,149,9
5229,2022-08-06 21:00:00,133,278,12,14,510,423,87,6
5230,2022-08-06 22:00:00,145,292,7,12,513,396,117,11
5231,2022-08-06 23:00:00,131,276,13,15,798,591,207,14
5232,2022-08-07 00:00:00,122,258,6,10,535,466,69,13
5233,2022-08-07 01:00:00,121,273,5,16,664,477,187,5
5234,2022-08-07 02:00:00,144,291,10,11,576,488,88,10
5235,2022-08-07 03:00:00,130,297,6,12,642,521,121,6
5236,2022-08-07 04:00:00,146,290,14,11,766,655,111,10
5237,2022-08-07 05:00:00,120,288,12,16,674,576,98,13
5238,2022-08-07 06:00:00,137,258,8,12,770,544,226,6
5239,2022-08-07 07:00:00,121,282,13,16,635,568,67,7
5240,2022-08-07 08:00:00,131,291,5,11,738,530,208,14
5241,2022-08-07 09:00:00,144,253,10,11,784,551,233,11
5242,2022-08-07 10:00:00,130,291,11,18,596,463,133,5
5243,2022-08-07 11:00:00,128,278,13,16,723,515,208,11
5244,2022-08-07 12:00:00,132,253,7,12,710,525,185,6
5245,2022-08-07 13:00:00,140,259,8,19,573,497,76,8
5246,2022-08-07 14:00:00,131,299,12,19,677,573,104,8
5247,2022-08-07 15:00:00,120,298,9,10,541,481,60,6
5248,2022-08-07 16:00:00,147,258,9,13,532,391,141,7
5249,2022-08-07 17:00:00,137,297,12,16,552,456,96,12
5250,2022-08-07 18:00:00,146,275,12,12,615,485,130,14
5251,2022-08-07 19:00:00,141,273,14,13,590,523,67,7
5252,2022-08-07 20:00:00,126,267,12,14,711,574,137,13
5253,2022-08-07 21:00:00,127,256,6,16,511,431,80,9
5254,2022-08-07 22:00:00,124,257,10,14,692,532,160,9
5255,2022-08-07 23:00:00,131,273,14,18,723,545,178,8
5256,2022-08-08 00:00:00,144,293,13,10,634,535,99,14
5257,2022-08-08 01:00:00,132,265,9,14,742,566,176,10
5258,2022-08-08 02:00:00,137,267,12,12,526,370,156,14
5259,2022-08-08 03:00:00,147,281,12,16,697,501,196,6
5260,2022-08-08 04:00:00,136,299,5,15,685,542,143,7
5261,2022-08-08 05:00:00,144,265,10,10,606,497,109,13
5262,2022-08-08 06:00:00,146,283,9,18,527,373,154,9
5263,2022-08-08 07:00:00,145,293,14,10,783,625,158,13
5264,2022-08-08 08:00:00,148,293,10,12,574,516,58,13
5265,2022-08-08 09:00:00,124,276,10,13,607,461,146,5
5266,2022-08-08 10:00:00,138,298,5,17,578,441,137,13
5267,2022-08-08 11:00:00,125,261,14,11,555,409,146,13
5268,2022-08-08 12:00:00,127,272,14,12,514,444,70,5
5269,2022-08-08 13:00:00,148,272,13,19,784,592,192,12
5270,2022-08-08 14:00:00,141,252,9,17,712,604,108,10
5271,2022-08-08 15:00:00,125,250,11,13,568,407,161,11
5272,2022-08-08 16:00:00,134,283,9,11,703,523,180,11
5273,2022-08-08 17:00:00,132,281,12,18,669,575,94,12
5274,2022-08-08 18:00:00,127,256,9,18,585,436,149,11
5275,2022-08-08 19:00:00,121,276,6,17,605,533,72,8
5276,2022-08-08 20:00:00,120,278,9,11,696,571,125,6
5277,2022-08-08 21:00:00,144,291,8,13,617,500,117,7
5278,2022-08-08 22:00:00,120,256,12,16,715,630,85,14
5279,2022-08-08 23:00:00,145,284,7,10,633,549,84,12
5280,2022-08-09 00:00:00,135,263,12,11,635,508,127,12
5281,2022-08-09 01:00:00,134,294,9,18,530,450,80,9
5282,2022-08-09 02:00:00,122,271,13,14,748,604,144,9
5283,2022-08-09 03:00:00,149,275,13,12,633,550,83,5
5284,2022-08-09 04:00:00,130,299,5,15,795,620,175,8
5285,2022-08-09 05:00:00,138,297,10,14,550,389,161,12
5286,2022-08-09 06:00:00,142,287,13,11,603,479,124,12
5287,2022-08-09 07:00:00,149,284,13,14,533,388,145,7
5288,2022-08-09 08:00:00,132,259,5,10,620,538,82,9
5289,2022-08-09 09:00:00,124,272,11,11,683,488,195,5
5290,2022-08-09 10:00:00,143,295,12,19,563,501,62,12
5291,2022-08-09 11:00:00,120,295,14,14,694,505,189,6
5292,2022-08-09 12:00:00,126,265,8,18,524,380,144,9
5293,2022-08-09 13:00:00,121,264,5,12,651,498,153,8
5294,2022-08-09 14:00:00,145,287,10,12,577,459,118,9
5295,2022-08-09 15:00:00,129,251,10,11,532,445,87,13
5296,2022-08-09 16:00:00,138,264,9,17,579,438,141,12
5297,2022-08-09 17:00:00,141,257,5,17,540,465,75,11
5298,2022-08-09 18:00:00,136,266,9,18,656,478,178,12
5299,2022-08-09 19:00:00,140,283,8,17,541,475,66,9
5300,2022-08-09 20:00:00,143,255,5,17,674,596,78,13
5301,2022-08-09 21:00:00,146,284,10,13,561,414,147,12
5302,2022-08-09 22:00:00,126,278,13,16,777,599,178,14
5303,2022-08-09 23:00:00,128,270,12,18,536,474,62,8
5304,2022-08-10 00:00:00,147,282,5,12,769,545,224,13
5305,2022-08-10 01:00:00,136,268,12,10,587,525,62,12
5306,2022-08-10 02:00:00,124,282,14,19,620,522,98,10
5307,2022-08-10 03:00:00,123,290,14,13,727,614,113,9
5308,2022-08-10 04:00:00,139,288,8,18,647,462,185,13
5309,2022-08-10 05:00:00,142,280,12,11,799,605,194,9
5310,2022-08-10 06:00:00,129,269,6,12,782,642,140,11
5311,2022-08-10 07:00:00,145,269,5,13,534,403,131,10
5312,2022-08-10 08:00:00,128,265,13,18,657,478,179,10
5313,2022-08-10 09:00:00,138,258,12,10,745,579,166,9
5314,2022-08-10 10:00:00,141,274,5,19,745,662,83,12
5315,2022-08-10 11:00:00,138,299,5,17,623,552,71,10
5316,2022-08-10 12:00:00,149,298,14,12,511,391,120,13
5317,2022-08-10 13:00:00,148,266,7,16,539,456,83,12
5318,2022-08-10 14:00:00,145,292,5,19,554,438,116,8
5319,2022-08-10 15:00:00,125,270,8,16,668,506,162,6
5320,2022-08-10 16:00:00,148,275,7,13,529,430,99,10
5321,2022-08-10 17:00:00,149,281,6,13,775,677,98,11
5322,2022-08-10 18:00:00,148,266,8,15,751,629,122,13
5323,2022-08-10 19:00:00,128,252,10,14,597,506,91,6
5324,2022-08-10 20:00:00,135,265,10,19,551,437,114,12
5325,2022-08-10 21:00:00,130,261,9,11,777,581,196,9
5326,2022-08-10 22:00:00,143,294,8,19,524,416,108,8
5327,2022-08-10 23:00:00,147,254,8,12,725,614,111,12
5328,2022-08-11 00:00:00,136,272,11,10,540,445,95,10
5329,2022-08-11 01:00:00,136,261,9,14,672,480,192,13
5330,2022-08-11 02:00:00,139,279,14,15,524,443,81,5
5331,2022-08-11 03:00:00,130,266,6,15,657,490,167,9
5332,2022-08-11 04:00:00,146,286,6,14,698,512,186,10
5333,2022-08-11 05:00:00,143,285,5,16,645,501,144,12
5334,2022-08-11 06:00:00,139,283,9,18,680,607,73,12
5335,2022-08-11 07:00:00,123,298,5,18,652,567,85,5
5336,2022-08-11 08:00:00,130,278,10,13,623,485,138,11
5337,2022-08-11 09:00:00,129,284,12,17,776,632,144,6
5338,2022-08-11 10:00:00,148,262,12,14,769,583,186,11
5339,2022-08-11 11:00:00,135,286,11,11,603,525,78,9
5340,2022-08-11 12:00:00,125,272,9,17,558,471,87,9
5341,2022-08-11 13:00:00,130,251,11,17,625,451,174,6
5342,2022-08-11 14:00:00,140,259,11,15,787,560,227,13
5343,2022-08-11 15:00:00,142,265,11,15,686,516,170,14
5344,2022-08-11 16:00:00,131,297,11,12,533,397,136,8
5345,2022-08-11 17:00:00,143,260,9,19,550,438,112,8
5346,2022-08-11 18:00:00,126,264,10,19,693,607,86,7
5347,2022-08-11 19:00:00,149,268,14,16,700,596,104,11
5348,2022-08-11 20:00:00,144,263,9,12,570,434,136,6
5349,2022-08-11 21:00:00,136,269,11,17,618,492,126,6
5350,2022-08-11 22:00:00,130,250,7,15,559,466,93,9
5351,2022-08-11 23:00:00,140,259,8,14,702,590,112,14
5352,2022-08-12 00:00:00,147,277,6,13,723,588,135,6
5353,2022-08-12 01:00:00,131,257,14,15,712,549,163,11
5354,2022-08-12 02:00:00,132,267,13,16,535,442,93,14
5355,2022-08-12 03:00:00,127,289,8,19,732,529,203,14
5356,2022-08-12 04:00:00,130,278,10,14,767,676,91,14
5357,2022-08-12 05:00:00,126,259,9,12,692,487,205,13
5358,2022-08-12 06:00:00,135,281,9,19,766,685,81,10
5359,2022-08-12 07:00:00,144,271,10,12,647,543,104,7
5360,2022-08-12 08:00:00,146,290,13,15,680,565,115,8
5361,2022-08-12 09:00:00,140,290,7,15,514,421,93,11
5362,2022-08-12 10:00:00,148,259,9,13,693,539,154,11
5363,2022-08-12 11:00:00,136,293,8,16,702,624,78,6
5364,2022-08-12 12:00:00,121,280,10,18,547,458,89,6
5365,2022-08-12 13:00:00,127,259,11,15,688,571,117,6
5366,2022-08-12 14:00:00,132,291,11,11,783,681,102,13
5367,2022-08-12 15:00:00,131,293,13,11,671,550,121,8
5368,2022-08-12 16:00:00,137,295,10,17,575,448,127,7
5369,2022-08-12 17:00:00,149,288,7,11,523,373,150,5
5370,2022-08-12 18:00:00,124,284,10,18,770,553,217,14
5371,2022-08-12 19:00:00,125,283,5,11,597,441,156,6
5372,2022-08-12 20:00:00,125,250,12,16,703,513,190,12
5373,2022-08-12 21:00:00,148,257,11,11,776,650,126,5
5374,2022-08-12 22:00:00,143,261,11,14,636,538,98,5
5375,2022-08-12 23:00:00,142,258,11,18,612,530,82,12
5376,2022-08-13 00:00:00,146,268,14,14,502,407,95,10
5377,2022-08-13 01:00:00,126,278,5,13,682,557,125,13
5378,2022-08-13 02:00:00,148,258,6,11,753,670,83,7
5379,2022-08-13 03:00:00,129,279,5,15,721,567,154,12
5380,2022-08-13 04:00:00,126,275,13,17,725,585,140,6
5381,2022-08-13 05:00:00,139,290,12,11,691,564,127,9
5382,2022-08-13 06:00:00,148,282,11,15,608,432,176,13
5383,2022-08-13 07:00:00,141,262,11,16,731,647,84,10
5384,2022-08-13 08:00:00,143,269,11,12,719,601,118,6
5385,2022-08-13 09:00:00,129,253,6,11,576,420,156,8
5386,2022-08-13 10:00:00,131,257,8,13,693,530,163,6
5387,2022-08-13 11:00:00,133,290,14,11,687,577,110,9
5388,2022-08-13 12:00:00,145,276,14,17,613,525,88,9
5389,2022-08-13 13:00:00,145,270,9,16,704,539,165,10
5390,2022-08-13 14:00:00,129,253,10,17,604,472,132,7
5391,2022-08-13 15:00:00,121,281,14,10,545,387,158,6
5392,2022-08-13 16:00:00,129,257,6,18,628,464,164,8
5393,2022-08-13 17:00:00,142,280,6,14,659,535,124,10
5394,2022-08-13 18:00:00,123,271,6,14,660,563,97,11
5395,2022-08-13 19:00:00,144,279,8,14,680,488,192,9
5396,2022-08-13 20:00:00,149,262,12,11,753,595,158,13
5397,2022-08-13 21:00:00,136,271,13,18,556,500,56,5
5398,2022-08-13 22:00:00,144,277,8,11,784,620,164,10
5399,2022-08-13 23:00:00,133,284,11,17,611,546,65,7
5400,2022-08-14 00:00:00,121,260,6,14,772,644,128,11
5401,2022-08-14 01:00:00,125,281,8,17,577,429,148,7
5402,2022-08-14 02:00:00,134,266,5,12,742,612,130,7
5403,2022-08-14 03:00:00,145,259,6,14,763,607,156,14
5404,2022-08-14 04:00:00,130,298,8,13,508,414,94,8
5405,2022-08-14 05:00:00,130,279,10,10,745,549,196,11
5406,2022-08-14 06:00:00,123,295,9,16,641,551,90,9
5407,2022-08-14 07:00:00,143,289,8,16,798,620,178,9
5408,2022-08-14 08:00:00,142,295,10,14,526,377,149,12
5409,2022-08-14 09:00:00,123,251,8,19,576,497,79,7
5410,2022-08-14 10:00:00,124,265,9,18,751,656,95,14
5411,2022-08-14 11:00:00,124,257,11,18,740,627,113,12
5412,2022-08-14 12:00:00,145,256,9,13,513,383,130,10
5413,2022-08-14 13:00:00,149,275,13,11,742,578,164,10
5414,2022-08-14 14:00:00,140,260,6,19,621,450,171,8
5415,2022-08-14 15:00:00,121,293,5,18,746,612,134,5
5416,2022-08-14 16:00:00,142,272,14,13,651,527,124,10
5417,2022-08-14 17:00:00,130,250,10,12,541,388,153,12
5418,2022-08-14 18:00:00,129,257,11,10,506,365,141,6
5419,2022-08-14 19:00:00,135,284,5,17,614,504,110,14
5420,2022-08-14 20:00:00,141,297,5,18,691,554,137,9
5421,2022-08-14 21:00:00,145,263,12,16,518,415,103,7
5422,2022-08-14 22:00:00,149,286,13,18,645,499,146,8
5423,2022-08-14 23:00:00,132,279,6,19,573,423,150,7
5424,2022-08-15 00:00:00,148,299,9,13,551,460,91,11
5425,2022-08-15 01:00:00,147,280,10,12,568,494,74,7
5426,2022-08-15 02:00:00,149,273,14,18,593,509,84,5
5427,2022-08-15 03:00:00,132,280,14,17,645,508,137,11
5428,2022-08-15 04:00:00,133,255,11,12,791,613,178,13
5429,2022-08-15 05:00:00,128,299,5,10,578,475,103,10
5430,2022-08-15 06:00:00,126,261,5,18,764,678,86,14
5431,2022-08-15 07:00:00,126,289,8,10,715,630,85,14
5432,2022-08-15 08:00:00,133,290,11,17,667,535,132,14
5433,2022-08-15 09:00:00,140,258,13,11,519,424,95,13
5434,2022-08-15 10:00:00,143,273,9,18,642,473,169,9
5435,2022-08-15 11:00:00,129,282,8,11,640,466,174,8
5436,2022-08-15 12:00:00,128,261,10,14,667,489,178,6
5437,2022-08-15 13:00:00,126,260,7,13,531,458,73,11
5438,2022-08-15 14:00:00,148,253,7,18,571,497,74,5
5439,2022-08-15 15:00:00,141,296,5,19,618,483,135,8
5440,2022-08-15 16:00:00,128,280,11,19,646,513,133,13
5441,2022-08-15 17:00:00,144,298,13,19,550,449,101,7
5442,2022-08-15 18:00:00,142,294,13,11,680,575,105,11
5443,2022-08-15 19:00:00,124,285,14,13,765,599,166,10
5444,2022-08-15 20:00:00,127,257,8,17,547,411,136,5
5445,2022-08-15 21:00:00,139,270,9,16,702,558,144,5
5446,2022-08-15 22:00:00,130,278,8,17,570,496,74,5
5447,2022-08-15 23:00:00,143,253,10,10,554,466,88,7
5448,2022-08-16 00:00:00,142,275,7,18,699,540,159,11
5449,2022-08-16 01:00:00,132,270,6,11,549,393,156,8
5450,2022-08-16 02:00:00,135,268,6,13,546,456,90,5
5451,2022-08-16 03:00:00,139,262,11,17,548,491,57,6
5452,2022-08-16 04:00:00,132,276,9,18,611,542,69,6
5453,2022-08-16 05:00:00,124,296,8,18,529,462,67,13
5454,2022-08-16 06:00:00,145,288,5,15,768,663,105,12
5455,2022-08-16 07:00:00,135,277,8,13,526,456,70,7
5456,2022-08-16 08:00:00,125,262,11,19,718,618,100,6
5457,2022-08-16 09:00:00,148,257,12,12,538,435,103,9
5458,2022-08-16 10:00:00,130,289,13,10,593,528,65,9
5459,2022-08-16 11:00:00,138,261,7,19,746,544,202,10
5460,2022-08-16 12:00:00,138,270,8,13,767,627,140,8
5461,2022-08-16 13:00:00,148,286,10,18,649,516,133,8
5462,2022-08-16 14:00:00,148,287,8,15,514,437,77,7
5463,2022-08-16 15:00:00,126,281,6,13,505,372,133,5
5464,2022-08-16 16:00:00,131,291,8,14,746,615,131,9
5465,2022-08-16 17:00:00,130,255,11,10,586,485,101,13
5466,2022-08-16 18:00:00,129,299,9,14,761,674,87,10
5467,2022-08-16 19:00:00,147,257,14,11,765,600,165,7
5468,2022-08-16 20:00:00,138,266,5,11,568,398,170,12
5469,2022-08-16 21:00:00,128,269,5,16,704,555,149,5
5470,2022-08-16 22:00:00,149,288,11,17,720,541,179,11
5471,2022-08-16 23:00:00,132,276,7,12,593,495,98,13
5472,2022-08-17 00:00:00,140,267,8,15,648,578,70,13
5473,2022-08-17 01:00:00,147,269,5,12,558,464,94,5
5474,2022-08-17 02:00:00,123,270,7,15,657,575,82,9
5475,2022-08-17 03:00:00,129,268,12,12,527,452,75,6
5476,2022-08-17 04:00:00,131,296,7,18,685,524,161,12
5477,2022-08-17 05:00:00,135,285,5,14,524,397,127,11
5478,2022-08-17 06:00:00,141,281,14,10,784,589,195,14
5479,2022-08-17 07:00:00,133,267,10,16,568,470,98,6
5480,2022-08-17 08:00:00,126,259,13,16,515,416,99,6
5481,2022-08-17 09:00:00,123,280,13,18,697,515,182,6
5482,2022-08-17 10:00:00,132,258,12,17,623,550,73,7
5483,2022-08-17 11:00:00,125,287,13,14,665,465,200,13
5484,2022-08-17 12:00:00,145,267,6,18,679,583,96,7
5485,2022-08-17 13:00:00,133,268,14,10,665,565,100,10
5486,2022-08-17 14:00:00,146,272,8,17,632,520,112,11
5487,2022-08-17 15:00:00,122,290,10,11,533,411,122,9
5488,2022-08-17 16:00:00,125,272,10,13,537,447,90,11
5489,2022-08-17 17:00:00,132,282,10,19,649,487,162,11
5490,2022-08-17 18:00:00,144,297,14,11,579,489,90,5
5491,2022-08-17 19:00:00,130,274,9,13,772,553,219,9
5492,2022-08-17 20:00:00,128,277,11,11,514,444,70,9
5493,2022-08-17 21:00:00,142,270,14,13,727,574,153,14
5494,2022-08-17 22:00:00,128,287,9,10,617,490,127,10
5495,2022-08-17 23:00:00,128,262,12,10,797,703,94,10
5496,2022-08-18 00:00:00,123,277,9,11,652,585,67,14
5497,2022-08-18 01:00:00,132,270,8,14,688,489,199,12
5498,2022-08-18 02:00:00,136,270,5,18,513,427,86,8
5499,2022-08-18 03:00:00,145,284,13,18,601,467,134,8
5500,2022-08-18 04:00:00,133,258,7,18,615,457,158,13
5501,2022-08-18 05:00:00,132,272,8,11,557,447,110,7
5502,2022-08-18 06:00:00,148,279,14,12,584,417,167,14
5503,2022-08-18 07:00:00,130,294,5,17,797,688,109,8
5504,2022-08-18 08:00:00,126,251,13,19,594,431,163,5
5505,2022-08-18 09:00:00,121,282,14,17,523,376,147,11
5506,2022-08-18 10:00:00,136,289,7,18,525,402,123,8
5507,2022-08-18 11:00:00,128,297,7,12,555,471,84,6
5508,2022-08-18 12:00:00,124,279,9,15,533,397,136,10
5509,2022-08-18 13:00:00,128,253,8,10,569,465,104,11
5510,2022-08-18 14:00:00,142,256,9,15,705,569,136,13
5511,2022-08-18 15:00:00,124,298,9,19,611,433,178,13
5512,2022-08-18 16:00:00,145,258,5,14,633,449,184,14
5513,2022-08-18 17:00:00,147,283,7,10,690,539,151,9
5514,2022-08-18 18:00:00,138,278,10,17,777,631,146,8
5515,2022-08-18 19:00:00,132,294,13,11,607,445,162,12
5516,2022-08-18 20:00:00,141,288,5,11,777,677,100,11
5517,2022-08-18 21:00:00,121,290,6,17,568,408,160,13
5518,2022-08-18 22:00:00,125,281,6,13,664,552,112,9
5519,2022-08-18 23:00:00,129,294,7,19,571,422,149,14
5520,2022-08-19 00:00:00,133,261,6,10,751,596,155,8
5521,2022-08-19 01:00:00,138,261,6,18,646,456,190,14
5522,2022-08-19 02:00:00,142,264,11,17,626,493,133,5
5523,2022-08-19 03:00:00,123,268,5,11,670,591,79,5
5524,2022-08-19 04:00:00,138,268,6,16,693,552,141,7
5525,2022-08-19 05:00:00,148,291,10,12,591,501,90,10
5526,2022-08-19 06:00:00,140,277,7,10,592,435,157,7
5527,2022-08-19 07:00:00,148,266,12,10,789,580,209,7
5528,2022-08-19 08:00:00,121,250,9,17,587,424,163,13
5529,2022-08-19 09:00:00,144,291,12,17,729,552,177,6
5530,2022-08-19 10:00:00,129,295,13,18,749,637,112,7
5531,2022-08-19 11:00:00,136,258,10,17,781,601,180,14
5532,2022-08-19 12:00:00,123,279,14,11,750,672,78,5
5533,2022-08-19 13:00:00,126,257,8,18,625,495,130,6
5534,2022-08-19 14:00:00,140,273,8,12,771,672,99,8
5535,2022-08-19 15:00:00,129,264,9,13,643,517,126,11
5536,2022-08-19 16:00:00,149,281,8,14,636,551,85,6
5537,2022-08-19 17:00:00,127,299,6,11,775,547,228,5
5538,2022-08-19 18:00:00,129,270,10,15,680,514,166,12
5539,2022-08-19 19:00:00,129,287,10,19,791,568,223,14
5540,2022-08-19 20:00:00,146,274,7,11,762,636,126,10
5541,2022-08-19 21:00:00,134,269,7,15,559,446,113,10
5542,2022-08-19 22:00:00,147,250,13,15,504,444,60,13
5543,2022-08-19 23:00:00,133,289,14,14,698,562,136,8
5544,2022-08-20 00:00:00,136,267,6,16,777,595,182,9
5545,2022-08-20 01:00:00,121,266,6,16,686,484,202,11
5546,2022-08-20 02:00:00,135,254,11,16,586,519,67,5
5547,2022-08-20 03:00:00,122,282,5,13,544,394,150,6
5548,2022-08-20 04:00:00,126,292,14,13,722,540,182,11
5549,2022-08-20 05:00:00,128,265,7,16,786,647,139,9
5550,2022-08-20 06:00:00,146,288,9,11,604,497,107,9
5551,2022-08-20 07:00:00,120,279,10,10,503,382,121,11
5552,2022-08-20 08:00:00,123,295,10,17,719,550,169,11
5553,2022-08-20 09:00:00,123,254,11,18,708,617,91,14
5554,2022-08-20 10:00:00,129,282,7,17,616,473,143,12
5555,2022-08-20 11:00:00,147,294,8,10,703,588,115,10
5556,2022-08-20 12:00:00,143,284,11,17,696,598,98,7
5557,2022-08-20 13:00:00,145,257,8,12,759,548,211,5
5558,2022-08-20 14:00:00,130,263,9,15,758,669,89,11
5559,2022-08-20 15:00:00,126,279,10,11,524,389,135,5
5560,2022-08-20 16:00:00,149,293,14,10,741,559,182,9
5561,2022-08-20 17:00:00,131,289,10,16,784,564,220,14
5562,2022-08-20 18:00:00,145,279,9,15,519,388,131,12
5563,2022-08-20 19:00:00,129,252,10,18,776,640,136,10
5564,2022-08-20 20:00:00,146,265,10,17,576,509,67,5
5565,2022-08-20 21:00:00,139,285,13,12,640,525,115,5
5566,2022-08-20 22:00:00,132,295,10,12,684,543,141,7
5567,2022-08-20 23:00:00,148,253,10,12,718,635,83,12
5568,2022-08-21 00:00:00,132,297,14,13,609,428,181,5
5569,2022-08-21 01:00:00,146,292,12,14,555,452,103,13
5570,2022-08-21 02:00:00,141,263,5,10,533,468,65,5
5571,2022-08-21 03:00:00,144,297,12,14,539,401,138,13
5572,2022-08-21 04:00:00,121,264,8,17,571,511,60,6
5573,2022-08-21 05:00:00,134,295,7,14,601,421,180,7
5574,2022-08-21 06:00:00,121,258,9,14,588,453,135,12
5575,2022-08-21 07:00:00,127,259,8,14,585,484,101,7
5576,2022-08-21 08:00:00,124,297,14,12,789,572,217,5
5577,2022-08-21 09:00:00,127,295,12,11,601,424,177,6
5578,2022-08-21 10:00:00,130,294,13,12,588,460,128,8
5579,2022-08-21 11:00:00,123,295,5,11,506,385,121,8
5580,2022-08-21 12:00:00,140,265,13,14,560,486,74,13
5581,2022-08-21 13:00:00,145,288,8,18,690,579,111,13
5582,2022-08-21 14:00:00,121,256,7,19,758,539,219,13
5583,2022-08-21 15:00:00,125,291,12,18,756,536,220,14
5584,2022-08-21 16:00:00,146,285,13,19,728,519,209,12
5585,2022-08-21 17:00:00,132,297,5,18,660,519,141,5
5586,2022-08-21 18:00:00,125,260,9,18,537,429,108,13
5587,2022-08-21 19:00:00,126,259,8,12,799,679,120,6
5588,2022-08-21 20:00:00,148,261,5,11,788,678,110,9
5589,2022-08-21 21:00:00,139,276,14,13,544,420,124,10
5590,2022-08-21 22:00:00,129,256,11,16,668,600,68,10
5591,2022-08-21 23:00:00,136,284,6,16,699,574,125,8
5592,2022-08-22 00:00:00,131,282,7,14,706,593,113,10
5593,2022-08-22 01:00:00,127,271,6,12,657,545,112,5
5594,2022-08-22 02:00:00,142,277,9,13,742,521,221,5
5595,2022-08-22 03:00:00,148,280,10,12,522,467,55,10
5596,2022-08-22 04:00:00,136,297,5,18,557,392,165,11
5597,2022-08-22 05:00:00,138,294,6,15,702,519,183,8
5598,2022-08-22 06:00:00,123,278,9,15,665,488,177,7
5599,2022-08-22 07:00:00,132,251,13,17,610,433,177,13
5600,2022-08-22 08:00:00,143,277,6,11,711,501,210,14
5601,2022-08-22 09:00:00,143,295,6,16,530,372,158,13
5602,2022-08-22 10:00:00,141,252,7,10,618,530,88,12
5603,2022-08-22 11:00:00,139,272,9,18,627,522,105,10
5604,2022-08-22 12:00:00,131,294,5,15,524,370,154,14
5605,2022-08-22 13:00:00,130,296,11,11,664,473,191,10
5606,2022-08-22 14:00:00,133,262,14,15,552,489,63,10
5607,2022-08-22 15:00:00,136,285,7,14,635,529,106,14
5608,2022-08-22 16:00:00,130,271,6,14,706,544,162,11
5609,2022-08-22 17:00:00,143,292,8,17,527,427,100,13
5610,2022-08-22 18:00:00,121,294,13,18,692,579,113,13
5611,2022-08-22 19:00:00,148,264,7,19,789,705,84,8
5612,2022-08-22 20:00:00,133,261,7,11,612,493,119,8
5613,2022-08-22 21:00:00,129,253,6,13,619,461,158,14
5614,2022-08-22 22:00:00,131,268,14,14,593,478,115,8
5615,2022-08-22 23:00:00,142,279,11,12,511,456,55,6
5616,2022-08-23 00:00:00,146,261,8,18,754,642,112,5
5617,2022-08-23 01:00:00,135,299,13,17,731,513,218,13
5618,2022-08-23 02:00:00,143,256,6,16,613,476,137,6
5619,2022-08-23 03:00:00,130,288,13,14,629,475,154,7
5620,2022-08-23 04:00:00,139,269,12,18,590,510,80,5
5621,2022-08-23 05:00:00,126,296,12,18,535,430,105,14
5622,2022-08-23 06:00:00,132,276,5,10,564,476,88,7
5623,2022-08-23 07:00:00,143,298,10,13,653,565,88,14
5624,2022-08-23 08:00:00,123,298,14,10,729,646,83,5
5625,2022-08-23 09:00:00,122,296,6,18,729,528,201,10
5626,2022-08-23 10:00:00,147,283,7,14,791,631,160,7
5627,2022-08-23 11:00:00,149,281,9,13,517,460,57,14
5628,2022-08-23 12:00:00,148,274,9,14,637,451,186,6
5629,2022-08-23 13:00:00,133,252,9,16,628,512,116,6
5630,2022-08-23 14:00:00,124,292,8,11,678,588,90,10
5631,2022-08-23 15:00:00,126,267,12,14,591,419,172,7
5632,2022-08-23 16:00:00,123,273,11,14,573,403,170,7
5633,2022-08-23 17:00:00,136,260,8,18,643,509,134,11
5634,2022-08-23 18:00:00,126,295,13,14,711,620,91,10
5635,2022-08-23 19:00:00,149,294,5,12,588,503,85,5
5636,2022-08-23 20:00:00,145,258,13,10,612,532,80,5
5637,2022-08-23 21:00:00,136,253,10,13,653,471,182,11
5638,2022-08-23 22:00:00,127,263,13,17,547,401,146,11
5639,2022-08-23 23:00:00,144,250,10,17,575,470,105,14
5640,2022-08-24 00:00:00,144,286,13,17,782,629,153,5
5641,2022-08-24 01:00:00,137,258,10,15,603,516,87,11
5642,2022-08-24 02:00:00,132,288,12,17,714,530,184,12
5643,2022-08-24 03:00:00,149,266,8,18,573,408,165,12
5644,2022-08-24 04:00:00,144,299,6,14,720,617,103,11
5645,2022-08-24 05:00:00,142,268,11,10,634,474,160,11
5646,2022-08-24 06:00:00,130,291,10,14,635,485,150,10
5647,2022-08-24 07:00:00,141,286,11,18,697,544,153,8
5648,2022-08-24 08:00:00,142,293,5,16,650,575,75,8
5649,2022-08-24 09:00:00,143,268,10,17,658,559,99,7
5650,2022-08-24 10:00:00,131,291,14,15,635,513,122,10
5651,2022-08-24 11:00:00,148,266,6,14,531,427,104,10
5652,2022-08-24 12:00:00,126,268,10,19,695,519,176,6
5653,2022-08-24 13:00:00,139,256,13,16,620,548,72,5
5654,2022-08-24 14:00:00,133,250,5,10,563,451,112,10
5655,2022-08-24 15:00:00,149,265,13,10,654,550,104,8
5656,2022-08-24 16:00:00,122,295,13,15,701,624,77,5
5657,2022-08-24 17:00:00,139,279,5,13,722,517,205,11
5658,2022-08-24 18:00:00,127,271,9,15,557,406,151,9
5659,2022-08-24 19:00:00,130,250,7,11,691,601,90,8
5660,2022-08-24 20:00:00,143,262,11,19,786,703,83,5
5661,2022-08-24 21:00:00,126,266,13,11,607,534,73,7
5662,2022-08-24 22:00:00,135,268,12,16,751,600,151,13
5663,2022-08-24 23:00:00,121,263,11,12,767,599,168,6
5664,2022-08-25 00:00:00,129,274,7,19,588,458,130,13
5665,2022-08-25 01:00:00,143,261,10,15,659,468,191,13
5666,2022-08-25 02:00:00,140,276,6,19,540,430,110,14
5667,2022-08-25 03:00:00,148,261,12,18,768,620,148,5
5668,2022-08-25 04:00:00,149,287,6,13,695,561,134,10
5669,2022-08-25 05:00:00,122,286,13,13,565,502,63,6
5670,2022-08-25 06:00:00,130,262,8,12,569,472,97,8
5671,2022-08-25 07:00:00,148,297,12,14,765,619,146,6
5672,2022-08-25 08:00:00,120,293,7,16,538,472,66,8
5673,2022-08-25 09:00:00,142,254,14,13,548,385,163,14
5674,2022-08-25 10:00:00,145,274,6,17,580,475,105,14
5675,2022-08-25 11:00:00,130,277,14,18,533,455,78,10
5676,2022-08-25 12:00:00,122,277,13,10,633,512,121,7
5677,2022-08-25 13:00:00,146,298,7,12,686,584,102,5
5678,2022-08-25 14:00:00,137,298,6,16,755,594,161,7
5679,2022-08-25 15:00:00,144,289,12,14,583,445,138,13
5680,2022-08-25 16:00:00,145,295,14,17,711,551,160,12
5681,2022-08-25 17:00:00,126,250,12,19,606,503,103,7
5682,2022-08-25 18:00:00,143,268,10,18,706,551,155,14
5683,2022-08-25 19:00:00,135,295,10,13,584,524,60,9
5684,2022-08-25 20:00:00,138,274,6,11,540,404,136,10
5685,2022-08-25 21:00:00,122,285,5,13,526,424,102,6
5686,2022-08-25 22:00:00,142,295,10,14,789,704,85,13
5687,2022-08-25 23:00:00,140,261,14,16,538,416,122,12
5688,2022-08-26 00:00:00,136,251,5,13,574,483,91,14
5689,2022-08-26 01:00:00,129,267,9,19,729,653,76,10
5690,2022-08-26 02:00:00,134,299,9,15,718,552,166,11
5691,2022-08-26 03:00:00,135,277,5,15,520,396,124,13
5692,2022-08-26 04:00:00,129,291,5,12,516,385,131,9
5693,2022-08-26 05:00:00,130,294,13,17,614,544,70,5
5694,2022-08-26 06:00:00,131,295,12,18,648,492,156,10
5695,2022-08-26 07:00:00,141,299,9,11,664,487,177,7
5696,2022-08-26 08:00:00,140,251,6,14,750,652,98,12
5697,2022-08-26 09:00:00,140,250,8,13,778,643,135,7
5698,2022-08-26 10:00:00,142,291,13,16,722,524,198,12
5699,2022-08-26 11:00:00,138,297,9,13,736,592,144,11
5700,2022-08-26 12:00:00,133,279,9,15,594,489,105,12
5701,2022-08-26 13:00:00,149,261,13,15,547,413,134,5
5702,2022-08-26 14:00:00,149,253,7,13,695,487,208,9
5703,2022-08-26 15:00:00,121,256,6,19,762,538,224,11
5704,2022-08-26 16:00:00,146,258,9,17,663,529,134,8
5705,2022-08-26 17:00:00,126,265,5,12,587,523,64,9
5706,2022-08-26 18:00:00,130,250,11,18,777,662,115,9
5707,2022-08-26 19:00:00,131,297,13,18,581,413,168,11
5708,2022-08-26 20:00:00,138,275,11,19,784,659,125,10
5709,2022-08-26 21:00:00,145,268,8,11,563,454,109,8
5710,2022-08-26 22:00:00,141,293,9,18,528,436,92,12
5711,2022-08-26 23:00:00,149,261,11,16,638,451,187,8
5712,2022-08-27 00:00:00,148,283,7,19,722,517,205,5
5713,2022-08-27 01:00:00,125,268,5,19,612,492,120,11
5714,2022-08-27 02:00:00,149,268,5,18,559,455,104,11
5715,2022-08-27 03:00:00,149,256,9,17,754,541,213,6
5716,2022-08-27 04:00:00,122,253,11,12,550,393,157,6
5717,2022-08-27 05:00:00,144,258,13,13,546,416,130,6
5718,2022-08-27 06:00:00,143,252,12,17,580,472,108,14
5719,2022-08-27 07:00:00,121,277,8,12,573,500,73,6
5720,2022-08-27 08:00:00,131,268,10,19,567,484,83,9
5721,2022-08-27 09:00:00,136,255,14,14,591,488,103,9
5722,2022-08-27 10:00:00,144,269,12,14,533,439,94,13
5723,2022-08-27 11:00:00,131,281,8,12,616,525,91,11
5724,2022-08-27 12:00:00,129,268,12,16,555,440,115,7
5725,2022-08-27 13:00:00,134,290,13,15,761,674,87,7
5726,2022-08-27 14:00:00,139,271,5,17,506,444,62,9
5727,2022-08-27 15:00:00,137,263,5,13,503,366,137,14
5728,2022-08-27 16:00:00,144,279,14,14,561,402,159,5
5729,2022-08-27 17:00:00,140,266,13,14,608,514,94,10
5730,2022-08-27 18:00:00,126,287,11,14,663,497,166,14
5731,2022-08-27 19:00:00,128,292,6,17,733,630,103,9
5732,2022-08-27 20:00:00,136,276,12,18,542,400,142,5
5733,2022-08-27 21:00:00,144,275,6,19,586,489,97,9
5734,2022-08-27 22:00:00,144,263,13,14,626,488,138,10
5735,2022-08-27 23:00:00,127,291,8,11,589,446,143,11
5736,2022-08-28 00:00:00,132,286,9,12,552,389,163,12
5737,2022-08-28 01:00:00,127,252,12,10,596,444,152,6
5738,2022-08-28 02:00:00,120,278,8,15,517,364,153,8
5739,2022-08-28 03:00:00,127,293,9,19,681,480,201,6
5740,2022-08-28 04:00:00,145,253,10,17,627,562,65,14
5741,2022-08-28 05:00:00,129,281,7,14,518,446,72,7
5742,2022-08-28 06:00:00,148,267,12,12,794,668,126,8
5743,2022-08-28 07:00:00,121,269,9,14,732,592,140,13
5744,2022-08-28 08:00:00,132,257,9,13,529,409,120,13
5745,2022-08-28 09:00:00,139,250,12,10,522,375,147,7
5746,2022-08-28 10:00:00,124,258,14,13,543,380,163,14
5747,2022-08-28 11:00:00,120,290,13,14,742,661,81,7
5748,2022-08-28 12:00:00,142,251,10,18,789,632,157,8
5749,2022-08-28 13:00:00,125,285,10,12,609,545,64,9
5750,2022-08-28 14:00:00,121,277,9,12,515,382,133,14
5751,2022-08-28 15:00:00,127,265,7,19,719,578,141,8
5752,2022-08-28 16:00:00,136,271,6,16,629,454,175,14
5753,2022-08-28 17:00:00,138,265,5,17,596,499,97,10
5754,2022-08-28 18:00:00,122,282,10,11,674,547,127,13
5755,2022-08-28 19:00:00,126,284,14,14,689,529,160,12
5756,2022-08-28 20:00:00,123,251,13,13,749,545,204,8
5757,2022-08-28 21:00:00,145,254,7,19,514,389,125,12
5758,2022-08-28 22:00:00,142,284,9,17,636,565,71,11
5759,2022-08-28 23:00:00,125,259,8,12,647,494,153,12
5760,2022-08-29 00:00:00,129,263,11,12,621,544,77,5
5761,2022-08-29 01:00:00,137,272,14,11,734,650,84,9
5762,2022-08-29 02:00:00,133,287,12,11,508,385,123,6
5763,2022-08-29 03:00:00,130,298,10,17,603,518,85,13
5764,2022-08-29 04:00:00,141,279,7,18,664,519,145,10
5765,2022-08-29 05:00:00,147,289,11,15,634,557,77,13
5766,2022-08-29 06:00:00,127,282,10,11,769,622,147,5
5767,2022-08-29 07:00:00,149,268,12,11,633,526,107,14
5768,2022-08-29 08:00:00,137,265,12,13,618,476,142,13
5769,2022-08-29 09:00:00,120,295,13,17,673,473,200,9
5770,2022-08-29 10:00:00,139,274,6,10,776,697,79,14
5771,2022-08-29 11:00:00,134,292,6,14,773,544,229,14
5772,2022-08-29 12:00:00,129,297,11,16,769,598,171,13
5773,2022-08-29 13:00:00,136,286,7,17,737,603,134,8
5774,2022-08-29 14:00:00,145,270,7,15,653,464,189,12
5775,2022-08-29 15:00:00,141,284,7,12,781,671,110,12
5776,2022-08-29 16:00:00,130,262,6,17,731,583,148,13
5777,2022-08-29 17:00:00,126,297,10,18,528,421,107,10
5778,2022-08-29 18:00:00,125,288,11,16,619,510,109,12
5779,2022-08-29 19:00:00,124,282,9,13,790,605,185,6
5780,2022-08-29 20:00:00,143,299,11,16,706,506,200,13
5781,2022-08-29 21:00:00,148,283,6,15,648,506,142,7
5782,2022-08-29 22:00:00,135,280,12,16,673,563,110,13
5783,2022-08-29 23:00:00,128,279,7,17,586,504,82,9
5784,2022-08-30 00:00:00,147,282,8,18,727,572,155,9
5785,2022-08-30 01:00:00,134,297,9,19,712,574,138,7
5786,2022-08-30 02:00:00,140,250,10,14,616,489,127,7
5787,2022-08-30 03:00:00,127,259,9,13,612,504,108,12
5788,2022-08-30 04:00:00,143,280,9,10,551,404,147,9
5789,2022-08-30 05:00:00,133,289,14,12,629,461,168,11
5790,2022-08-30 06:00:00,145,269,6,15,709,569,140,10
5791,2022-08-30 07:00:00,142,283,5,10,781,595,186,8
5792,2022-08-30 08:00:00,147,286,5,13,775,679,96,6
5793,2022-08-30 09:00:00,133,264,5,19,697,495,202,11
5794,2022-08-30 10:00:00,134,251,12,14,602,519,83,9
5795,2022-08-30 11:00:00,127,287,6,18,761,680,81,8
5796,2022-08-30 12:00:00,147,285,5,14,656,473,183,12
5797,2022-08-30 13:00:00,138,286,5,16,744,549,195,10
5798,2022-08-30 14:00:00,147,259,12,18,709,631,78,14
5799,2022-08-30 15:00:00,141,298,8,16,769,691,78,13
5800,2022-08-30 16:00:00,121,275,12,17,697,538,159,9
5801,2022-08-30 17:00:00,138,263,11,19,541,480,61,7
5802,2022-08-30 18:00:00,139,284,12,10,517,422,95,12
5803,2022-08-30 19:00:00,148,266,9,11,623,472,151,6
5804,2022-08-30 20:00:00,124,255,5,13,512,374,138,10
5805,2022-08-30 21:00:00,137,295,7,16,668,575,93,5
5806,2022-08-30 22:00:00,130,296,8,19,624,509,115,11
5807,2022-08-30 23:00:00,136,260,5,18,619,509,110,10
5808,2022-08-31 00:00:00,148,265,7,12,501,440,61,5
5809,2022-08-31 01:00:00,139,258,13,18,510,400,110,8
5810,2022-08-31 02:00:00,138,296,7,10,768,563,205,8
5811,2022-08-31 03:00:00,148,253,5,13,793,650,143,11
5812,2022-08-31 04:00:00,135,268,5,11,705,609,96,14
5813,2022-08-31 05:00:00,148,280,14,11,613,529,84,10
5814,2022-08-31 06:00:00,147,264,6,17,587,519,68,7
5815,2022-08-31 07:00:00,121,299,5,11,673,491,182,8
5816,2022-08-31 08:00:00,123,278,14,17,722,621,101,13
5817,2022-08-31 09:00:00,142,277,6,13,766,620,146,13
5818,2022-08-31 10:00:00,125,284,8,13,596,458,138,8
5819,2022-08-31 11:00:00,139,279,8,10,643,573,70,12
5820,2022-08-31 12:00:00,146,270,7,16,655,543,112,14
5821,2022-08-31 13:00:00,126,267,6,14,659,522,137,14
5822,2022-08-31 14:00:00,138,269,12,19,594,424,170,6
5823,2022-08-31 15:00:00,120,287,5,19,642,482,160,8
5824,2022-08-31 16:00:00,145,277,10,12,670,538,132,7
5825,2022-08-31 17:00:00,149,286,12,12,532,418,114,12
5826,2022-08-31 18:00:00,136,285,11,19,755,637,118,5
5827,2022-08-31 19:00:00,134,287,12,18,772,679,93,8
5828,2022-08-31 20:00:00,142,254,9,18,579,471,108,10
5829,2022-08-31 21:00:00,142,266,5,14,734,567,167,10
5830,2022-08-31 22:00:00,144,255,9,13,552,435,117,6
5831,2022-08-31 23:00:00,124,257,13,14,513,403,110,11
5832,2022-09-01 00:00:00,136,283,8,11,576,487,89,8
5833,2022-09-01 01:00:00,148,295,10,14,632,527,105,7
5834,2022-09-01 02:00:00,127,287,13,18,799,623,176,6
5835,2022-09-01 03:00:00,141,294,7,13,704,579,125,9
5836,2022-09-01 04:00:00,124,266,14,19,773,692,81,6
5837,2022-09-01 05:00:00,125,252,6,13,633,443,190,10
5838,2022-09-01 06:00:00,143,291,6,11,638,495,143,12
5839,2022-09-01 07:00:00,132,277,13,18,639,524,115,6
5840,2022-09-01 08:00:00,127,293,13,16,558,398,160,7
5841,2022-09-01 09:00:00,128,253,5,10,636,451,185,11
5842,2022-09-01 10:00:00,141,272,7,18,554,488,66,12
5843,2022-09-01 11:00:00,135,264,13,18,786,567,219,6
5844,2022-09-01 12:00:00,146,257,7,15,611,464,147,9
5845,2022-09-01 13:00:00,120,281,13,11,724,556,168,10
5846,2022-09-01 14:00:00,148,263,8,17,640,453,187,11
5847,2022-09-01 15:00:00,123,258,7,17,752,535,217,9
5848,2022-09-01 16:00:00,148,288,11,13,712,516,196,14
5849,2022-09-01 17:00:00,139,253,12,10,595,483,112,5
5850,2022-09-01 18:00:00,144,277,6,17,796,664,132,14
5851,2022-09-01 19:00:00,120,299,9,12,680,531,149,8
5852,2022-09-01 20:00:00,149,275,11,10,625,471,154,13
5853,2022-09-01 21:00:00,126,272,5,12,651,539,112,5
5854,2022-09-01 22:00:00,129,250,11,15,545,449,96,12
5855,2022-09-01 23:00:00,127,286,11,15,583,505,78,10
5856,2022-09-02 00:00:00,147,260,12,13,508,429,79,14
5857,2022-09-02 01:00:00,132,257,9,16,771,692,79,14
5858,2022-09-02 02:00:00,137,264,7,16,564,480,84,8
5859,2022-09-02 03:00:00,140,270,11,12,554,467,87,11
5860,2022-09-02 04:00:00,120,278,11,13,777,688,89,9
5861,2022-09-02 05:00:00,132,286,10,11,587,477,110,9
5862,2022-09-02 06:00:00,133,275,7,19,528,456,72,6
5863,2022-09-02 07:00:00,143,250,14,17,603,492,111,5
5864,2022-09-02 08:00:00,135,289,8,12,696,524,172,13
5865,2022-09-02 09:00:00,129,290,13,13,581,411,170,11
5866,2022-09-02 10:00:00,145,284,8,15,536,414,122,6
5867,2022-09-02 11:00:00,121,281,9,14,571,457,114,8
5868,2022-09-02 12:00:00,146,298,8,17,773,579,194,8
5869,2022-09-02 13:00:00,137,278,9,17,554,458,96,14
5870,2022-09-02 14:00:00,140,259,8,12,645,546,99,12
5871,2022-09-02 15:00:00,142,255,6,18,546,386,160,6
5872,2022-09-02 16:00:00,144,250,13,11,520,442,78,5
5873,2022-09-02 17:00:00,141,253,8,10,542,456,86,5
5874,2022-09-02 18:00:00,123,256,14,15,587,443,144,9
5875,2022-09-02 19:00:00,137,262,7,12,533,408,125,12
5876,2022-09-02 20:00:00,120,251,8,18,595,470,125,7
5877,2022-09-02 21:00:00,126,278,9,13,567,423,144,5
5878,2022-09-02 22:00:00,144,258,14,14,734,567,167,5
5879,2022-09-02 23:00:00,137,272,5,19,560,475,85,11
5880,2022-09-03 00:00:00,130,262,13,12,671,513,158,11
5881,2022-09-03 01:00:00,147,278,6,16,759,535,224,10
5882,2022-09-03 02:00:00,142,290,10,13,744,611,133,8
5883,2022-09-03 03:00:00,131,290,12,14,626,443,183,13
5884,2022-09-03 04:00:00,120,278,13,15,535,411,124,5
5885,2022-09-03 05:00:00,130,284,6,15,779,673,106,11
5886,2022-09-03 06:00:00,138,294,7,16,543,482,61,8
5887,2022-09-03 07:00:00,138,299,13,11,510,403,107,11
5888,2022-09-03 08:00:00,123,283,10,14,768,615,153,14
5889,2022-09-03 09:00:00,134,259,14,10,723,507,216,7
5890,2022-09-03 10:00:00,144,283,8,16,621,514,107,11
5891,2022-09-03 11:00:00,141,295,6,16,685,486,199,10
5892,2022-09-03 12:00:00,144,253,10,14,595,508,87,7
5893,2022-09-03 13:00:00,145,271,13,12,628,472,156,5
5894,2022-09-03 14:00:00,138,259,7,15,508,456,52,6
5895,2022-09-03 15:00:00,134,288,9,16,620,440,180,5
5896,2022-09-03 16:00:00,138,266,5,15,548,396,152,11
5897,2022-09-03 17:00:00,142,292,14,14,765,544,221,10
5898,2022-09-03 18:00:00,139,269,12,11,678,511,167,13
5899,2022-09-03 19:00:00,142,291,13,13,788,687,101,5
5900,2022-09-03 20:00:00,127,276,5,14,720,612,108,8
5901,2022-09-03 21:00:00,124,282,13,12,592,438,154,6
5902,2022-09-03 22:00:00,134,292,9,10,794,603,191,8
5903,2022-09-03 23:00:00,127,274,12,13,531,442,89,14
5904,2022-09-04 00:00:00,144,251,5,13,696,622,74,11
5905,2022-09-04 01:00:00,134,264,14,13,589,457,132,5
5906,2022-09-04 02:00:00,138,264,7,13,734,584,150,14
5907,2022-09-04 03:00:00,128,283,11,10,572,415,157,5
5908,2022-09-04 04:00:00,120,281,11,12,552,455,97,6
5909,2022-09-04 05:00:00,124,293,10,11,524,408,116,8
5910,2022-09-04 06:00:00,125,296,11,11,703,574,129,14
5911,2022-09-04 07:00:00,143,299,11,15,719,613,106,9
5912,2022-09-04 08:00:00,125,289,9,12,623,465,158,11
5913,2022-09-04 09:00:00,148,252,12,18,740,566,174,13
5914,2022-09-04 10:00:00,122,294,9,15,584,510,74,7
5915,2022-09-04 11:00:00,134,287,6,19,692,508,184,5
5916,2022-09-04 12:00:00,149,295,8,19,716,636,80,12
5917,2022-09-04 13:00:00,133,267,12,16,516,450,66,9
5918,2022-09-04 14:00:00,123,266,14,11,678,568,110,13
5919,2022-09-04 15:00:00,136,290,14,12,616,454,162,7
5920,2022-09-04 16:00:00,124,259,12,13,686,533,153,6
5921,2022-09-04 17:00:00,131,261,12,14,614,462,152,12
5922,2022-09-04 18:00:00,127,265,14,16,612,477,135,6
5923,2022-09-04 19:00:00,139,291,10,14,648,579,69,7
5924,2022-09-04 20:00:00,144,280,6,15,681,602,79,13
5925,2022-09-04 21:00:00,144,257,12,17,550,415,135,10
5926,2022-09-04 22:00:00,133,281,7,13,618,505,113,9
5927,2022-09-04 23:00:00,140,296,5,17,506,391,115,5
5928,2022-09-05 00:00:00,126,298,8,12,651,473,178,9
5929,2022-09-05 01:00:00,128,253,5,12,749,649,100,14
5930,2022-09-05 02:00:00,148,260,13,10,518,362,156,10
5931,2022-09-05 03:00:00,135,283,8,15,637,551,86,10
5932,2022-09-05 04:00:00,145,269,12,18,527,374,153,9
5933,2022-09-05 05:00:00,125,278,12,17,633,538,95,12
5934,2022-09-05 06:00:00,148,279,6,11,588,453,135,8
5935,2022-09-05 07:00:00,134,295,7,17,668,590,78,10
5936,2022-09-05 08:00:00,130,253,12,16,576,448,128,8
5937,2022-09-05 09:00:00,121,287,11,14,604,459,145,11
5938,2022-09-05 10:00:00,133,265,5,11,526,429,97,11
5939,2022-09-05 11:00:00,142,273,13,11,736,616,120,7
5940,2022-09-05 12:00:00,121,288,6,14,785,703,82,12
5941,2022-09-05 13:00:00,146,288,5,11,777,626,151,8
5942,2022-09-05 14:00:00,138,289,8,16,665,497,168,10
5943,2022-09-05 15:00:00,131,252,8,15,655,529,126,14
5944,2022-09-05 16:00:00,121,265,12,11,749,627,122,9
5945,2022-09-05 17:00:00,140,256,6,15,529,385,144,6
5946,2022-09-05 18:00:00,148,269,5,14,578,490,88,10
5947,2022-09-05 19:00:00,147,277,6,15,655,490,165,14
5948,2022-09-05 20:00:00,120,298,6,19,571,442,129,11
5949,2022-09-05 21:00:00,129,253,7,10,608,443,165,5
5950,2022-09-05 22:00:00,133,289,12,11,774,598,176,5
5951,2022-09-05 23:00:00,140,288,7,19,638,560,78,8
5952,2022-09-06 00:00:00,141,263,7,12,779,571,208,9
5953,2022-09-06 01:00:00,129,281,11,10,680,492,188,5
5954,2022-09-06 02:00:00,129,276,6,10,587,526,61,14
5955,2022-09-06 03:00:00,120,275,10,11,589,519,70,8
5956,2022-09-06 04:00:00,139,257,10,18,609,529,80,5
5957,2022-09-06 05:00:00,125,267,12,19,770,673,97,6
5958,2022-09-06 06:00:00,146,250,13,18,586,421,165,7
5959,2022-09-06 07:00:00,134,254,7,19,768,636,132,5
5960,2022-09-06 08:00:00,131,254,13,14,552,470,82,6
5961,2022-09-06 09:00:00,132,270,8,11,734,624,110,12
5962,2022-09-06 10:00:00,137,258,14,10,760,557,203,8
5963,2022-09-06 11:00:00,139,281,6,15,634,504,130,6
5964,2022-09-06 12:00:00,134,251,12,15,709,541,168,8
5965,2022-09-06 13:00:00,130,256,10,13,796,640,156,12
5966,2022-09-06 14:00:00,143,263,13,12,669,584,85,7
5967,2022-09-06 15:00:00,144,286,11,17,796,621,175,9
5968,2022-09-06 16:00:00,135,289,7,15,508,413,95,10
5969,2022-09-06 17:00:00,132,286,12,13,799,576,223,8
5970,2022-09-06 18:00:00,122,259,14,18,577,509,68,10
5971,2022-09-06 19:00:00,121,276,14,14,551,439,112,12
5972,2022-09-06 20:00:00,141,273,8,10,632,493,139,9
5973,2022-09-06 21:00:00,149,268,10,12,706,608,98,14
5974,2022-09-06 22:00:00,143,281,7,18,566,466,100,9
5975,2022-09-06 23:00:00,125,250,8,13,693,584,109,12
5976,2022-09-07 00:00:00,130,272,5,17,719,523,196,8
5977,2022-09-07 01:00:00,131,256,8,14,792,636,156,14
5978,2022-09-07 02:00:00,134,291,14,19,784,635,149,8
5979,2022-09-07 03:00:00,124,268,10,15,654,580,74,8
5980,2022-09-07 04:00:00,120,283,14,15,619,442,177,11
5981,2022-09-07 05:00:00,144,269,13,12,788,580,208,6
5982,2022-09-07 06:00:00,141,276,12,12,512,420,92,14
5983,2022-09-07 07:00:00,148,297,8,18,708,506,202,12
5984,2022-09-07 08:00:00,128,294,6,15,653,481,172,7
5985,2022-09-07 09:00:00,141,271,13,19,768,537,231,14
5986,2022-09-07 10:00:00,120,259,7,13,685,574,111,6
5987,2022-09-07 11:00:00,149,267,9,10,536,377,159,9
5988,2022-09-07 12:00:00,135,282,5,13,626,481,145,7
5989,2022-09-07 13:00:00,127,283,6,14,755,642,113,11
5990,2022-09-07 14:00:00,146,270,10,15,526,384,142,5
5991,2022-09-07 15:00:00,142,292,14,14,749,531,218,12
5992,2022-09-07 16:00:00,130,252,11,19,674,595,79,14
5993,2022-09-07 17:00:00,126,293,9,16,675,542,133,9
5994,2022-09-07 18:00:00,120,296,14,10,798,714,84,8
5995,2022-09-07 19:00:00,141,272,8,13,553,423,130,9
5996,2022-09-07 20:00:00,122,286,9,16,762,648,114,13
5997,2022-09-07 21:00:00,143,285,8,17,683,599,84,10
5998,2022-09-07 22:00:00,124,250,5,17,750,644,106,9
5999,2022-09-07 23:00:00,149,280,7,13,646,500,146,5
6000,2022-09-08 00:00:00,129,252,7,13,697,529,168,9
6001,2022-09-08 01:00:00,127,275,12,15,742,652,90,9
6002,2022-09-08 02:00:00,136,264,13,13,676,494,182,7
6003,2022-09-08 03:00:00,142,298,5,10,781,579,202,5
6004,2022-09-08 04:00:00,138,287,6,10,758,667,91,6
6005,2022-09-08 05:00:00,139,262,12,10,526,457,69,5
6006,2022-09-08 06:00:00,131,253,14,16,737,642,95,7
6007,2022-09-08 07:00:00,146,285,8,12,716,604,112,12
6008,2022-09-08 08:00:00,143,290,6,15,519,439,80,8
6009,2022-09-08 09:00:00,123,298,5,19,700,587,113,11
6010,2022-09-08 10:00:00,147,275,13,17,721,638,83,8
6011,2022-09-08 11:00:00,125,264,14,19,532,459,73,14
6012,2022-09-08 12:00:00,137,291,5,13,709,570,139,7
6013,2022-09-08 13:00:00,142,262,14,18,656,537,119,6
6014,2022-09-08 14:00:00,149,257,11,15,535,441,94,8
6015,2022-09-08 15:00:00,145,258,13,11,641,520,121,10
6016,2022-09-08 16:00:00,141,269,14,16,553,495,58,7
6017,2022-09-08 17:00:00,124,256,8,16,731,588,143,7
6018,2022-09-08 18:00:00,147,291,14,13,551,477,74,7
6019,2022-09-08 19:00:00,135,282,5,14,733,572,161,14
6020,2022-09-08 20:00:00,126,292,14,18,667,550,117,5
6021,2022-09-08 21:00:00,132,260,6,13,682,506,176,9
6022,2022-09-08 22:00:00,129,280,8,12,516,417,99,11
6023,2022-09-08 23:00:00,132,262,6,10,523,466,57,8
6024,2022-09-09 00:00:00,131,273,5,10,788,654,134,8
6025,2022-09-09 01:00:00,137,286,12,11,721,605,116,12
6026,2022-09-09 02:00:00,129,291,11,16,544,489,55,12
6027,2022-09-09 03:00:00,121,264,10,16,640,545,95,14
6028,2022-09-09 04:00:00,139,270,8,16,671,549,122,8
6029,2022-09-09 05:00:00,136,292,8,14,678,605,73,12
6030,2022-09-09 06:00:00,120,295,12,19,735,554,181,5
6031,2022-09-09 07:00:00,136,272,12,18,707,598,109,12
6032,2022-09-09 08:00:00,139,271,5,18,657,523,134,14
6033,2022-09-09 09:00:00,127,287,7,13,588,459,129,10
6034,2022-09-09 10:00:00,131,284,13,13,531,377,154,11
6035,2022-09-09 11:00:00,138,287,5,13,662,522,140,14
6036,2022-09-09 12:00:00,149,297,12,15,540,432,108,6
6037,2022-09-09 13:00:00,143,253,7,16,549,482,67,9
6038,2022-09-09 14:00:00,137,277,13,16,746,643,103,8
6039,2022-09-09 15:00:00,124,251,8,13,501,398,103,14
6040,2022-09-09 16:00:00,137,276,9,18,706,514,192,11
6041,2022-09-09 17:00:00,130,256,12,17,719,536,183,9
6042,2022-09-09 18:00:00,145,282,11,12,637,528,109,13
6043,2022-09-09 19:00:00,140,255,5,15,649,482,167,8
6044,2022-09-09 20:00:00,125,294,12,15,602,451,151,10
6045,2022-09-09 21:00:00,126,284,9,19,599,436,163,12
6046,2022-09-09 22:00:00,126,258,5,12,513,410,103,6
6047,2022-09-09 23:00:00,138,288,9,10,584,440,144,14
6048,2022-09-10 00:00:00,145,256,11,12,733,589,144,5
6049,2022-09-10 01:00:00,142,285,5,18,756,590,166,8
6050,2022-09-10 02:00:00,145,263,12,12,723,614,109,10
6051,2022-09-10 03:00:00,130,293,10,14,531,384,147,10
6052,2022-09-10 04:00:00,144,257,12,12,541,458,83,11
6053,2022-09-10 05:00:00,122,287,5,16,616,525,91,12
6054,2022-09-10 06:00:00,125,262,13,10,558,402,156,14
6055,2022-09-10 07:00:00,144,291,6,19,691,553,138,5
6056,2022-09-10 08:00:00,145,298,5,10,578,424,154,5
6057,2022-09-10 09:00:00,134,260,9,18,618,522,96,7
6058,2022-09-10 10:00:00,144,295,5,15,754,540,214,6
6059,2022-09-10 11:00:00,147,297,6,15,510,415,95,14
6060,2022-09-10 12:00:00,127,268,14,14,529,448,81,11
6061,2022-09-10 13:00:00,123,278,8,17,772,689,83,5
6062,2022-09-10 14:00:00,140,275,14,13,724,543,181,13
6063,2022-09-10 15:00:00,132,276,10,13,551,429,122,10
6064,2022-09-10 16:00:00,136,266,11,11,597,528,69,9
6065,2022-09-10 17:00:00,149,277,7,17,714,607,107,14
6066,2022-09-10 18:00:00,136,256,8,18,541,401,140,11
6067,2022-09-10 19:00:00,147,270,7,18,626,563,63,8
6068,2022-09-10 20:00:00,134,288,14,13,574,493,81,10
6069,2022-09-10 21:00:00,125,268,11,14,576,447,129,6
6070,2022-09-10 22:00:00,138,266,13,18,748,535,213,12
6071,2022-09-10 23:00:00,141,292,7,10,787,661,126,8
6072,2022-09-11 00:00:00,141,264,14,17,728,587,141,10
6073,2022-09-11 01:00:00,146,276,5,18,501,442,59,14
6074,2022-09-11 02:00:00,132,254,12,12,586,510,76,7
6075,2022-09-11 03:00:00,123,265,14,11,573,404,169,10
6076,2022-09-11 04:00:00,121,285,14,15,738,593,145,5
6077,2022-09-11 05:00:00,128,281,6,12,739,640,99,11
6078,2022-09-11 06:00:00,140,272,14,12,679,542,137,11
6079,2022-09-11 07:00:00,131,259,6,14,772,580,192,13
6080,2022-09-11 08:00:00,124,284,12,13,756,653,103,6
6081,2022-09-11 09:00:00,120,282,9,17,686,616,70,13
6082,2022-09-11 10:00:00,142,295,9,18,735,598,137,14
6083,2022-09-11 11:00:00,138,287,10,11,578,505,73,13
6084,2022-09-11 12:00:00,144,272,13,16,514,427,87,7
6085,2022-09-11 13:00:00,128,261,14,10,551,437,114,6
6086,2022-09-11 14:00:00,121,281,13,18,785,630,155,13
6087,2022-09-11 15:00:00,147,274,6,11,617,535,82,13
6088,2022-09-11 16:00:00,140,259,11,17,559,478,81,14
6089,2022-09-11 17:00:00,147,277,10,16,607,515,92,10
6090,2022-09-11 18:00:00,126,256,10,10,695,559,136,9
6091,2022-09-11 19:00:00,140,298,12,12,732,624,108,7
6092,2022-09-11 20:00:00,139,286,7,10,786,644,142,11
6093,2022-09-11 21:00:00,141,288,12,11,665,506,159,6
6094,2022-09-11 22:00:00,124,264,10,14,713,501,212,10
6095,2022-09-11 23:00:00,131,264,7,17,745,627,118,8
6096,2022-09-12 00:00:00,128,269,12,10,789,566,223,5
6097,2022-09-12 01:00:00,128,288,14,16,622,551,71,11
6098,2022-09-12 02:00:00,124,270,10,19,760,610,150,12
6099,2022-09-12 03:00:00,127,271,6,10,557,413,144,12
6100,2022-09-12 04:00:00,134,260,5,15,663,474,189,6
6101,2022-09-12 05:00:00,134,263,10,11,596,443,153,8
6102,2022-09-12 06:00:00,137,287,14,16,556,433,123,11
6103,2022-09-12 07:00:00,131,281,5,17,635,481,154,11
6104,2022-09-12 08:00:00,139,292,7,15,794,584,210,9
6105,2022-09-12 09:00:00,134,264,7,13,734,549,185,10
6106,2022-09-12 10:00:00,139,271,11,18,744,546,198,5
6107,2022-09-12 11:00:00,120,288,7,15,598,481,117,13
6108,2022-09-12 12:00:00,148,274,12,17,536,389,147,13
6109,2022-09-12 13:00:00,126,255,5,19,668,527,141,8
6110,2022-09-12 14:00:00,130,258,8,16,561,411,150,12
6111,2022-09-12 15:00:00,139,259,10,13,533,414,119,5
6112,2022-09-12 16:00:00,143,268,8,13,625,446,179,6
6113,2022-09-12 17:00:00,128,251,12,13,572,404,168,11
6114,2022-09-12 18:00:00,123,260,5,19,623,531,92,9
6115,2022-09-12 19:00:00,145,294,10,15,598,486,112,11
6116,2022-09-12 20:00:00,148,297,8,16,553,421,132,10
6117,2022-09-12 21:00:00,122,266,5,18,699,569,130,6
6118,2022-09-12 22:00:00,149,283,12,12,567,510,57,13
6119,2022-09-12 23:00:00,137,270,6,12,571,484,87,13
6120,2022-09-13 00:00:00,131,260,12,13,685,564,121,6
6121,2022-09-13 01:00:00,124,258,7,12,749,587,162,12
6122,2022-09-13 02:00:00,125,285,5,17,606,464,142,11
6123,2022-09-13 03:00:00,133,252,11,11,744,656,88,5
6124,2022-09-13 04:00:00,130,273,5,18,745,528,217,6
6125,2022-09-13 05:00:00,122,265,12,19,744,613,131,6
6126,2022-09-13 06:00:00,139,264,13,18,688,559,129,12
6127,2022-09-13 07:00:00,130,264,11,19,581,428,153,11
6128,2022-09-13 08:00:00,140,294,14,17,525,420,105,9
6129,2022-09-13 09:00:00,131,286,11,14,664,540,124,11
6130,2022-09-13 10:00:00,137,273,6,10,706,513,193,14
6131,2022-09-13 11:00:00,149,293,11,19,725,539,186,7
6132,2022-09-13 12:00:00,142,257,7,13,589,442,147,6
6133,2022-09-13 13:00:00,131,287,8,17,690,492,198,6
6134,2022-09-13 14:00:00,128,259,11,13,726,623,103,7
6135,2022-09-13 15:00:00,122,276,6,18,772,576,196,11
6136,2022-09-13 16:00:00,123,255,5,18,707,557,150,8
6137,2022-09-13 17:00:00,142,259,11,11,647,509,138,14
6138,2022-09-13 18:00:00,142,293,8,11,761,638,123,7
6139,2022-09-13 19:00:00,149,290,10,19,649,573,76,10
6140,2022-09-13 20:00:00,143,266,10,15,606,536,70,12
6141,2022-09-13 21:00:00,139,275,9,14,772,649,123,12
6142,2022-09-13 22:00:00,131,270,6,18,620,483,137,8
6143,2022-09-13 23:00:00,147,270,5,17,766,561,205,13
6144,2022-09-14 00:00:00,127,294,14,10,668,480,188,5
6145,2022-09-14 01:00:00,147,267,5,11,708,588,120,13
6146,2022-09-14 02:00:00,141,254,5,13,621,502,119,14
6147,2022-09-14 03:00:00,129,261,12,11,695,588,107,8
6148,2022-09-14 04:00:00,128,271,6,10,568,424,144,11
6149,2022-09-14 05:00:00,127,280,8,15,648,464,184,10
6150,2022-09-14 06:00:00,140,262,8,12,513,386,127,9
6151,2022-09-14 07:00:00,143,295,13,13,571,408,163,7
6152,2022-09-14 08:00:00,137,293,9,16,561,479,82,12
6153,2022-09-14 09:00:00,122,270,9,10,532,477,55,9
6154,2022-09-14 10:00:00,131,253,14,12,680,500,180,14
6155,2022-09-14 11:00:00,125,251,9,10,769,553,216,6
6156,2022-09-14 12:00:00,121,276,13,12,714,570,144,13
6157,2022-09-14 13:00:00,120,268,11,16,630,545,85,7
6158,2022-09-14 14:00:00,122,250,9,12,638,458,180,14
6159,2022-09-14 15:00:00,148,272,7,16,657,534,123,9
6160,2022-09-14 16:00:00,135,250,13,12,724,524,200,8
6161,2022-09-14 17:00:00,140,254,5,14,504,377,127,11
6162,2022-09-14 18:00:00,143,295,6,17,597,456,141,12
6163,2022-09-14 19:00:00,123,290,10,17,663,584,79,8
6164,2022-09-14 20:00:00,124,277,8,10,694,491,203,10
6165,2022-09-14 21:00:00,138,267,14,19,777,602,175,14
6166,2022-09-14 22:00:00,129,267,9,16,524,422,102,7
6167,2022-09-14 23:00:00,140,289,8,12,683,577,106,14
6168,2022-09-15 00:00:00,130,299,7,15,524,445,79,10
6169,2022-09-15 01:00:00,133,289,11,10,762,559,203,6
6170,2022-09-15 02:00:00,149,289,6,14,786,630,156,12
6171,2022-09-15 03:00:00,144,294,14,17,598,534,64,11
6172,2022-09-15 04:00:00,137,297,14,19,588,505,83,7
6173,2022-09-15 05:00:00,145,274,12,19,599,521,78,7
6174,2022-09-15 06:00:00,135,260,9,18,626,500,126,14
6175,2022-09-15 07:00:00,140,255,14,16,796,663,133,6
6176,2022-09-15 08:00:00,128,269,6,16,694,575,119,13
6177,2022-09-15 09:00:00,120,252,6,12,567,474,93,8
6178,2022-09-15 10:00:00,129,280,12,15,791,609,182,14
6179,2022-09-15 11:00:00,140,283,7,10,565,494,71,11
6180,2022-09-15 12:00:00,139,275,9,19,733,584,149,12
6181,2022-09-15 13:00:00,135,272,9,17,625,527,98,7
6182,2022-09-15 14:00:00,138,285,7,17,755,567,188,13
6183,2022-09-15 15:00:00,128,283,12,13,702,496,206,6
6184,2022-09-15 16:00:00,137,269,14,18,514,412,102,8
6185,2022-09-15 17:00:00,130,260,14,16,681,546,135,9
6186,2022-09-15 18:00:00,135,269,8,11,723,647,76,8
6187,2022-09-15 19:00:00,140,291,6,19,769,574,195,13
6188,2022-09-15 20:00:00,130,277,5,15,789,588,201,5
6189,2022-09-15 21:00:00,122,298,13,15,662,526,136,10
6190,2022-09-15 22:00:00,133,274,10,13,563,441,122,14
6191,2022-09-15 23:00:00,130,267,12,19,539,432,107,12
6192,2022-09-16 00:00:00,120,297,8,15,697,622,75,11
6193,2022-09-16 01:00:00,120,292,14,10,557,464,93,10
6194,2022-09-16 02:00:00,137,258,6,19,622,439,183,6
6195,2022-09-16 03:00:00,121,288,14,12,521,433,88,14
6196,2022-09-16 04:00:00,140,298,14,17,711,588,123,14
6197,2022-09-16 05:00:00,141,261,14,14,525,463,62,9
6198,2022-09-16 06:00:00,148,283,10,14,793,593,200,8
6199,2022-09-16 07:00:00,127,254,7,12,726,639,87,8
6200,2022-09-16 08:00:00,131,280,8,16,586,473,113,6
6201,2022-09-16 09:00:00,120,291,5,14,623,463,160,9
6202,2022-09-16 10:00:00,120,261,9,12,633,461,172,12
6203,2022-09-16 11:00:00,133,261,7,13,621,503,118,8
6204,2022-09-16 12:00:00,129,289,7,10,737,524,213,13
6205,2022-09-16 13:00:00,125,259,10,14,531,374,157,14
6206,2022-09-16 14:00:00,136,274,13,10,693,527,166,11
6207,2022-09-16 15:00:00,124,275,14,17,707,572,135,6
6208,2022-09-16 16:00:00,131,262,13,18,640,494,146,14
6209,2022-09-16 17:00:00,143,294,10,10,624,520,104,12
6210,2022-09-16 18:00:00,124,279,13,16,670,506,164,10
6211,2022-09-16 19:00:00,134,294,10,16,751,614,137,14
6212,2022-09-16 20:00:00,144,280,8,18,502,425,77,8
6213,2022-09-16 21:00:00,126,290,12,14,557,438,119,13
6214,2022-09-16 22:00:00,135,275,14,15,654,568,86,14
6215,2022-09-16 23:00:00,128,251,7,14,736,656,80,8
6216,2022-09-17 00:00:00,142,285,9,17,647,533,114,12
6217,2022-09-17 01:00:00,138,284,14,11,501,377,124,6
6218,2022-09-17 02:00:00,130,294,11,14,694,605,89,5
6219,2022-09-17 03:00:00,140,290,7,10,686,521,165,6
6220,2022-09-17 04:00:00,125,297,6,17,560,435,125,13
6221,2022-09-17 05:00:00,135,279,10,18,769,625,144,7
6222,2022-09-17 06:00:00,146,289,14,14,611,486,125,9
6223,2022-09-17 07:00:00,137,267,12,10,597,493,104,9
6224,2022-09-17 08:00:00,123,250,9,10,632,499,133,8
6225,2022-09-17 09:00:00,132,291,11,18,571,474,97,14
6226,2022-09-17 10:00:00,148,273,7,18,662,478,184,11
6227,2022-09-17 11:00:00,148,256,8,10,749,563,186,12
6228,2022-09-17 12:00:00,123,251,11,15,688,590,98,12
6229,2022-09-17 13:00:00,122,261,9,16,641,527,114,10
6230,2022-09-17 14:00:00,139,280,10,15,574,436,138,11
6231,2022-09-17 15:00:00,147,285,6,12,793,615,178,11
6232,2022-09-17 16:00:00,129,284,8,15,501,413,88,11
6233,2022-09-17 17:00:00,132,260,6,11,634,510,124,8
6234,2022-09-17 18:00:00,134,276,6,16,554,463,91,10
6235,2022-09-17 19:00:00,135,268,9,19,690,518,172,14
6236,2022-09-17 20:00:00,139,277,8,12,788,603,185,10
6237,2022-09-17 21:00:00,121,281,9,15,570,482,88,8
6238,2022-09-17 22:00:00,137,274,14,16,577,425,152,7
6239,2022-09-17 23:00:00,147,256,5,13,694,546,148,11
6240,2022-09-18 00:00:00,122,293,12,17,775,582,193,10
6241,2022-09-18 01:00:00,122,285,9,11,790,650,140,10
6242,2022-09-18 02:00:00,133,280,10,12,504,414,90,9
6243,2022-09-18 03:00:00,121,252,14,12,530,420,110,11
6244,2022-09-18 04:00:00,121,255,14,17,505,364,141,13
6245,2022-09-18 05:00:00,128,276,5,11,697,509,188,5
6246,2022-09-18 06:00:00,148,281,14,16,648,577,71,12
6247,2022-09-18 07:00:00,129,261,6,16,774,650,124,9
6248,2022-09-18 08:00:00,147,296,9,11,721,590,131,13
6249,2022-09-18 09:00:00,126,296,12,13,758,551,207,6
6250,2022-09-18 10:00:00,123,255,11,13,611,448,163,9
6251,2022-09-18 11:00:00,121,258,14,18,529,473,56,11
6252,2022-09-18 12:00:00,141,259,14,17,687,558,129,13
6253,2022-09-18 13:00:00,132,283,14,17,619,439,180,11
6254,2022-09-18 14:00:00,144,268,10,10,657,489,168,13
6255,2022-09-18 15:00:00,122,288,7,12,700,570,130,11
6256,2022-09-18 16:00:00,128,279,11,13,695,597,98,6
6257,2022-09-18 17:00:00,140,284,12,10,558,484,74,5
6258,2022-09-18 18:00:00,147,269,14,16,525,463,62,6
6259,2022-09-18 19:00:00,124,267,9,18,759,660,99,10
6260,2022-09-18 20:00:00,124,258,9,12,622,446,176,11
6261,2022-09-18 21:00:00,136,262,6,11,501,373,128,13
6262,2022-09-18 22:00:00,139,271,12,11,733,600,133,5
6263,2022-09-18 23:00:00,142,263,6,11,621,466,155,7
6264,2022-09-19 00:00:00,130,282,14,19,782,582,200,7
6265,2022-09-19 01:00:00,126,258,12,15,569,441,128,11
6266,2022-09-19 02:00:00,139,289,14,11,743,546,197,8
6267,2022-09-19 03:00:00,138,261,6,15,595,522,73,5
6268,2022-09-19 04:00:00,122,294,11,10,760,588,172,8
6269,2022-09-19 05:00:00,129,288,8,10,561,420,141,11
6270,2022-09-19 06:00:00,123,279,7,13,549,414,135,14
6271,2022-09-19 07:00:00,123,288,6,16,750,537,213,11
6272,2022-09-19 08:00:00,139,275,14,18,540,391,149,10
6273,2022-09-19 09:00:00,145,293,9,17,543,442,101,12
6274,2022-09-19 10:00:00,129,251,6,10,686,526,160,6
6275,2022-09-19 11:00:00,123,251,14,19,704,558,146,7
6276,2022-09-19 12:00:00,121,292,14,19,778,572,206,14
6277,2022-09-19 13:00:00,127,276,6,19,750,569,181,13
6278,2022-09-19 14:00:00,126,251,6,13,685,569,116,12
6279,2022-09-19 15:00:00,142,280,14,16,712,551,161,12
6280,2022-09-19 16:00:00,140,297,12,10,638,558,80,5
6281,2022-09-19 17:00:00,120,284,13,14,506,405,101,9
6282,2022-09-19 18:00:00,124,268,7,11,504,354,150,14
6283,2022-09-19 19:00:00,122,275,6,16,537,472,65,14
6284,2022-09-19 20:00:00,137,269,8,11,542,475,67,7
6285,2022-09-19 21:00:00,139,275,12,14,689,607,82,5
6286,2022-09-19 22:00:00,145,296,9,19,704,597,107,8
6287,2022-09-19 23:00:00,133,290,7,11,514,432,82,13
6288,2022-09-20 00:00:00,127,298,11,12,797,676,121,10
6289,2022-09-20 01:00:00,131,284,12,11,516,408,108,5
6290,2022-09-20 02:00:00,124,254,13,19,654,543,111,12
6291,2022-09-20 03:00:00,148,262,14,10,723,618,105,5
6292,2022-09-20 04:00:00,133,291,12,18,624,498,126,7
6293,2022-09-20 05:00:00,134,297,14,16,576,498,78,5
6294,2022-09-20 06:00:00,141,252,13,15,658,578,80,5
6295,2022-09-20 07:00:00,145,275,9,14,561,417,144,7
6296,2022-09-20 08:00:00,137,272,6,18,703,608,95,10
6297,2022-09-20 09:00:00,134,272,7,10,736,658,78,11
6298,2022-09-20 10:00:00,146,262,10,17,672,489,183,8
6299,2022-09-20 11:00:00,123,291,10,15,540,424,116,9
6300,2022-09-20 12:00:00,149,284,10,18,669,584,85,9
6301,2022-09-20 13:00:00,128,271,11,13,767,660,107,12
6302,2022-09-20 14:00:00,141,296,14,15,543,410,133,5
6303,2022-09-20 15:00:00,124,256,9,13,610,465,145,5
6304,2022-09-20 16:00:00,147,252,6,18,559,395,164,8
6305,2022-09-20 17:00:00,146,295,13,19,611,522,89,14
6306,2022-09-20 18:00:00,126,270,9,10,665,559,106,8
6307,2022-09-20 19:00:00,126,262,10,18,550,425,125,8
6308,2022-09-20 20:00:00,130,256,14,14,631,478,153,14
6309,2022-09-20 21:00:00,128,253,13,19,775,603,172,11
6310,2022-09-20 22:00:00,139,296,11,14,551,489,62,5
6311,2022-09-20 23:00:00,121,252,12,18,781,605,176,7
6312,2022-09-21 00:00:00,149,274,12,19,654,534,120,14
6313,2022-09-21 01:00:00,140,285,13,14,522,382,140,9
6314,2022-09-21 02:00:00,125,261,14,15,526,442,84,13
6315,2022-09-21 03:00:00,135,266,8,17,506,418,88,9
6316,2022-09-21 04:00:00,144,279,7,18,795,687,108,6
6317,2022-09-21 05:00:00,145,274,5,16,593,450,143,6
6318,2022-09-21 06:00:00,143,282,13,18,785,660,125,12
6319,2022-09-21 07:00:00,132,285,9,19,713,584,129,7
6320,2022-09-21 08:00:00,133,281,8,11,613,548,65,8
6321,2022-09-21 09:00:00,136,273,9,12,530,422,108,6
6322,2022-09-21 10:00:00,134,271,6,12,556,401,155,8
6323,2022-09-21 11:00:00,141,284,12,19,638,549,89,7
6324,2022-09-21 12:00:00,124,280,5,16,614,449,165,7
6325,2022-09-21 13:00:00,143,259,9,16,756,554,202,12
6326,2022-09-21 14:00:00,145,272,13,15,571,466,105,7
6327,2022-09-21 15:00:00,120,275,6,17,653,498,155,6
6328,2022-09-21 16:00:00,126,258,5,19,764,589,175,12
6329,2022-09-21 17:00:00,148,273,13,11,720,565,155,5
6330,2022-09-21 18:00:00,133,254,9,18,574,495,79,10
6331,2022-09-21 19:00:00,130,269,9,13,742,570,172,7
6332,2022-09-21 20:00:00,142,279,5,15,620,532,88,6
6333,2022-09-21 21:00:00,148,283,9,12,560,468,92,5
6334,2022-09-21 22:00:00,132,284,12,10,709,540,169,8
6335,2022-09-21 23:00:00,127,282,7,11,514,368,146,9
6336,2022-09-22 00:00:00,132,273,13,12,760,651,109,13
6337,2022-09-22 01:00:00,123,291,12,15,763,674,89,13
6338,2022-09-22 02:00:00,140,297,8,12,627,471,156,11
6339,2022-09-22 03:00:00,137,299,6,12,521,412,109,14
6340,2022-09-22 04:00:00,143,288,9,17,649,476,173,12
6341,2022-09-22 05:00:00,139,261,12,11,641,468,173,13
6342,2022-09-22 06:00:00,138,294,14,11,788,570,218,9
6343,2022-09-22 07:00:00,140,296,9,17,527,427,100,6
6344,2022-09-22 08:00:00,124,293,11,17,658,518,140,9
6345,2022-09-22 09:00:00,121,298,5,18,540,414,126,6
6346,2022-09-22 10:00:00,141,299,6,14,726,640,86,12
6347,2022-09-22 11:00:00,136,260,14,11,775,603,172,11
6348,2022-09-22 12:00:00,146,267,10,14,529,432,97,11
6349,2022-09-22 13:00:00,147,265,5,11,538,390,148,7
6350,2022-09-22 14:00:00,139,250,12,13,666,527,139,13
6351,2022-09-22 15:00:00,147,294,11,18,740,648,92,9
6352,2022-09-22 16:00:00,129,250,14,18,712,627,85,13
6353,2022-09-22 17:00:00,121,287,8,10,572,478,94,11
6354,2022-09-22 18:00:00,130,252,12,15,553,392,161,11
6355,2022-09-22 19:00:00,121,263,9,13,507,430,77,5
6356,2022-09-22 20:00:00,140,276,5,14,527,449,78,10
6357,2022-09-22 21:00:00,141,281,8,16,587,479,108,8
6358,2022-09-22 22:00:00,146,266,10,13,516,405,111,6
6359,2022-09-22 23:00:00,125,279,6,18,552,428,124,6
6360,2022-09-23 00:00:00,123,297,9,19,542,467,75,5
6361,2022-09-23 01:00:00,135,283,11,12,641,491,150,5
6362,2022-09-23 02:00:00,148,277,9,13,605,452,153,13
6363,2022-09-23 03:00:00,141,251,7,11,642,572,70,14
6364,2022-09-23 04:00:00,130,262,8,14,792,597,195,5
6365,2022-09-23 05:00:00,141,298,5,13,763,666,97,12
6366,2022-09-23 06:00:00,141,286,5,13,745,528,217,12
6367,2022-09-23 07:00:00,120,251,11,14,617,547,70,11
6368,2022-09-23 08:00:00,139,278,10,17,626,540,86,7
6369,2022-09-23 09:00:00,132,281,12,15,757,591,166,10
6370,2022-09-23 10:00:00,135,253,9,13,551,389,162,12
6371,2022-09-23 11:00:00,148,262,7,15,702,504,198,12
6372,2022-09-23 12:00:00,136,286,11,13,703,612,91,11
6373,2022-09-23 13:00:00,133,268,6,18,649,486,163,6
6374,2022-09-23 14:00:00,131,263,10,18,586,448,138,7
6375,2022-09-23 15:00:00,148,250,10,14,694,512,182,11
6376,2022-09-23 16:00:00,129,287,12,17,788,572,216,10
6377,2022-09-23 17:00:00,129,267,8,15,585,483,102,5
6378,2022-09-23 18:00:00,143,251,12,12,531,412,119,12
6379,2022-09-23 19:00:00,127,275,10,15,614,463,151,14
6380,2022-09-23 20:00:00,127,253,5,16,567,466,101,10
6381,2022-09-23 21:00:00,149,260,12,12,789,700,89,8
6382,2022-09-23 22:00:00,129,258,13,13,652,529,123,14
6383,2022-09-23 23:00:00,125,287,5,13,610,443,167,8
6384,2022-09-24 00:00:00,129,291,6,10,717,616,101,8
6385,2022-09-24 01:00:00,126,293,14,12,689,574,115,10
6386,2022-09-24 02:00:00,141,278,6,18,715,539,176,11
6387,2022-09-24 03:00:00,133,255,10,18,767,603,164,8
6388,2022-09-24 04:00:00,133,299,7,14,607,454,153,7
6389,2022-09-24 05:00:00,148,296,11,10,651,493,158,12
6390,2022-09-24 06:00:00,139,295,8,17,650,490,160,6
6391,2022-09-24 07:00:00,149,250,10,11,530,432,98,13
6392,2022-09-24 08:00:00,135,269,8,10,532,462,70,7
6393,2022-09-24 09:00:00,145,299,8,17,714,575,139,7
6394,2022-09-24 10:00:00,132,269,7,16,654,549,105,11
6395,2022-09-24 11:00:00,148,261,10,17,708,607,101,9
6396,2022-09-24 12:00:00,128,275,7,16,631,549,82,11
6397,2022-09-24 13:00:00,128,292,12,16,795,691,104,7
6398,2022-09-24 14:00:00,136,298,5,18,589,453,136,12
6399,2022-09-24 15:00:00,142,296,6,17,703,551,152,9
6400,2022-09-24 16:00:00,127,258,11,14,583,502,81,13
6401,2022-09-24 17:00:00,144,298,12,14,622,558,64,5
6402,2022-09-24 18:00:00,132,280,9,15,733,628,105,14
6403,2022-09-24 19:00:00,144,298,5,16,633,511,122,14
6404,2022-09-24 20:00:00,135,268,6,16,794,655,139,9
6405,2022-09-24 21:00:00,122,298,12,17,587,524,63,6
6406,2022-09-24 22:00:00,134,292,13,19,676,583,93,9
6407,2022-09-24 23:00:00,124,253,12,15,623,553,70,6
6408,2022-09-25 00:00:00,145,277,14,16,597,502,95,12
6409,2022-09-25 01:00:00,129,267,10,11,551,397,154,5
6410,2022-09-25 02:00:00,125,250,13,16,795,659,136,10
6411,2022-09-25 03:00:00,124,270,10,17,534,480,54,12
6412,2022-09-25 04:00:00,126,291,9,18,519,381,138,8
6413,2022-09-25 05:00:00,148,294,8,19,788,575,213,5
6414,2022-09-25 06:00:00,137,267,9,12,597,466,131,14
6415,2022-09-25 07:00:00,145,276,8,11,511,432,79,12
6416,2022-09-25 08:00:00,139,298,14,19,630,566,64,5
6417,2022-09-25 09:00:00,137,254,6,12,678,601,77,11
6418,2022-09-25 10:00:00,129,254,14,12,568,435,133,8
6419,2022-09-25 11:00:00,121,278,11,17,556,473,83,12
6420,2022-09-25 12:00:00,125,253,14,15,734,593,141,10
6421,2022-09-25 13:00:00,140,293,5,10,573,491,82,8
6422,2022-09-25 14:00:00,127,290,5,17,771,621,150,11
6423,2022-09-25 15:00:00,148,294,14,11,672,483,189,8
6424,2022-09-25 16:00:00,126,265,5,17,684,505,179,14
6425,2022-09-25 17:00:00,134,289,8,18,513,443,70,12
6426,2022-09-25 18:00:00,146,271,5,11,784,569,215,12
6427,2022-09-25 19:00:00,132,298,6,16,694,604,90,14
6428,2022-09-25 20:00:00,125,289,13,15,635,475,160,14
6429,2022-09-25 21:00:00,121,288,8,15,519,370,149,11
6430,2022-09-25 22:00:00,134,286,10,19,619,521,98,5
6431,2022-09-25 23:00:00,143,292,13,13,606,496,110,10
6432,2022-09-26 00:00:00,133,284,9,11,568,486,82,13
6433,2022-09-26 01:00:00,140,282,8,10,748,605,143,5
6434,2022-09-26 02:00:00,129,271,7,15,729,533,196,7
6435,2022-09-26 03:00:00,136,286,11,18,522,400,122,6
6436,2022-09-26 04:00:00,139,268,14,10,792,697,95,9
6437,2022-09-26 05:00:00,130,264,11,14,694,594,100,12
6438,2022-09-26 06:00:00,127,264,7,17,749,640,109,11
6439,2022-09-26 07:00:00,125,285,5,14,562,490,72,10
6440,2022-09-26 08:00:00,138,298,9,10,750,597,153,9
6441,2022-09-26 09:00:00,148,294,11,12,709,594,115,10
6442,2022-09-26 10:00:00,130,251,14,18,590,468,122,7
6443,2022-09-26 11:00:00,136,285,14,13,618,467,151,5
6444,2022-09-26 12:00:00,125,299,10,17,685,597,88,5
6445,2022-09-26 13:00:00,129,254,8,14,756,625,131,8
6446,2022-09-26 14:00:00,135,266,12,17,624,521,103,7
6447,2022-09-26 15:00:00,134,256,5,13,738,626,112,6
6448,2022-09-26 16:00:00,143,298,5,18,689,599,90,6
6449,2022-09-26 17:00:00,122,281,7,18,782,613,169,12
6450,2022-09-26 18:00:00,125,260,6,11,622,535,87,8
6451,2022-09-26 19:00:00,132,251,10,10,769,672,97,9
6452,2022-09-26 20:00:00,149,277,8,12,564,406,158,10
6453,2022-09-26 21:00:00,141,277,5,10,746,585,161,5
6454,2022-09-26 22:00:00,126,265,7,19,504,403,101,6
6455,2022-09-26 23:00:00,141,250,12,13,780,663,117,9
6456,2022-09-27 00:00:00,141,272,11,18,674,579,95,10
6457,2022-09-27 01:00:00,135,270,14,16,795,612,183,12
6458,2022-09-27 02:00:00,137,259,12,16,557,401,156,14
6459,2022-09-27 03:00:00,122,283,5,13,729,611,118,14
6460,2022-09-27 04:00:00,147,274,9,14,628,559,69,8
6461,2022-09-27 05:00:00,131,257,9,16,527,446,81,10
6462,2022-09-27 06:00:00,132,252,11,17,766,664,102,12
6463,2022-09-27 07:00:00,120,275,6,15,566,405,161,9
6464,2022-09-27 08:00:00,124,255,11,19,512,407,105,12
6465,2022-09-27 09:00:00,135,287,9,13,709,619,90,6
6466,2022-09-27 10:00:00,147,274,14,19,748,587,161,6
6467,2022-09-27 11:00:00,135,272,14,14,728,566,162,5
6468,2022-09-27 12:00:00,135,275,8,19,726,647,79,5
6469,2022-09-27 13:00:00,131,297,7,17,506,379,127,6
6470,2022-09-27 14:00:00,127,253,10,11,586,443,143,11
6471,2022-09-27 15:00:00,135,260,5,17,538,466,72,6
6472,2022-09-27 16:00:00,131,276,14,18,618,524,94,11
6473,2022-09-27 17:00:00,121,282,8,18,792,634,158,13
6474,2022-09-27 18:00:00,144,263,13,10,715,538,177,12
6475,2022-09-27 19:00:00,144,279,9,11,614,512,102,10
6476,2022-09-27 20:00:00,148,251,6,19,523,366,157,5
6477,2022-09-27 21:00:00,121,256,10,18,689,514,175,7
6478,2022-09-27 22:00:00,134,250,9,18,752,649,103,12
6479,2022-09-27 23:00:00,146,272,14,15,570,506,64,6
6480,2022-09-28 00:00:00,122,287,10,10,705,497,208,8
6481,2022-09-28 01:00:00,125,255,11,10,573,462,111,14
6482,2022-09-28 02:00:00,124,260,12,17,712,543,169,11
6483,2022-09-28 03:00:00,121,271,9,11,580,498,82,7
6484,2022-09-28 04:00:00,128,262,6,15,749,530,219,7
6485,2022-09-28 05:00:00,138,276,14,13,613,529,84,13
6486,2022-09-28 06:00:00,139,250,14,15,780,567,213,7
6487,2022-09-28 07:00:00,121,296,12,16,548,474,74,13
6488,2022-09-28 08:00:00,147,288,13,19,752,573,179,11
6489,2022-09-28 09:00:00,148,251,5,11,547,440,107,14
6490,2022-09-28 10:00:00,142,282,5,19,550,445,105,11
6491,2022-09-28 11:00:00,143,281,10,10,567,508,59,14
6492,2022-09-28 12:00:00,134,256,8,16,762,615,147,12
6493,2022-09-28 13:00:00,141,269,5,15,558,462,96,14
6494,2022-09-28 14:00:00,124,257,14,11,746,583,163,12
6495,2022-09-28 15:00:00,137,251,13,17,707,632,75,8
6496,2022-09-28 16:00:00,136,273,9,10,604,492,112,13
6497,2022-09-28 17:00:00,133,281,8,10,678,565,113,5
6498,2022-09-28 18:00:00,148,252,10,19,700,497,203,8
6499,2022-09-28 19:00:00,147,252,14,18,545,459,86,11
6500,2022-09-28 20:00:00,139,287,11,13,644,474,170,14
6501,2022-09-28 21:00:00,130,269,6,11,733,589,144,6
6502,2022-09-28 22:00:00,130,291,9,13,602,428,174,7
6503,2022-09-28 23:00:00,127,265,6,11,718,575,143,7
6504,2022-09-29 00:00:00,136,290,14,18,788,616,172,11
6505,2022-09-29 01:00:00,144,279,7,14,790,709,81,12
6506,2022-09-29 02:00:00,149,266,5,13,795,709,86,12
6507,2022-09-29 03:00:00,133,274,9,11,657,532,125,7
6508,2022-09-29 04:00:00,133,298,12,12,736,544,192,9
6509,2022-09-29 05:00:00,135,296,8,17,731,596,135,14
6510,2022-09-29 06:00:00,144,275,14,11,791,600,191,13
6511,2022-09-29 07:00:00,124,253,5,11,755,529,226,7
6512,2022-09-29 08:00:00,131,298,6,13,539,461,78,10
6513,2022-09-29 09:00:00,125,254,14,19,617,438,179,8
6514,2022-09-29 10:00:00,121,270,11,10,701,582,119,14
6515,2022-09-29 11:00:00,137,282,13,13,660,590,70,5
6516,2022-09-29 12:00:00,149,287,7,13,762,606,156,5
6517,2022-09-29 13:00:00,147,281,12,14,612,530,82,12
6518,2022-09-29 14:00:00,139,295,8,19,552,424,128,10
6519,2022-09-29 15:00:00,132,259,8,19,750,565,185,5
6520,2022-09-29 16:00:00,138,275,6,17,714,579,135,11
6521,2022-09-29 17:00:00,120,291,6,10,650,575,75,12
6522,2022-09-29 18:00:00,126,277,12,18,504,412,92,7
6523,2022-09-29 19:00:00,149,291,10,11,632,488,144,6
6524,2022-09-29 20:00:00,123,295,9,19,662,478,184,9
6525,2022-09-29 21:00:00,149,271,13,10,535,425,110,13
6526,2022-09-29 22:00:00,140,287,5,17,564,440,124,10
6527,2022-09-29 23:00:00,122,289,6,19,531,412,119,12
6528,2022-09-30 00:00:00,144,285,8,19,740,524,216,14
6529,2022-09-30 01:00:00,136,274,7,10,773,599,174,6
6530,2022-09-30 02:00:00,138,262,12,15,504,440,64,12
6531,2022-09-30 03:00:00,120,260,10,17,771,621,150,10
6532,2022-09-30 04:00:00,135,290,8,10,718,586,132,13
6533,2022-09-30 05:00:00,143,285,7,15,712,512,200,10
6534,2022-09-30 06:00:00,138,263,11,10,780,566,214,10
6535,2022-09-30 07:00:00,121,274,10,13,543,384,159,9
6536,2022-09-30 08:00:00,125,275,9,12,762,624,138,14
6537,2022-09-30 09:00:00,133,272,10,15,553,484,69,5
6538,2022-09-30 10:00:00,122,269,13,13,746,588,158,5
6539,2022-09-30 11:00:00,148,263,6,11,723,506,217,9
6540,2022-09-30 12:00:00,142,273,9,15,519,437,82,12
6541,2022-09-30 13:00:00,132,267,14,16,548,455,93,8
6542,2022-09-30 14:00:00,138,281,8,13,715,642,73,7
6543,2022-09-30 15:00:00,122,268,12,13,562,412,150,14
6544,2022-09-30 16:00:00,122,259,6,19,643,463,180,11
6545,2022-09-30 17:00:00,145,261,7,16,651,568,83,9
6546,2022-09-30 18:00:00,145,253,7,19,559,467,92,10
6547,2022-09-30 19:00:00,137,274,12,15,736,563,173,13
6548,2022-09-30 20:00:00,145,278,9,13,562,403,159,9
6549,2022-09-30 21:00:00,123,279,12,15,792,598,194,6
6550,2022-09-30 22:00:00,136,253,8,16,514,422,92,5
6551,2022-09-30 23:00:00,139,258,11,16,741,631,110,14
6552,2022-10-01 00:00:00,131,272,5,18,674,565,109,10
6553,2022-10-01 01:00:00,148,271,7,18,541,480,61,11
6554,2022-10-01 02:00:00,123,266,9,13,509,418,91,12
6555,2022-10-01 03:00:00,125,298,12,13,686,518,168,7
6556,2022-10-01 04:00:00,146,260,6,12,522,390,132,14
6557,2022-10-01 05:00:00,142,296,11,14,552,408,144,7
6558,2022-10-01 06:00:00,125,286,10,15,656,521,135,11
6559,2022-10-01 07:00:00,131,263,7,11,682,525,157,10
6560,2022-10-01 08:00:00,130,274,14,15,611,437,174,14
6561,2022-10-01 09:00:00,140,258,7,19,778,644,134,6
6562,2022-10-01 10:00:00,140,273,5,13,620,490,130,11
6563,2022-10-01 11:00:00,124,295,9,19,521,376,145,5
6564,2022-10-01 12:00:00,142,275,13,13,729,633,96,13
6565,2022-10-01 13:00:00,121,283,7,19,615,536,79,14
6566,2022-10-01 14:00:00,148,272,12,17,547,458,89,13
6567,2022-10-01 15:00:00,139,297,8,17,694,515,179,11
6568,2022-10-01 16:00:00,144,252,14,13,627,562,65,12
6569,2022-10-01 17:00:00,142,250,8,17,673,570,103,6
6570,2022-10-01 18:00:00,135,292,8,15,638,487,151,14
6571,2022-10-01 19:00:00,141,286,5,12,683,584,99,5
6572,2022-10-01 20:00:00,135,289,5,16,684,535,149,9
6573,2022-10-01 21:00:00,125,290,6,17,547,421,126,9
6574,2022-10-01 22:00:00,120,297,9,11,794,653,141,12
6575,2022-10-01 23:00:00,132,297,10,10,581,412,169,14
6576,2022-10-02 00:00:00,123,273,11,13,580,406,174,13
6577,2022-10-02 01:00:00,126,258,14,13,589,422,167,11
6578,2022-10-02 02:00:00,128,266,12,12,506,367,139,8
6579,2022-10-02 03:00:00,143,291,12,19,725,626,99,14
6580,2022-10-02 04:00:00,123,288,6,16,755,677,78,10
6581,2022-10-02 05:00:00,146,259,13,16,588,427,161,13
6582,2022-10-02 06:00:00,121,250,5,15,765,668,97,12
6583,2022-10-02 07:00:00,132,252,13,15,662,489,173,10
6584,2022-10-02 08:00:00,122,297,7,19,694,514,180,11
6585,2022-10-02 09:00:00,142,269,7,11,773,670,103,13
6586,2022-10-02 10:00:00,133,299,13,14,549,386,163,5
6587,2022-10-02 11:00:00,128,299,13,15,556,459,97,8
6588,2022-10-02 12:00:00,127,285,11,18,795,660,135,9
6589,2022-10-02 13:00:00,136,285,10,11,676,513,163,12
6590,2022-10-02 14:00:00,131,275,5,18,610,429,181,9
6591,2022-10-02 15:00:00,122,291,10,14,766,587,179,12
6592,2022-10-02 16:00:00,135,280,14,18,649,471,178,8
6593,2022-10-02 17:00:00,149,290,5,16,549,472,77,11
6594,2022-10-02 18:00:00,124,289,7,15,705,631,74,7
6595,2022-10-02 19:00:00,121,252,7,14,649,469,180,13
6596,2022-10-02 20:00:00,123,279,13,15,626,441,185,8
6597,2022-10-02 21:00:00,121,273,8,11,690,602,88,9
6598,2022-10-02 22:00:00,124,291,8,15,729,618,111,13
6599,2022-10-02 23:00:00,148,265,9,15,551,458,93,12
6600,2022-10-03 00:00:00,141,280,6,15,586,421,165,9
6601,2022-10-03 01:00:00,121,294,10,19,725,512,213,6
6602,2022-10-03 02:00:00,135,298,6,19,599,485,114,5
6603,2022-10-03 03:00:00,120,255,9,15,558,468,90,8
6604,2022-10-03 04:00:00,148,279,11,18,742,540,202,7
6605,2022-10-03 05:00:00,133,253,7,17,748,659,89,14
6606,2022-10-03 06:00:00,134,285,5,10,599,477,122,8
6607,2022-10-03 07:00:00,130,275,14,17,699,578,121,5
6608,2022-10-03 08:00:00,134,260,9,17,640,529,111,14
6609,2022-10-03 09:00:00,134,273,12,12,716,572,144,14
6610,2022-10-03 10:00:00,140,288,12,13,760,682,78,14
6611,2022-10-03 11:00:00,139,268,13,16,612,455,157,6
6612,2022-10-03 12:00:00,132,274,12,10,733,590,143,13
6613,2022-10-03 13:00:00,134,265,12,14,701,596,105,12
6614,2022-10-03 14:00:00,125,263,5,19,686,542,144,12
6615,2022-10-03 15:00:00,146,255,14,17,501,367,134,9
6616,2022-10-03 16:00:00,126,266,12,18,545,470,75,12
6617,2022-10-03 17:00:00,127,299,7,12,700,504,196,14
6618,2022-10-03 18:00:00,130,256,7,10,574,405,169,8
6619,2022-10-03 19:00:00,142,266,13,11,531,385,146,10
6620,2022-10-03 20:00:00,122,255,6,15,724,631,93,10
6621,2022-10-03 21:00:00,138,260,14,11,786,588,198,12
6622,2022-10-03 22:00:00,126,264,5,11,573,404,169,6
6623,2022-10-03 23:00:00,139,281,5,19,596,506,90,11
6624,2022-10-04 00:00:00,138,250,11,11,634,499,135,10
6625,2022-10-04 01:00:00,126,272,6,10,674,499,175,12
6626,2022-10-04 02:00:00,136,260,11,16,541,404,137,13
6627,2022-10-04 03:00:00,121,286,13,12,691,516,175,8
6628,2022-10-04 04:00:00,136,266,5,14,682,575,107,10
6629,2022-10-04 05:00:00,133,255,7,14,696,520,176,5
6630,2022-10-04 06:00:00,144,294,6,13,508,448,60,11
6631,2022-10-04 07:00:00,128,258,8,11,782,685,97,5
6632,2022-10-04 08:00:00,147,282,12,18,714,556,158,7
6633,2022-10-04 09:00:00,127,277,5,11,576,469,107,13
6634,2022-10-04 10:00:00,145,271,12,11,796,599,197,13
6635,2022-10-04 11:00:00,124,296,10,11,715,600,115,9
6636,2022-10-04 12:00:00,145,264,13,18,694,486,208,13
6637,2022-10-04 13:00:00,134,257,7,17,521,387,134,6
6638,2022-10-04 14:00:00,123,297,11,13,661,519,142,11
6639,2022-10-04 15:00:00,120,280,13,16,612,546,66,12
6640,2022-10-04 16:00:00,134,284,11,10,700,555,145,14
6641,2022-10-04 17:00:00,124,276,8,16,677,503,174,6
6642,2022-10-04 18:00:00,124,261,5,19,771,571,200,9
6643,2022-10-04 19:00:00,134,281,8,13,516,432,84,13
6644,2022-10-04 20:00:00,127,296,14,18,524,418,106,11
6645,2022-10-04 21:00:00,136,266,10,13,590,515,75,11
6646,2022-10-04 22:00:00,139,291,9,11,714,582,132,8
6647,2022-10-04 23:00:00,143,256,6,15,531,441,90,11
6648,2022-10-05 00:00:00,121,291,11,13,611,549,62,9
6649,2022-10-05 01:00:00,122,278,6,18,777,582,195,12
6650,2022-10-05 02:00:00,136,261,9,11,536,422,114,5
6651,2022-10-05 03:00:00,138,278,5,17,594,481,113,11
6652,2022-10-05 04:00:00,145,255,14,19,601,501,100,13
6653,2022-10-05 05:00:00,149,271,6,10,561,472,89,9
6654,2022-10-05 06:00:00,131,263,13,18,797,564,233,13
6655,2022-10-05 07:00:00,131,261,14,10,560,460,100,9
6656,2022-10-05 08:00:00,131,286,9,16,693,534,159,14
6657,2022-10-05 09:00:00,127,255,14,13,595,423,172,14
6658,2022-10-05 10:00:00,138,257,8,16,534,402,132,6
6659,2022-10-05 11:00:00,149,272,5,15,528,434,94,14
6660,2022-10-05 12:00:00,130,274,7,12,526,381,145,14
6661,2022-10-05 13:00:00,126,261,10,11,516,458,58,9
6662,2022-10-05 14:00:00,120,296,7,15,637,452,185,13
6663,2022-10-05 15:00:00,144,252,9,19,652,561,91,13
6664,2022-10-05 16:00:00,142,253,8,17,762,571,191,9
6665,2022-10-05 17:00:00,131,289,12,19,511,437,74,11
6666,2022-10-05 18:00:00,125,281,13,11,529,420,109,5
6667,2022-10-05 19:00:00,130,257,12,10,686,522,164,11
6668,2022-10-05 20:00:00,126,263,5,11,565,468,97,5
6669,2022-10-05 21:00:00,125,259,13,13,704,590,114,10
6670,2022-10-05 22:00:00,149,286,10,14,712,607,105,6
6671,2022-10-05 23:00:00,138,284,6,15,790,599,191,5
6672,2022-10-06 00:00:00,129,267,5,14,514,386,128,14
6673,2022-10-06 01:00:00,124,295,11,11,704,540,164,9
6674,2022-10-06 02:00:00,145,261,11,17,708,532,176,8
6675,2022-10-06 03:00:00,148,298,13,14,520,443,77,11
6676,2022-10-06 04:00:00,131,275,6,11,599,448,151,10
6677,2022-10-06 05:00:00,120,298,7,16,624,498,126,5
6678,2022-10-06 06:00:00,131,288,5,12,780,605,175,14
6679,2022-10-06 07:00:00,143,258,14,17,796,691,105,8
6680,2022-10-06 08:00:00,139,259,6,19,513,436,77,10
6681,2022-10-06 09:00:00,124,299,9,16,585,515,70,13
6682,2022-10-06 10:00:00,149,286,14,11,591,487,104,12
6683,2022-10-06 11:00:00,148,284,13,15,644,505,139,12
6684,2022-10-06 12:00:00,135,270,8,13,787,696,91,10
6685,2022-10-06 13:00:00,120,280,8,14,570,436,134,9
6686,2022-10-06 14:00:00,142,252,10,13,531,437,94,8
6687,2022-10-06 15:00:00,135,269,6,18,796,630,166,6
6688,2022-10-06 16:00:00,146,279,5,11,733,622,111,12
6689,2022-10-06 17:00:00,149,258,10,10,684,531,153,5
6690,2022-10-06 18:00:00,136,269,13,11,527,383,144,8
6691,2022-10-06 19:00:00,127,280,14,14,600,476,124,5
6692,2022-10-06 20:00:00,146,260,13,13,532,456,76,7
6693,2022-10-06 21:00:00,132,254,5,13,745,619,126,13
6694,2022-10-06 22:00:00,129,264,10,11,707,497,210,14
6695,2022-10-06 23:00:00,123,268,5,10,613,523,90,14
6696,2022-10-07 00:00:00,120,274,13,16,506,373,133,12
6697,2022-10-07 01:00:00,146,288,10,10,731,523,208,14
6698,2022-10-07 02:00:00,135,272,7,15,518,402,116,11
6699,2022-10-07 03:00:00,136,274,7,12,556,389,167,9
6700,2022-10-07 04:00:00,142,285,7,13,650,498,152,9
6701,2022-10-07 05:00:00,139,292,12,17,776,685,91,11
6702,2022-10-07 06:00:00,144,281,14,17,524,402,122,13
6703,2022-10-07 07:00:00,144,263,10,18,772,676,96,12
6704,2022-10-07 08:00:00,123,290,13,10,574,406,168,12
6705,2022-10-07 09:00:00,138,288,5,18,552,473,79,8
6706,2022-10-07 10:00:00,146,267,8,13,668,532,136,6
6707,2022-10-07 11:00:00,142,252,14,18,670,524,146,10
6708,2022-10-07 12:00:00,124,268,7,18,643,566,77,6
6709,2022-10-07 13:00:00,132,299,8,13,512,387,125,12
6710,2022-10-07 14:00:00,133,270,11,12,749,667,82,11
6711,2022-10-07 15:00:00,138,290,9,17,768,657,111,7
6712,2022-10-07 16:00:00,137,277,14,13,543,478,65,13
6713,2022-10-07 17:00:00,134,254,8,14,698,552,146,10
6714,2022-10-07 18:00:00,130,272,10,17,568,446,122,14
6715,2022-10-07 19:00:00,149,266,8,10,767,594,173,10
6716,2022-10-07 20:00:00,129,286,9,16,546,437,109,6
6717,2022-10-07 21:00:00,138,260,10,18,678,551,127,12
6718,2022-10-07 22:00:00,144,264,10,16,694,492,202,5
6719,2022-10-07 23:00:00,120,250,12,18,574,454,120,13
6720,2022-10-08 00:00:00,120,271,10,16,644,533,111,14
6721,2022-10-08 01:00:00,124,256,9,18,786,641,145,5
6722,2022-10-08 02:00:00,137,264,7,12,601,461,140,11
6723,2022-10-08 03:00:00,139,268,10,14,611,474,137,7
6724,2022-10-08 04:00:00,141,273,10,18,755,590,165,8
6725,2022-10-08 05:00:00,123,296,6,19,517,383,134,14
6726,2022-10-08 06:00:00,143,298,6,14,587,421,166,5
6727,2022-10-08 07:00:00,146,277,12,10,614,482,132,7
6728,2022-10-08 08:00:00,137,272,8,11,581,449,132,5
6729,2022-10-08 09:00:00,127,267,12,11,522,407,115,6
6730,2022-10-08 10:00:00,148,275,10,13,708,616,92,9
6731,2022-10-08 11:00:00,124,280,8,16,588,524,64,11
6732,2022-10-08 12:00:00,133,273,14,12,560,400,160,6
6733,2022-10-08 13:00:00,138,294,5,11,625,549,76,5
6734,2022-10-08 14:00:00,139,287,8,15,634,527,107,8
6735,2022-10-08 15:00:00,121,278,12,15,569,417,152,11
6736,2022-10-08 16:00:00,147,275,10,14,564,450,114,13
6737,2022-10-08 17:00:00,124,251,5,11,696,609,87,8
6738,2022-10-08 18:00:00,121,292,14,17,595,493,102,9
6739,2022-10-08 19:00:00,133,289,10,17,721,582,139,9
6740,2022-10-08 20:00:00,122,270,8,16,641,512,129,11
6741,2022-10-08 21:00:00,122,274,9,17,530,473,57,13
6742,2022-10-08 22:00:00,122,280,6,18,670,511,159,10
6743,2022-10-08 23:00:00,142,271,11,18,730,540,190,11
6744,2022-10-09 00:00:00,143,268,8,12,560,415,145,13
6745,2022-10-09 01:00:00,146,290,12,18,551,456,95,12
6746,2022-10-09 02:00:00,139,296,14,19,515,362,153,6
6747,2022-10-09 03:00:00,128,266,11,19,783,648,135,11
6748,2022-10-09 04:00:00,140,268,5,18,764,636,128,14
6749,2022-10-09 05:00:00,144,262,14,11,655,513,142,10
6750,2022-10-09 06:00:00,145,265,10,18,510,396,114,10
6751,2022-10-09 07:00:00,138,278,12,12,689,603,86,9
6752,2022-10-09 08:00:00,135,275,9,11,720,541,179,14
6753,2022-10-09 09:00:00,131,291,10,12,790,688,102,6
6754,2022-10-09 10:00:00,127,291,11,14,688,567,121,11
6755,2022-10-09 11:00:00,141,272,6,17,509,441,68,11
6756,2022-10-09 12:00:00,130,273,13,16,569,506,63,9
6757,2022-10-09 13:00:00,127,280,13,12,613,550,63,12
6758,2022-10-09 14:00:00,124,257,14,10,739,534,205,13
6759,2022-10-09 15:00:00,142,266,11,10,527,415,112,7
6760,2022-10-09 16:00:00,148,281,13,17,676,596,80,13
6761,2022-10-09 17:00:00,132,272,14,11,705,534,171,6
6762,2022-10-09 18:00:00,128,298,9,16,629,448,181,9
6763,2022-10-09 19:00:00,129,256,11,12,597,512,85,6
6764,2022-10-09 20:00:00,124,270,10,10,577,425,152,8
6765,2022-10-09 21:00:00,124,258,6,11,678,520,158,8
6766,2022-10-09 22:00:00,126,271,12,10,642,521,121,8
6767,2022-10-09 23:00:00,124,276,8,13,777,673,104,8
6768,2022-10-10 00:00:00,132,289,8,15,682,593,89,11
6769,2022-10-10 01:00:00,130,258,8,11,638,462,176,9
6770,2022-10-10 02:00:00,147,273,9,17,723,540,183,14
6771,2022-10-10 03:00:00,134,288,11,18,624,441,183,6
6772,2022-10-10 04:00:00,135,257,14,17,520,433,87,12
6773,2022-10-10 05:00:00,140,292,11,17,720,551,169,8
6774,2022-10-10 06:00:00,122,256,12,12,775,620,155,13
6775,2022-10-10 07:00:00,139,295,7,18,753,608,145,8
6776,2022-10-10 08:00:00,131,256,7,10,700,629,71,5
6777,2022-10-10 09:00:00,146,272,6,14,751,577,174,5
6778,2022-10-10 10:00:00,138,296,9,14,658,566,92,12
6779,2022-10-10 11:00:00,136,275,13,18,723,517,206,14
6780,2022-10-10 12:00:00,133,264,8,14,572,451,121,7
6781,2022-10-10 13:00:00,132,262,13,18,591,473,118,10
6782,2022-10-10 14:00:00,127,286,7,15,714,522,192,7
6783,2022-10-10 15:00:00,124,291,6,12,538,454,84,12
6784,2022-10-10 16:00:00,129,264,6,19,786,649,137,13
6785,2022-10-10 17:00:00,148,286,9,12,735,576,159,5
6786,2022-10-10 18:00:00,146,264,8,12,749,535,214,10
6787,2022-10-10 19:00:00,137,259,11,16,637,522,115,5
6788,2022-10-10 20:00:00,130,257,10,10,607,440,167,5
6789,2022-10-10 21:00:00,120,253,6,16,689,604,85,5
6790,2022-10-10 22:00:00,124,286,7,17,672,509,163,5
6791,2022-10-10 23:00:00,132,253,14,13,744,530,214,14
6792,2022-10-11 00:00:00,146,255,14,15,798,694,104,6
6793,2022-10-11 01:00:00,147,264,8,19,789,702,87,5
6794,2022-10-11 02:00:00,129,281,12,18,504,360,144,9
6795,2022-10-11 03:00:00,138,260,6,11,632,494,138,13
6796,2022-10-11 04:00:00,135,297,12,11,615,439,176,11
6797,2022-10-11 05:00:00,138,298,9,19,501,391,110,14
6798,2022-10-11 06:00:00,140,287,13,15,790,576,214,10
6799,2022-10-11 07:00:00,135,250,6,11,738,647,91,6
6800,2022-10-11 08:00:00,132,286,7,14,680,508,172,10
6801,2022-10-11 09:00:00,124,278,14,14,587,504,83,6
6802,2022-10-11 10:00:00,123,259,5,15,730,642,88,12
6803,2022-10-11 11:00:00,124,273,13,14,746,589,157,6
6804,2022-10-11 12:00:00,123,280,10,15,575,445,130,11
6805,2022-10-11 13:00:00,129,265,7,10,508,388,120,9
6806,2022-10-11 14:00:00,130,265,7,16,626,532,94,8
6807,2022-10-11 15:00:00,123,282,13,19,720,610,110,13
6808,2022-10-11 16:00:00,123,267,14,18,704,615,89,6
6809,2022-10-11 17:00:00,126,263,10,19,701,539,162,8
6810,2022-10-11 18:00:00,130,286,11,15,616,486,130,13
6811,2022-10-11 19:00:00,132,298,13,13,782,559,223,14
6812,2022-10-11 20:00:00,140,261,13,14,663,563,100,11
6813,2022-10-11 21:00:00,124,251,7,16,673,492,181,5
6814,2022-10-11 22:00:00,141,283,7,19,682,590,92,6
6815,2022-10-11 23:00:00,131,255,6,18,579,439,140,11
6816,2022-10-12 00:00:00,124,297,6,12,663,594,69,8
6817,2022-10-12 01:00:00,126,254,11,18,502,430,72,6
6818,2022-10-12 02:00:00,130,250,14,11,719,578,141,6
6819,2022-10-12 03:00:00,130,297,10,13,517,422,95,14
6820,2022-10-12 04:00:00,129,263,9,15,732,554,178,14
6821,2022-10-12 05:00:00,142,292,13,15,584,448,136,14
6822,2022-10-12 06:00:00,140,280,12,10,563,398,165,6
6823,2022-10-12 07:00:00,144,284,11,14,519,464,55,9
6824,2022-10-12 08:00:00,127,275,6,17,723,647,76,12
6825,2022-10-12 09:00:00,123,279,12,18,784,557,227,14
6826,2022-10-12 10:00:00,143,267,8,12,590,467,123,9
6827,2022-10-12 11:00:00,149,291,9,15,505,364,141,8
6828,2022-10-12 12:00:00,135,268,13,15,529,405,124,5
6829,2022-10-12 13:00:00,126,250,8,10,591,452,139,11
6830,2022-10-12 14:00:00,136,264,13,14,690,612,78,7
6831,2022-10-12 15:00:00,144,264,9,14,530,436,94,9
6832,2022-10-12 16:00:00,126,294,5,14,621,481,140,12
6833,2022-10-12 17:00:00,146,261,7,19,687,593,94,8
6834,2022-10-12 18:00:00,129,275,12,12,590,453,137,8
6835,2022-10-12 19:00:00,130,294,12,16,662,523,139,11
6836,2022-10-12 20:00:00,121,259,6,18,576,435,141,10
6837,2022-10-12 21:00:00,133,283,9,15,730,649,81,12
6838,2022-10-12 22:00:00,132,272,7,19,508,360,148,12
6839,2022-10-12 23:00:00,147,258,6,10,516,404,112,7
6840,2022-10-13 00:00:00,145,282,10,18,590,436,154,12
6841,2022-10-13 01:00:00,144,279,6,13,691,511,180,13
6842,2022-10-13 02:00:00,139,257,14,17,544,400,144,14
6843,2022-10-13 03:00:00,140,293,14,13,777,691,86,6
6844,2022-10-13 04:00:00,125,294,14,19,640,532,108,11
6845,2022-10-13 05:00:00,149,270,6,10,602,481,121,10
6846,2022-10-13 06:00:00,143,258,6,17,566,410,156,8
6847,2022-10-13 07:00:00,127,295,7,15,717,574,143,5
6848,2022-10-13 08:00:00,126,274,5,15,591,435,156,8
6849,2022-10-13 09:00:00,121,272,6,13,723,514,209,7
6850,2022-10-13 10:00:00,136,282,8,18,713,597,116,5
6851,2022-10-13 11:00:00,122,252,12,12,620,492,128,9
6852,2022-10-13 12:00:00,125,268,7,13,766,562,204,8
6853,2022-10-13 13:00:00,132,274,8,12,780,576,204,13
6854,2022-10-13 14:00:00,134,284,5,19,663,512,151,10
6855,2022-10-13 15:00:00,128,274,6,19,682,611,71,7
6856,2022-10-13 16:00:00,133,295,12,12,734,611,123,14
6857,2022-10-13 17:00:00,144,296,11,12,647,540,107,13
6858,2022-10-13 18:00:00,148,253,8,13,761,559,202,11
6859,2022-10-13 19:00:00,138,294,8,11,716,638,78,5
6860,2022-10-13 20:00:00,148,251,12,10,511,427,84,13
6861,2022-10-13 21:00:00,120,276,8,15,566,447,119,12
6862,2022-10-13 22:00:00,142,271,9,19,713,575,138,8
6863,2022-10-13 23:00:00,147,272,11,19,507,386,121,9
6864,2022-10-14 00:00:00,149,273,10,10,649,524,125,5
6865,2022-10-14 01:00:00,133,268,9,15,682,532,150,11
6866,2022-10-14 02:00:00,121,297,5,13,687,584,103,10
6867,2022-10-14 03:00:00,129,263,10,18,774,565,209,5
6868,2022-10-14 04:00:00,123,289,5,14,515,376,139,9
6869,2022-10-14 05:00:00,127,270,8,18,592,514,78,5
6870,2022-10-14 06:00:00,149,265,13,10,644,490,154,12
6871,2022-10-14 07:00:00,126,295,12,13,706,556,150,14
6872,2022-10-14 08:00:00,127,281,10,16,584,448,136,5
6873,2022-10-14 09:00:00,133,267,14,13,598,497,101,10
6874,2022-10-14 10:00:00,123,258,14,19,525,434,91,5
6875,2022-10-14 11:00:00,130,259,11,11,597,432,165,14
6876,2022-10-14 12:00:00,132,275,6,12,790,650,140,13
6877,2022-10-14 13:00:00,148,257,11,11,678,488,190,10
6878,2022-10-14 14:00:00,149,282,8,18,719,517,202,13
6879,2022-10-14 15:00:00,131,277,9,17,681,493,188,11
6880,2022-10-14 16:00:00,134,292,5,14,736,577,159,13
6881,2022-10-14 17:00:00,141,272,11,19,706,528,178,10
6882,2022-10-14 18:00:00,139,288,7,14,799,588,211,5
6883,2022-10-14 19:00:00,128,297,12,19,724,624,100,9
6884,2022-10-14 20:00:00,147,297,6,18,797,563,234,6
6885,2022-10-14 21:00:00,120,258,14,11,656,576,80,10
6886,2022-10-14 22:00:00,145,269,6,15,541,415,126,12
6887,2022-10-14 23:00:00,140,299,5,16,528,424,104,5
6888,2022-10-15 00:00:00,131,298,11,11,666,471,195,9
6889,2022-10-15 01:00:00,128,252,14,15,771,641,130,10
6890,2022-10-15 02:00:00,125,275,10,11,715,612,103,6
6891,2022-10-15 03:00:00,124,288,11,12,644,512,132,6
6892,2022-10-15 04:00:00,121,292,5,15,698,597,101,8
6893,2022-10-15 05:00:00,132,256,10,13,707,635,72,13
6894,2022-10-15 06:00:00,125,292,12,15,612,454,158,6
6895,2022-10-15 07:00:00,123,279,11,16,771,624,147,9
6896,2022-10-15 08:00:00,137,271,9,13,529,471,58,7
6897,2022-10-15 09:00:00,145,257,9,13,672,559,113,13
6898,2022-10-15 10:00:00,148,287,6,18,756,532,224,6
6899,2022-10-15 11:00:00,121,260,6,13,620,539,81,9
6900,2022-10-15 12:00:00,121,281,13,13,726,581,145,10
6901,2022-10-15 13:00:00,128,265,5,10,649,561,88,12
6902,2022-10-15 14:00:00,140,272,9,17,517,432,85,6
6903,2022-10-15 15:00:00,132,277,6,18,560,433,127,14
6904,2022-10-15 16:00:00,127,250,11,15,538,413,125,9
6905,2022-10-15 17:00:00,147,292,13,11,640,533,107,5
6906,2022-10-15 18:00:00,133,266,14,17,689,578,111,5
6907,2022-10-15 19:00:00,131,293,8,19,568,432,136,9
6908,2022-10-15 20:00:00,132,274,12,18,660,551,109,8
6909,2022-10-15 21:00:00,144,275,12,16,541,424,117,9
6910,2022-10-15 22:00:00,142,260,6,13,548,450,98,7
6911,2022-10-15 23:00:00,132,287,13,12,545,459,86,11
6912,2022-10-16 00:00:00,141,299,9,10,636,539,97,12
6913,2022-10-16 01:00:00,124,257,7,15,590,482,108,6
6914,2022-10-16 02:00:00,144,280,5,19,562,422,140,13
6915,2022-10-16 03:00:00,142,291,8,14,500,350,150,10
6916,2022-10-16 04:00:00,123,271,7,18,796,666,130,12
6917,2022-10-16 05:00:00,126,288,13,14,506,391,115,10
6918,2022-10-16 06:00:00,147,273,7,14,754,536,218,9
6919,2022-10-16 07:00:00,141,291,8,15,525,427,98,6
6920,2022-10-16 08:00:00,121,273,6,19,528,443,85,8
6921,2022-10-16 09:00:00,129,255,13,14,791,664,127,7
6922,2022-10-16 10:00:00,121,257,11,12,765,610,155,7
6923,2022-10-16 11:00:00,148,296,10,13,657,520,137,12
6924,2022-10-16 12:00:00,133,269,13,17,562,476,86,11
6925,2022-10-16 13:00:00,136,263,14,18,601,463,138,5
6926,2022-10-16 14:00:00,146,259,13,19,681,492,189,11
6927,2022-10-16 15:00:00,145,269,13,11,648,510,138,7
6928,2022-10-16 16:00:00,121,284,10,17,555,498,57,10
6929,2022-10-16 17:00:00,141,266,12,11,669,536,133,5
6930,2022-10-16 18:00:00,130,299,8,10,748,635,113,8
6931,2022-10-16 19:00:00,127,267,8,17,664,517,147,5
6932,2022-10-16 20:00:00,124,292,12,16,523,378,145,13
6933,2022-10-16 21:00:00,125,285,11,18,696,573,123,8
6934,2022-10-16 22:00:00,130,285,6,15,603,425,178,5
6935,2022-10-16 23:00:00,143,269,11,16,503,375,128,9
6936,2022-10-17 00:00:00,142,284,6,11,652,514,138,12
6937,2022-10-17 01:00:00,136,269,14,16,733,629,104,8
6938,2022-10-17 02:00:00,134,293,13,19,640,547,93,14
6939,2022-10-17 03:00:00,129,284,14,15,545,435,110,6
6940,2022-10-17 04:00:00,147,285,8,11,517,431,86,14
6941,2022-10-17 05:00:00,136,256,7,15,516,426,90,14
6942,2022-10-17 06:00:00,126,272,13,11,617,501,116,9
6943,2022-10-17 07:00:00,138,266,9,12,502,417,85,8
6944,2022-10-17 08:00:00,149,299,6,18,796,611,185,13
6945,2022-10-17 09:00:00,147,293,9,18,740,619,121,13
6946,2022-10-17 10:00:00,137,267,5,16,564,427,137,11
6947,2022-10-17 11:00:00,138,271,7,15,771,658,113,11
6948,2022-10-17 12:00:00,148,256,7,16,523,448,75,14
6949,2022-10-17 13:00:00,122,263,12,13,799,710,89,5
6950,2022-10-17 14:00:00,122,280,13,11,592,415,177,9
6951,2022-10-17 15:00:00,132,285,12,19,763,637,126,12
6952,2022-10-17 16:00:00,135,274,13,11,504,377,127,6
6953,2022-10-17 17:00:00,136,265,5,11,599,519,80,9
6954,2022-10-17 18:00:00,145,283,9,18,641,537,104,8
6955,2022-10-17 19:00:00,134,265,14,17,719,605,114,10
6956,2022-10-17 20:00:00,124,296,13,18,731,624,107,11
6957,2022-10-17 21:00:00,146,265,9,19,542,436,106,6
6958,2022-10-17 22:00:00,123,288,6,13,735,652,83,8
6959,2022-10-17 23:00:00,123,251,14,14,738,639,99,6
6960,2022-10-18 00:00:00,123,275,11,17,663,490,173,12
6961,2022-10-18 01:00:00,123,268,9,17,770,636,134,12
6962,2022-10-18 02:00:00,133,270,14,15,553,455,98,6
6963,2022-10-18 03:00:00,135,278,14,16,531,374,157,13
6964,2022-10-18 04:00:00,134,273,6,16,725,610,115,9
6965,2022-10-18 05:00:00,147,297,8,17,647,518,129,6
6966,2022-10-18 06:00:00,131,297,13,18,697,530,167,6
6967,2022-10-18 07:00:00,125,288,13,16,760,676,84,7
6968,2022-10-18 08:00:00,124,298,14,13,635,452,183,7
6969,2022-10-18 09:00:00,121,258,11,13,554,419,135,9
6970,2022-10-18 10:00:00,144,289,5,14,603,449,154,14
6971,2022-10-18 11:00:00,126,267,5,12,562,429,133,13
6972,2022-10-18 12:00:00,132,292,6,17,746,570,176,9
6973,2022-10-18 13:00:00,132,256,8,10,720,623,97,10
6974,2022-10-18 14:00:00,129,275,12,19,635,535,100,13
6975,2022-10-18 15:00:00,140,269,10,11,552,488,64,5
6976,2022-10-18 16:00:00,124,289,10,16,660,491,169,14
6977,2022-10-18 17:00:00,137,283,5,13,690,517,173,8
6978,2022-10-18 18:00:00,147,277,7,13,663,481,182,7
6979,2022-10-18 19:00:00,148,289,10,18,678,493,185,12
6980,2022-10-18 20:00:00,131,279,12,19,601,427,174,6
6981,2022-10-18 21:00:00,126,262,13,10,647,530,117,14
6982,2022-10-18 22:00:00,120,292,10,18,683,555,128,5
6983,2022-10-18 23:00:00,146,269,8,16,740,594,146,8
6984,2022-10-19 00:00:00,129,285,12,14,567,404,163,6
6985,2022-10-19 01:00:00,130,252,10,10,756,645,111,9
6986,2022-10-19 02:00:00,141,296,5,18,724,586,138,12
6987,2022-10-19 03:00:00,121,294,12,18,578,413,165,8
6988,2022-10-19 04:00:00,149,279,12,16,591,476,115,12
6989,2022-10-19 05:00:00,142,296,9,13,766,604,162,8
6990,2022-10-19 06:00:00,147,261,11,11,504,425,79,13
6991,2022-10-19 07:00:00,125,288,14,13,751,582,169,9
6992,2022-10-19 08:00:00,123,299,14,13,636,491,145,12
6993,2022-10-19 09:00:00,132,260,13,13,501,424,77,9
6994,2022-10-19 10:00:00,143,283,13,17,617,509,108,8
6995,2022-10-19 11:00:00,137,274,11,12,558,396,162,8
6996,2022-10-19 12:00:00,124,288,6,13,745,525,220,8
6997,2022-10-19 13:00:00,128,275,14,16,715,568,147,14
6998,2022-10-19 14:00:00,127,277,6,19,730,633,97,9
6999,2022-10-19 15:00:00,149,251,12,16,721,557,164,10
7000,2022-10-19 16:00:00,128,281,8,15,677,519,158,7
7001,2022-10-19 17:00:00,136,289,12,14,595,528,67,14
7002,2022-10-19 18:00:00,135,252,9,19,617,499,118,5
7003,2022-10-19 19:00:00,130,298,8,15,669,523,146,13
7004,2022-10-19 20:00:00,132,272,8,17,735,522,213,7
7005,2022-10-19 21:00:00,126,295,10,19,707,613,94,10
7006,2022-10-19 22:00:00,120,267,10,11,784,618,166,14
7007,2022-10-19 23:00:00,132,251,8,10,602,482,120,14
7008,2022-10-20 00:00:00,135,277,6,16,567,471,96,9
7009,2022-10-20 01:00:00,143,259,14,18,584,470,114,13
7010,2022-10-20 02:00:00,140,268,12,10,733,658,75,13
7011,2022-10-20 03:00:00,132,288,12,10,757,676,81,10
7012,2022-10-20 04:00:00,120,284,7,14,587,515,72,12
7013,2022-10-20 05:00:00,131,260,11,10,719,504,215,5
7014,2022-10-20 06:00:00,135,274,6,11,560,432,128,13
7015,2022-10-20 07:00:00,121,277,8,11,554,421,133,8
7016,2022-10-20 08:00:00,140,289,10,14,503,409,94,8
7017,2022-10-20 09:00:00,135,277,10,10,626,544,82,12
7018,2022-10-20 10:00:00,121,270,14,15,659,555,104,5
7019,2022-10-20 11:00:00,143,253,12,17,709,610,99,10
7020,2022-10-20 12:00:00,133,289,7,15,620,530,90,7
7021,2022-10-20 13:00:00,137,251,9,16,659,586,73,13
7022,2022-10-20 14:00:00,125,267,11,12,680,524,156,9
7023,2022-10-20 15:00:00,121,293,7,11,782,660,122,11
7024,2022-10-20 16:00:00,120,273,12,19,782,588,194,8
7025,2022-10-20 17:00:00,134,298,12,18,744,660,84,6
7026,2022-10-20 18:00:00,142,276,13,16,585,436,149,8
7027,2022-10-20 19:00:00,143,283,11,19,572,441,131,6
7028,2022-10-20 20:00:00,123,287,7,15,627,508,119,6
7029,2022-10-20 21:00:00,132,277,14,12,764,560,204,14
7030,2022-10-20 22:00:00,133,252,7,14,590,512,78,6
7031,2022-10-20 23:00:00,144,269,12,12,560,462,98,13
7032,2022-10-21 00:00:00,133,256,6,19,586,512,74,7
7033,2022-10-21 01:00:00,148,285,14,11,517,376,141,11
7034,2022-10-21 02:00:00,128,280,13,10,696,506,190,7
7035,2022-10-21 03:00:00,131,266,9,10,523,393,130,8
7036,2022-10-21 04:00:00,142,284,12,10,687,606,81,9
7037,2022-10-21 05:00:00,139,260,10,13,751,583,168,9
7038,2022-10-21 06:00:00,130,281,7,12,575,415,160,7
7039,2022-10-21 07:00:00,137,272,12,18,725,650,75,7
7040,2022-10-21 08:00:00,128,277,9,16,699,574,125,5
7041,2022-10-21 09:00:00,147,287,9,11,617,536,81,5
7042,2022-10-21 10:00:00,130,269,11,14,674,572,102,8
7043,2022-10-21 11:00:00,145,294,10,17,668,598,70,14
7044,2022-10-21 12:00:00,132,256,14,10,683,524,159,8
7045,2022-10-21 13:00:00,145,274,14,12,747,574,173,8
7046,2022-10-21 14:00:00,145,255,14,17,555,461,94,8
7047,2022-10-21 15:00:00,143,291,13,15,634,524,110,9
7048,2022-10-21 16:00:00,140,277,6,13,556,392,164,5
7049,2022-10-21 17:00:00,138,292,5,17,739,523,216,10
7050,2022-10-21 18:00:00,144,265,8,19,561,445,116,5
7051,2022-10-21 19:00:00,138,281,6,10,704,510,194,14
7052,2022-10-21 20:00:00,123,257,12,13,726,538,188,11
7053,2022-10-21 21:00:00,124,287,14,15,660,470,190,11
7054,2022-10-21 22:00:00,128,282,7,12,701,573,128,5
7055,2022-10-21 23:00:00,146,278,7,15,658,472,186,14
7056,2022-10-22 00:00:00,132,283,13,19,564,436,128,14
7057,2022-10-22 01:00:00,120,294,11,15,796,690,106,10
7058,2022-10-22 02:00:00,126,258,6,16,667,475,192,6
7059,2022-10-22 03:00:00,132,273,8,14,529,445,84,8
7060,2022-10-22 04:00:00,134,291,7,16,667,576,91,14
7061,2022-10-22 05:00:00,133,264,9,15,737,641,96,13
7062,2022-10-22 06:00:00,143,292,14,10,581,467,114,8
7063,2022-10-22 07:00:00,142,293,5,17,523,384,139,5
7064,2022-10-22 08:00:00,143,291,7,13,529,427,102,8
7065,2022-10-22 09:00:00,132,271,13,13,617,471,146,7
7066,2022-10-22 10:00:00,143,268,11,11,712,551,161,6
7067,2022-10-22 11:00:00,139,294,6,15,672,480,192,9
7068,2022-10-22 12:00:00,142,252,11,18,730,593,137,12
7069,2022-10-22 13:00:00,139,278,9,12,536,423,113,7
7070,2022-10-22 14:00:00,147,267,9,10,608,431,177,11
7071,2022-10-22 15:00:00,125,288,8,17,628,473,155,9
7072,2022-10-22 16:00:00,122,264,5,12,502,431,71,5
7073,2022-10-22 17:00:00,145,286,13,17,766,662,104,5
7074,2022-10-22 18:00:00,137,283,8,12,609,496,113,11
7075,2022-10-22 19:00:00,140,254,13,13,776,552,224,5
7076,2022-10-22 20:00:00,123,284,11,12,691,563,128,10
7077,2022-10-22 21:00:00,136,260,8,18,514,445,69,11
7078,2022-10-22 22:00:00,135,282,13,15,790,584,206,9
7079,2022-10-22 23:00:00,129,266,6,15,670,570,100,8
7080,2022-10-23 00:00:00,141,292,10,12,744,543,201,9
7081,2022-10-23 01:00:00,129,254,9,17,525,402,123,13
7082,2022-10-23 02:00:00,129,286,6,15,510,394,116,13
7083,2022-10-23 03:00:00,133,261,6,18,615,479,136,6
7084,2022-10-23 04:00:00,137,251,5,16,658,538,120,7
7085,2022-10-23 05:00:00,148,263,7,12,738,652,86,6
7086,2022-10-23 06:00:00,146,298,14,19,533,421,112,11
7087,2022-10-23 07:00:00,134,284,14,11,751,665,86,5
7088,2022-10-23 08:00:00,143,272,13,19,583,419,164,14
7089,2022-10-23 09:00:00,147,250,5,11,608,446,162,12
7090,2022-10-23 10:00:00,135,269,13,12,740,640,100,9
7091,2022-10-23 11:00:00,126,271,11,10,532,375,157,7
7092,2022-10-23 12:00:00,145,285,7,18,631,465,166,6
7093,2022-10-23 13:00:00,131,268,10,15,625,496,129,8
7094,2022-10-23 14:00:00,145,276,11,11,585,516,69,14
7095,2022-10-23 15:00:00,121,275,6,16,629,453,176,10
7096,2022-10-23 16:00:00,125,285,14,17,638,459,179,9
7097,2022-10-23 17:00:00,121,277,7,17,558,396,162,9
7098,2022-10-23 18:00:00,149,250,5,19,573,482,91,6
7099,2022-10-23 19:00:00,145,263,12,18,642,509,133,12
7100,2022-10-23 20:00:00,122,297,11,19,731,650,81,10
7101,2022-10-23 21:00:00,123,253,10,17,782,573,209,14
7102,2022-10-23 22:00:00,120,254,8,19,634,542,92,13
7103,2022-10-23 23:00:00,124,287,14,12,616,508,108,7
7104,2022-10-24 00:00:00,128,289,11,13,617,537,80,7
7105,2022-10-24 01:00:00,123,275,14,15,665,550,115,12
7106,2022-10-24 02:00:00,134,262,9,10,756,602,154,11
7107,2022-10-24 03:00:00,122,281,14,14,502,430,72,9
7108,2022-10-24 04:00:00,135,253,7,13,697,559,138,9
7109,2022-10-24 05:00:00,124,260,13,14,544,431,113,13
7110,2022-10-24 06:00:00,137,298,5,10,720,619,101,12
7111,2022-10-24 07:00:00,139,278,13,11,706,575,131,14
7112,2022-10-24 08:00:00,147,285,12,11,747,668,79,6
7113,2022-10-24 09:00:00,142,261,12,11,628,534,94,13
7114,2022-10-24 10:00:00,139,275,12,12,695,519,176,7
7115,2022-10-24 11:00:00,137,251,5,10,525,370,155,8
7116,2022-10-24 12:00:00,136,283,7,19,614,457,157,13
7117,2022-10-24 13:00:00,121,280,5,15,633,542,91,10
7118,2022-10-24 14:00:00,128,286,8,19,550,398,152,8
7119,2022-10-24 15:00:00,136,286,8,19,724,631,93,7
7120,2022-10-24 16:00:00,137,283,11,14,533,437,96,13
7121,2022-10-24 17:00:00,129,264,11,12,585,437,148,8
7122,2022-10-24 18:00:00,128,286,8,17,554,429,125,6
7123,2022-10-24 19:00:00,149,267,5,12,578,510,68,10
7124,2022-10-24 20:00:00,132,290,14,13,576,469,107,10
7125,2022-10-24 21:00:00,122,276,11,17,582,412,170,8
7126,2022-10-24 22:00:00,133,261,13,16,677,560,117,5
7127,2022-10-24 23:00:00,127,252,13,14,540,474,66,10
7128,2022-10-25 00:00:00,145,277,10,12,597,506,91,12
7129,2022-10-25 01:00:00,132,267,11,18,771,595,176,5
7130,2022-10-25 02:00:00,126,276,9,17,669,595,74,6
7131,2022-10-25 03:00:00,138,277,14,13,527,393,134,5
7132,2022-10-25 04:00:00,123,257,7,19,789,599,190,11
7133,2022-10-25 05:00:00,146,261,12,16,606,529,77,12
7134,2022-10-25 06:00:00,141,259,12,10,634,444,190,7
7135,2022-10-25 07:00:00,129,269,8,15,505,452,53,13
7136,2022-10-25 08:00:00,139,280,7,16,621,441,180,7
7137,2022-10-25 09:00:00,149,292,6,16,572,465,107,12
7138,2022-10-25 10:00:00,130,284,12,14,773,564,209,6
7139,2022-10-25 11:00:00,135,270,7,16,787,588,199,13
7140,2022-10-25 12:00:00,128,259,14,16,766,647,119,14
7141,2022-10-25 13:00:00,136,252,14,17,701,617,84,12
7142,2022-10-25 14:00:00,146,298,6,19,635,451,184,9
7143,2022-10-25 15:00:00,124,267,14,18,556,487,69,6
7144,2022-10-25 16:00:00,123,250,6,15,706,535,171,9
7145,2022-10-25 17:00:00,145,287,11,18,524,448,76,9
7146,2022-10-25 18:00:00,140,289,6,11,560,457,103,6
7147,2022-10-25 19:00:00,148,293,6,11,611,541,70,6
7148,2022-10-25 20:00:00,120,266,14,13,608,460,148,6
7149,2022-10-25 21:00:00,145,254,13,10,761,575,186,7
7150,2022-10-25 22:00:00,122,264,11,15,712,593,119,7
7151,2022-10-25 23:00:00,146,298,9,19,501,424,77,10
7152,2022-10-26 00:00:00,135,255,10,11,674,586,88,12
7153,2022-10-26 01:00:00,128,254,10,15,672,516,156,8
7154,2022-10-26 02:00:00,138,290,12,15,768,641,127,7
7155,2022-10-26 03:00:00,137,262,10,13,791,596,195,10
7156,2022-10-26 04:00:00,126,289,7,16,516,442,74,14
7157,2022-10-26 05:00:00,142,250,14,12,666,511,155,12
7158,2022-10-26 06:00:00,146,255,7,16,750,612,138,5
7159,2022-10-26 07:00:00,136,280,7,19,745,565,180,13
7160,2022-10-26 08:00:00,123,298,12,15,789,663,126,5
7161,2022-10-26 09:00:00,132,250,6,12,660,557,103,11
7162,2022-10-26 10:00:00,124,281,11,17,707,614,93,12
7163,2022-10-26 11:00:00,120,276,12,15,622,473,149,6
7164,2022-10-26 12:00:00,142,251,10,18,685,493,192,10
7165,2022-10-26 13:00:00,133,274,12,12,671,534,137,14
7166,2022-10-26 14:00:00,136,291,7,10,661,507,154,5
7167,2022-10-26 15:00:00,137,271,8,14,606,502,104,10
7168,2022-10-26 16:00:00,129,272,13,11,531,396,135,10
7169,2022-10-26 17:00:00,125,260,9,16,714,525,189,9
7170,2022-10-26 18:00:00,127,259,7,19,787,658,129,11
7171,2022-10-26 19:00:00,132,285,11,19,649,580,69,8
7172,2022-10-26 20:00:00,139,261,12,15,611,547,64,14
7173,2022-10-26 21:00:00,136,293,12,13,686,548,138,9
7174,2022-10-26 22:00:00,148,253,12,16,695,495,200,7
7175,2022-10-26 23:00:00,138,299,11,13,541,382,159,12
7176,2022-10-27 00:00:00,136,292,8,18,516,397,119,13
7177,2022-10-27 01:00:00,149,267,12,10,717,622,95,8
7178,2022-10-27 02:00:00,121,285,6,14,544,475,69,9
7179,2022-10-27 03:00:00,138,250,6,18,716,608,108,13
7180,2022-10-27 04:00:00,121,280,7,13,773,574,199,6
7181,2022-10-27 05:00:00,125,286,13,18,792,645,147,9
7182,2022-10-27 06:00:00,145,283,6,10,502,414,88,8
7183,2022-10-27 07:00:00,145,291,14,19,731,520,211,8
7184,2022-10-27 08:00:00,147,272,13,14,686,548,138,6
7185,2022-10-27 09:00:00,120,276,14,18,560,441,119,6
7186,2022-10-27 10:00:00,148,292,9,13,611,535,76,10
7187,2022-10-27 11:00:00,145,280,10,12,516,408,108,13
7188,2022-10-27 12:00:00,120,276,9,11,708,596,112,5
7189,2022-10-27 13:00:00,138,256,11,19,770,578,192,6
7190,2022-10-27 14:00:00,129,268,8,16,581,491,90,8
7191,2022-10-27 15:00:00,148,290,10,18,784,589,195,13
7192,2022-10-27 16:00:00,120,252,9,10,657,460,197,13
7193,2022-10-27 17:00:00,132,255,13,17,782,660,122,6
7194,2022-10-27 18:00:00,145,270,5,13,694,526,168,6
7195,2022-10-27 19:00:00,143,269,14,12,776,623,153,12
7196,2022-10-27 20:00:00,131,276,7,13,506,381,125,6
7197,2022-10-27 21:00:00,144,251,6,16,798,689,109,14
7198,2022-10-27 22:00:00,142,291,8,17,693,533,160,9
7199,2022-10-27 23:00:00,125,267,14,16,514,433,81,12
7200,2022-10-28 00:00:00,138,285,14,13,656,581,75,14
7201,2022-10-28 01:00:00,147,268,14,19,567,469,98,12
7202,2022-10-28 02:00:00,141,285,10,14,609,491,118,7
7203,2022-10-28 03:00:00,142,282,12,17,770,570,200,5
7204,2022-10-28 04:00:00,125,298,8,13,545,453,92,8
7205,2022-10-28 05:00:00,144,266,12,13,768,566,202,6
7206,2022-10-28 06:00:00,120,278,14,10,711,514,197,14
7207,2022-10-28 07:00:00,139,254,14,15,672,555,117,14
7208,2022-10-28 08:00:00,124,293,6,11,727,536,191,11
7209,2022-10-28 09:00:00,136,285,12,19,743,602,141,10
7210,2022-10-28 10:00:00,122,280,11,14,659,550,109,9
7211,2022-10-28 11:00:00,130,277,11,14,659,510,149,12
7212,2022-10-28 12:00:00,129,263,12,16,752,605,147,12
7213,2022-10-28 13:00:00,121,290,14,18,726,525,201,12
7214,2022-10-28 14:00:00,144,250,6,17,761,557,204,7
7215,2022-10-28 15:00:00,129,274,14,17,676,525,151,12
7216,2022-10-28 16:00:00,123,280,5,12,662,540,122,8
7217,2022-10-28 17:00:00,134,253,13,12,780,553,227,13
7218,2022-10-28 18:00:00,127,284,10,13,720,554,166,8
7219,2022-10-28 19:00:00,142,274,10,10,696,505,191,9
7220,2022-10-28 20:00:00,149,299,13,13,530,377,153,7
7221,2022-10-28 21:00:00,123,279,9,11,640,531,109,7
7222,2022-10-28 22:00:00,124,276,5,13,549,489,60,6
7223,2022-10-28 23:00:00,132,275,5,18,722,517,205,8
7224,2022-10-29 00:00:00,128,285,10,16,689,584,105,13
7225,2022-10-29 01:00:00,120,274,9,19,634,491,143,12
7226,2022-10-29 02:00:00,142,296,13,13,536,409,127,6
7227,2022-10-29 03:00:00,123,296,5,12,598,429,169,9
7228,2022-10-29 04:00:00,140,292,12,14,724,531,193,8
7229,2022-10-29 05:00:00,147,284,6,17,571,433,138,9
7230,2022-10-29 06:00:00,142,265,5,14,592,432,160,14
7231,2022-10-29 07:00:00,132,262,8,14,573,463,110,10
7232,2022-10-29 08:00:00,144,253,9,12,535,376,159,14
7233,2022-10-29 09:00:00,132,251,10,17,767,594,173,8
7234,2022-10-29 10:00:00,130,279,11,15,632,561,71,9
7235,2022-10-29 11:00:00,145,272,11,18,737,535,202,5
7236,2022-10-29 12:00:00,144,267,6,11,634,547,87,11
7237,2022-10-29 13:00:00,142,274,5,14,588,497,91,8
7238,2022-10-29 14:00:00,126,268,7,11,731,568,163,7
7239,2022-10-29 15:00:00,146,282,9,17,708,615,93,10
7240,2022-10-29 16:00:00,147,296,13,19,500,354,146,9
7241,2022-10-29 17:00:00,130,287,10,18,530,394,136,5
7242,2022-10-29 18:00:00,144,284,13,11,559,495,64,14
7243,2022-10-29 19:00:00,123,270,14,13,620,490,130,7
7244,2022-10-29 20:00:00,130,254,10,12,723,619,104,11
7245,2022-10-29 21:00:00,146,293,10,15,657,505,152,8
7246,2022-10-29 22:00:00,137,261,9,14,743,614,129,14
7247,2022-10-29 23:00:00,123,257,12,15,671,570,101,11
7248,2022-10-30 00:00:00,137,260,7,14,772,582,190,12
7249,2022-10-30 01:00:00,135,296,10,16,700,609,91,11
7250,2022-10-30 02:00:00,128,269,5,10,522,432,90,5
7251,2022-10-30 03:00:00,137,290,6,13,611,497,114,11
7252,2022-10-30 04:00:00,145,263,5,16,630,479,151,9
7253,2022-10-30 05:00:00,137,263,8,14,531,454,77,7
7254,2022-10-30 06:00:00,125,295,10,14,639,451,188,11
7255,2022-10-30 07:00:00,123,295,10,10,757,648,109,7
7256,2022-10-30 08:00:00,131,260,11,12,570,416,154,6
7257,2022-10-30 09:00:00,135,262,12,16,697,573,124,12
7258,2022-10-30 10:00:00,148,293,5,12,784,563,221,14
7259,2022-10-30 11:00:00,138,285,8,15,669,533,136,8
7260,2022-10-30 12:00:00,140,281,8,10,523,392,131,5
7261,2022-10-30 13:00:00,147,276,6,12,761,670,91,7
7262,2022-10-30 14:00:00,139,258,6,19,666,496,170,6
7263,2022-10-30 15:00:00,139,262,12,18,676,565,111,12
7264,2022-10-30 16:00:00,147,268,13,11,762,641,121,10
7265,2022-10-30 17:00:00,140,270,13,11,667,489,178,10
7266,2022-10-30 18:00:00,143,258,8,17,596,440,156,13
7267,2022-10-30 19:00:00,128,264,10,19,711,600,111,11
7268,2022-10-30 20:00:00,141,293,10,15,597,509,88,7
7269,2022-10-30 21:00:00,141,286,12,18,743,569,174,12
7270,2022-10-30 22:00:00,131,265,11,14,747,580,167,8
7271,2022-10-30 23:00:00,147,277,7,18,506,396,110,5
7272,2022-10-31 00:00:00,149,254,13,17,783,695,88,11
7273,2022-10-31 01:00:00,120,279,7,17,740,628,112,6
7274,2022-10-31 02:00:00,130,277,9,13,550,481,69,10
7275,2022-10-31 03:00:00,132,291,11,15,790,608,182,13
7276,2022-10-31 04:00:00,140,265,7,13,677,497,180,10
7277,2022-10-31 05:00:00,135,251,10,13,745,648,97,11
7278,2022-10-31 06:00:00,142,275,11,10,543,482,61,12
7279,2022-10-31 07:00:00,138,290,5,17,565,440,125,10
7280,2022-10-31 08:00:00,149,292,13,11,759,566,193,8
7281,2022-10-31 09:00:00,122,277,7,18,517,425,92,12
7282,2022-10-31 10:00:00,126,288,14,12,750,552,198,5
7283,2022-10-31 11:00:00,127,283,9,18,782,571,211,5
7284,2022-10-31 12:00:00,126,288,8,19,731,570,161,7
7285,2022-10-31 13:00:00,145,292,11,10,603,490,113,6
7286,2022-10-31 14:00:00,137,275,8,13,716,562,154,11
7287,2022-10-31 15:00:00,137,277,8,14,591,444,147,5
7288,2022-10-31 16:00:00,133,273,7,13,713,582,131,5
7289,2022-10-31 17:00:00,131,263,12,10,532,432,100,8
7290,2022-10-31 18:00:00,127,253,5,10,668,545,123,5
7291,2022-10-31 19:00:00,120,258,8,18,783,623,160,14
7292,2022-10-31 20:00:00,122,256,10,10,608,515,93,12
7293,2022-10-31 21:00:00,125,293,11,10,707,633,74,6
7294,2022-10-31 22:00:00,134,277,10,14,769,577,192,5
7295,2022-10-31 23:00:00,140,255,8,10,645,562,83,8
7296,2022-11-01 00:00:00,120,267,8,18,522,405,117,9
7297,2022-11-01 01:00:00,120,281,8,18,762,539,223,11
7298,2022-11-01 02:00:00,143,256,10,13,563,463,100,8
7299,2022-11-01 03:00:00,140,282,10,19,624,560,64,9
7300,2022-11-01 04:00:00,123,294,14,17,615,481,134,10
7301,2022-11-01 05:00:00,145,263,11,18,576,434,142,6
7302,2022-11-01 06:00:00,144,253,13,18,721,558,163,9
7303,2022-11-01 07:00:00,146,298,14,11,500,412,88,13
7304,2022-11-01 08:00:00,136,281,7,18,520,440,80,9
7305,2022-11-01 09:00:00,149,250,8,11,585,490,95,8
7306,2022-11-01 10:00:00,149,290,6,13,568,423,145,13
7307,2022-11-01 11:00:00,129,256,10,15,569,455,114,6
7308,2022-11-01 12:00:00,134,284,7,17,571,406,165,11
7309,2022-11-01 13:00:00,121,259,5,12,715,607,108,9
7310,2022-11-01 14:00:00,129,251,14,10,782,564,218,11
7311,2022-11-01 15:00:00,131,250,8,19,589,467,122,14
7312,2022-11-01 16:00:00,132,298,5,15,500,374,126,11
7313,2022-11-01 17:00:00,124,268,8,17,703,520,183,9
7314,2022-11-01 18:00:00,137,278,14,19,513,394,119,9
7315,2022-11-01 19:00:00,132,297,12,13,617,488,129,7
7316,2022-11-01 20:00:00,128,258,12,12,535,436,99,14
7317,2022-11-01 21:00:00,143,299,9,17,632,461,171,5
7318,2022-11-01 22:00:00,138,284,6,15,651,549,102,10
7319,2022-11-01 23:00:00,126,264,11,14,566,402,164,7
7320,2022-11-02 00:00:00,144,263,9,13,619,513,106,7
7321,2022-11-02 01:00:00,131,273,9,11,787,561,226,9
7322,2022-11-02 02:00:00,123,254,7,18,746,587,159,7
7323,2022-11-02 03:00:00,145,250,7,10,599,515,84,13
7324,2022-11-02 04:00:00,121,284,14,14,576,499,77,13
7325,2022-11-02 05:00:00,148,289,10,16,520,465,55,7
7326,2022-11-02 06:00:00,123,257,14,19,565,466,99,8
7327,2022-11-02 07:00:00,146,267,14,13,685,550,135,11
7328,2022-11-02 08:00:00,144,272,9,19,504,376,128,7
7329,2022-11-02 09:00:00,140,295,6,17,696,497,199,8
7330,2022-11-02 10:00:00,149,274,10,18,604,472,132,7
7331,2022-11-02 11:00:00,143,281,11,15,514,398,116,9
7332,2022-11-02 12:00:00,138,285,12,13,714,570,144,7
7333,2022-11-02 13:00:00,141,253,12,15,687,557,130,6
7334,2022-11-02 14:00:00,130,272,5,14,644,525,119,8
7335,2022-11-02 15:00:00,127,296,13,18,793,582,211,7
7336,2022-11-02 16:00:00,145,268,5,11,712,566,146,6
7337,2022-11-02 17:00:00,142,281,12,15,762,549,213,7
7338,2022-11-02 18:00:00,134,287,9,10,744,530,214,6
7339,2022-11-02 19:00:00,121,295,9,17,736,519,217,8
7340,2022-11-02 20:00:00,133,272,13,15,622,553,69,5
7341,2022-11-02 21:00:00,137,251,8,16,736,656,80,14
7342,2022-11-02 22:00:00,139,252,10,14,724,616,108,13
7343,2022-11-02 23:00:00,140,278,13,16,739,611,128,5
7344,2022-11-03 00:00:00,130,275,9,13,657,469,188,6
7345,2022-11-03 01:00:00,146,292,6,13,549,488,61,9
7346,2022-11-03 02:00:00,125,251,12,13,680,493,187,13
7347,2022-11-03 03:00:00,131,295,12,15,540,415,125,12
7348,2022-11-03 04:00:00,147,263,10,13,621,458,163,9
7349,2022-11-03 05:00:00,135,277,14,19,696,611,85,10
7350,2022-11-03 06:00:00,139,292,10,17,589,467,122,12
7351,2022-11-03 07:00:00,125,296,5,18,555,442,113,12
7352,2022-11-03 08:00:00,122,257,14,13,672,536,136,9
7353,2022-11-03 09:00:00,139,294,14,16,665,524,141,12
7354,2022-11-03 10:00:00,129,273,12,14,638,513,125,14
7355,2022-11-03 11:00:00,131,292,9,13,674,547,127,8
7356,2022-11-03 12:00:00,128,271,9,11,538,403,135,13
7357,2022-11-03 13:00:00,140,254,8,13,764,618,146,13
7358,2022-11-03 14:00:00,136,274,12,19,591,429,162,14
7359,2022-11-03 15:00:00,148,283,8,11,576,420,156,5
7360,2022-11-03 16:00:00,125,265,8,13,723,641,82,8
7361,2022-11-03 17:00:00,145,255,10,14,701,559,142,8
7362,2022-11-03 18:00:00,127,285,13,17,732,541,191,5
7363,2022-11-03 19:00:00,142,295,8,12,797,568,229,10
7364,2022-11-03 20:00:00,131,295,6,15,774,648,126,10
7365,2022-11-03 21:00:00,146,292,5,13,674,556,118,8
7366,2022-11-03 22:00:00,129,259,13,12,581,509,72,7
7367,2022-11-03 23:00:00,126,295,8,12,691,536,155,10
7368,2022-11-04 00:00:00,125,260,6,17,781,688,93,13
7369,2022-11-04 01:00:00,127,295,10,11,509,428,81,14
7370,2022-11-04 02:00:00,133,293,11,11,604,509,95,13
7371,2022-11-04 03:00:00,127,263,13,16,680,541,139,9
7372,2022-11-04 04:00:00,120,277,13,10,654,567,87,7
7373,2022-11-04 05:00:00,131,287,6,16,630,514,116,13
7374,2022-11-04 06:00:00,145,250,12,12,666,516,150,5
7375,2022-11-04 07:00:00,139,268,8,10,530,468,62,11
7376,2022-11-04 08:00:00,147,283,14,18,771,671,100,12
7377,2022-11-04 09:00:00,126,290,10,17,681,585,96,13
7378,2022-11-04 10:00:00,142,296,5,15,687,498,189,7
7379,2022-11-04 11:00:00,130,271,6,13,745,525,220,5
7380,2022-11-04 12:00:00,147,272,9,18,716,512,204,5
7381,2022-11-04 13:00:00,132,294,11,10,580,407,173,6
7382,2022-11-04 14:00:00,136,295,11,13,697,599,98,10
7383,2022-11-04 15:00:00,147,272,13,18,655,572,83,6
7384,2022-11-04 16:00:00,121,267,10,13,736,544,192,11
7385,2022-11-04 17:00:00,137,259,13,12,584,490,94,9
7386,2022-11-04 18:00:00,148,267,8,12,712,564,148,14
7387,2022-11-04 19:00:00,143,263,10,14,634,446,188,8
7388,2022-11-04 20:00:00,127,278,9,10,747,536,211,5
7389,2022-11-04 21:00:00,148,280,13,14,735,575,160,14
7390,2022-11-04 22:00:00,120,296,9,19,766,631,135,7
7391,2022-11-04 23:00:00,121,293,12,19,552,389,163,5
7392,2022-11-05 00:00:00,127,288,14,11,505,445,60,8
7393,2022-11-05 01:00:00,126,268,12,16,784,663,121,6
7394,2022-11-05 02:00:00,144,299,11,19,632,537,95,8
7395,2022-11-05 03:00:00,120,280,12,14,636,526,110,7
7396,2022-11-05 04:00:00,147,276,9,14,549,408,141,5
7397,2022-11-05 05:00:00,133,250,7,10,681,515,166,8
7398,2022-11-05 06:00:00,120,254,9,10,688,502,186,11
7399,2022-11-05 07:00:00,141,268,12,15,598,419,179,8
7400,2022-11-05 08:00:00,143,254,5,15,716,623,93,6
7401,2022-11-05 09:00:00,133,269,6,17,627,534,93,5
7402,2022-11-05 10:00:00,134,250,12,19,552,419,133,9
7403,2022-11-05 11:00:00,145,288,13,16,770,612,158,7
7404,2022-11-05 12:00:00,141,291,11,12,622,555,67,13
7405,2022-11-05 13:00:00,146,270,9,14,772,555,217,14
7406,2022-11-05 14:00:00,129,260,8,18,537,388,149,14
7407,2022-11-05 15:00:00,130,287,9,14,681,605,76,6
7408,2022-11-05 16:00:00,133,258,10,14,573,508,65,11
7409,2022-11-05 17:00:00,131,263,8,10,651,470,181,9
7410,2022-11-05 18:00:00,124,292,7,14,716,603,113,11
7411,2022-11-05 19:00:00,120,267,12,17,735,539,196,11
7412,2022-11-05 20:00:00,137,281,8,17,645,512,133,7
7413,2022-11-05 21:00:00,128,257,13,18,505,403,102,6
7414,2022-11-05 22:00:00,139,260,9,16,682,484,198,7
7415,2022-11-05 23:00:00,142,299,11,19,532,470,62,10
7416,2022-11-06 00:00:00,121,286,5,15,531,470,61,10
7417,2022-11-06 01:00:00,133,291,9,15,669,581,88,9
7418,2022-11-06 02:00:00,136,299,11,15,576,468,108,5
7419,2022-11-06 03:00:00,139,268,10,15,728,599,129,13
7420,2022-11-06 04:00:00,128,257,7,15,538,379,159,5
7421,2022-11-06 05:00:00,143,284,12,17,682,597,85,14
7422,2022-11-06 06:00:00,146,260,12,17,502,391,111,10
7423,2022-11-06 07:00:00,129,298,6,11,571,449,122,7
7424,2022-11-06 08:00:00,135,270,10,10,665,580,85,14
7425,2022-11-06 09:00:00,141,292,9,16,539,422,117,8
7426,2022-11-06 10:00:00,138,289,10,11,712,597,115,7
7427,2022-11-06 11:00:00,148,293,9,10,739,531,208,14
7428,2022-11-06 12:00:00,122,293,9,11,787,567,220,13
7429,2022-11-06 13:00:00,133,283,12,18,719,526,193,10
7430,2022-11-06 14:00:00,127,256,7,16,533,457,76,10
7431,2022-11-06 15:00:00,138,251,5,15,562,433,129,5
7432,2022-11-06 16:00:00,148,280,5,10,749,561,188,9
7433,2022-11-06 17:00:00,125,274,7,19,581,464,117,12
7434,2022-11-06 18:00:00,149,293,9,11,594,500,94,12
7435,2022-11-06 19:00:00,134,278,14,16,627,486,141,8
7436,2022-11-06 20:00:00,127,284,8,12,558,479,79,13
7437,2022-11-06 21:00:00,140,273,6,19,522,403,119,5
7438,2022-11-06 22:00:00,138,276,8,13,548,393,155,10
7439,2022-11-06 23:00:00,132,278,7,11,684,561,123,8
7440,2022-11-07 00:00:00,120,261,9,16,571,430,141,9
7441,2022-11-07 01:00:00,126,278,12,16,794,654,140,12
7442,2022-11-07 02:00:00,123,293,13,18,632,493,139,12
7443,2022-11-07 03:00:00,124,299,7,12,611,453,158,5
7444,2022-11-07 04:00:00,139,278,5,18,632,539,93,13
7445,2022-11-07 05:00:00,128,253,7,16,667,567,100,10
7446,2022-11-07 06:00:00,146,250,12,18,768,593,175,10
7447,2022-11-07 07:00:00,149,292,10,18,745,574,171,10
7448,2022-11-07 08:00:00,148,292,7,18,772,671,101,7
7449,2022-11-07 09:00:00,124,299,7,10,694,491,203,5
7450,2022-11-07 10:00:00,135,297,13,17,748,638,110,13
7451,2022-11-07 11:00:00,129,274,10,19,603,440,163,5
7452,2022-11-07 12:00:00,141,278,12,12,726,643,83,7
7453,2022-11-07 13:00:00,134,299,10,11,630,443,187,9
7454,2022-11-07 14:00:00,149,272,6,10,660,572,88,9
7455,2022-11-07 15:00:00,123,262,12,17,780,600,180,14
7456,2022-11-07 16:00:00,149,286,7,17,615,485,130,14
7457,2022-11-07 17:00:00,127,265,11,13,608,462,146,10
7458,2022-11-07 18:00:00,124,253,6,17,531,378,153,5
7459,2022-11-07 19:00:00,127,256,6,19,662,587,75,5
7460,2022-11-07 20:00:00,146,268,5,10,623,468,155,6
7461,2022-11-07 21:00:00,132,254,12,10,645,547,98,6
7462,2022-11-07 22:00:00,141,294,8,13,726,575,151,9
7463,2022-11-07 23:00:00,120,252,8,13,738,560,178,12
7464,2022-11-08 00:00:00,146,290,11,18,736,557,179,6
7465,2022-11-08 01:00:00,147,261,5,15,570,510,60,6
7466,2022-11-08 02:00:00,134,278,12,10,649,491,158,13
7467,2022-11-08 03:00:00,140,276,10,11,667,491,176,14
7468,2022-11-08 04:00:00,137,279,8,13,787,698,89,13
7469,2022-11-08 05:00:00,126,268,11,18,533,433,100,13
7470,2022-11-08 06:00:00,142,278,13,10,536,416,120,10
7471,2022-11-08 07:00:00,132,281,6,14,763,628,135,12
7472,2022-11-08 08:00:00,148,283,12,11,561,462,99,6
7473,2022-11-08 09:00:00,133,259,14,11,757,675,82,8
7474,2022-11-08 10:00:00,147,278,12,18,637,538,99,6
7475,2022-11-08 11:00:00,135,261,10,13,599,476,123,10
7476,2022-11-08 12:00:00,146,271,6,13,573,498,75,9
7477,2022-11-08 13:00:00,132,273,6,12,589,445,144,9
7478,2022-11-08 14:00:00,142,270,14,13,574,512,62,10
7479,2022-11-08 15:00:00,138,255,7,14,600,491,109,11
7480,2022-11-08 16:00:00,148,273,9,11,728,653,75,9
7481,2022-11-08 17:00:00,143,278,12,15,608,494,114,6
7482,2022-11-08 18:00:00,121,270,12,12,748,537,211,5
7483,2022-11-08 19:00:00,145,296,12,12,765,591,174,5
7484,2022-11-08 20:00:00,146,257,8,18,681,504,177,12
7485,2022-11-08 21:00:00,146,285,9,19,653,479,174,14
7486,2022-11-08 22:00:00,127,261,12,12,519,398,121,5
7487,2022-11-08 23:00:00,149,277,5,12,615,470,145,10
7488,2022-11-09 00:00:00,133,257,13,15,607,521,86,9
7489,2022-11-09 01:00:00,142,286,8,13,568,458,110,9
7490,2022-11-09 02:00:00,140,254,6,14,733,524,209,12
7491,2022-11-09 03:00:00,125,296,10,11,663,579,84,8
7492,2022-11-09 04:00:00,124,275,12,17,505,372,133,9
7493,2022-11-09 05:00:00,146,295,6,13,684,612,72,10
7494,2022-11-09 06:00:00,126,289,5,13,704,541,163,12
7495,2022-11-09 07:00:00,125,266,12,15,796,690,106,12
7496,2022-11-09 08:00:00,149,292,9,10,696,556,140,11
7497,2022-11-09 09:00:00,144,284,10,11,615,514,101,5
7498,2022-11-09 10:00:00,144,295,14,16,727,513,214,9
7499,2022-11-09 11:00:00,149,288,13,10,586,496,90,6
7500,2022-11-09 12:00:00,131,276,8,13,649,493,156,7
7501,2022-11-09 13:00:00,133,269,14,18,640,569,71,13
7502,2022-11-09 14:00:00,137,283,7,19,547,431,116,7
7503,2022-11-09 15:00:00,135,252,13,19,545,409,136,13
7504,2022-11-09 16:00:00,138,271,12,13,735,622,113,5
7505,2022-11-09 17:00:00,122,264,7,19,798,710,88,8
7506,2022-11-09 18:00:00,140,290,9,10,617,532,85,7
7507,2022-11-09 19:00:00,133,297,6,13,543,462,81,13
7508,2022-11-09 20:00:00,121,275,13,13,650,538,112,8
7509,2022-11-09 21:00:00,139,264,11,12,631,543,88,13
7510,2022-11-09 22:00:00,149,290,11,11,675,522,153,8
7511,2022-11-09 23:00:00,133,273,14,17,675,578,97,12
7512,2022-11-10 00:00:00,147,291,14,10,723,521,202,12
7513,2022-11-10 01:00:00,135,299,7,17,705,500,205,10
7514,2022-11-10 02:00:00,138,277,5,16,796,644,152,10
7515,2022-11-10 03:00:00,144,275,5,10,593,526,67,6
7516,2022-11-10 04:00:00,148,299,13,15,657,494,163,12
7517,2022-11-10 05:00:00,125,299,13,15,789,625,164,8
7518,2022-11-10 06:00:00,129,293,6,14,562,418,144,12
7519,2022-11-10 07:00:00,128,277,13,17,684,527,157,9
7520,2022-11-10 08:00:00,132,269,14,19,615,525,90,9
7521,2022-11-10 09:00:00,148,260,11,18,686,509,177,13
7522,2022-11-10 10:00:00,137,289,6,19,693,582,111,8
7523,2022-11-10 11:00:00,121,285,9,13,782,566,216,9
7524,2022-11-10 12:00:00,148,289,9,12,777,586,191,9
7525,2022-11-10 13:00:00,141,250,14,11,775,542,233,10
7526,2022-11-10 14:00:00,128,264,12,10,562,449,113,6
7527,2022-11-10 15:00:00,120,283,6,19,539,442,97,10
7528,2022-11-10 16:00:00,145,268,11,15,660,556,104,14
7529,2022-11-10 17:00:00,122,299,6,17,539,465,74,7
7530,2022-11-10 18:00:00,147,255,10,16,603,528,75,13
7531,2022-11-10 19:00:00,124,281,11,19,645,498,147,7
7532,2022-11-10 20:00:00,134,279,9,19,753,618,135,9
7533,2022-11-10 21:00:00,137,284,12,10,786,638,148,11
7534,2022-11-10 22:00:00,140,284,10,14,516,435,81,8
7535,2022-11-10 23:00:00,129,270,7,13,588,435,153,11
7536,2022-11-11 00:00:00,127,286,9,15,688,521,167,13
7537,2022-11-11 01:00:00,148,258,12,15,523,416,107,6
7538,2022-11-11 02:00:00,130,269,6,16,743,541,202,5
7539,2022-11-11 03:00:00,137,260,9,19,731,514,217,10
7540,2022-11-11 04:00:00,120,279,5,19,605,441,164,8
7541,2022-11-11 05:00:00,140,283,7,15,516,427,89,11
7542,2022-11-11 06:00:00,142,251,8,11,740,611,129,10
7543,2022-11-11 07:00:00,122,263,9,19,729,585,144,13
7544,2022-11-11 08:00:00,124,283,5,16,663,523,140,11
7545,2022-11-11 09:00:00,124,290,10,13,767,587,180,9
7546,2022-11-11 10:00:00,125,250,14,14,620,480,140,7
7547,2022-11-11 11:00:00,131,264,9,16,526,437,89,7
7548,2022-11-11 12:00:00,132,284,5,16,798,587,211,5
7549,2022-11-11 13:00:00,143,291,8,13,510,377,133,10
7550,2022-11-11 14:00:00,135,275,10,15,561,419,142,7
7551,2022-11-11 15:00:00,125,264,14,15,787,672,115,6
7552,2022-11-11 16:00:00,145,270,5,18,659,587,72,6
7553,2022-11-11 17:00:00,131,278,11,19,643,566,77,13
7554,2022-11-11 18:00:00,140,273,10,11,642,490,152,7
7555,2022-11-11 19:00:00,126,260,10,11,675,583,92,13
7556,2022-11-11 20:00:00,135,297,6,18,697,607,90,14
7557,2022-11-11 21:00:00,135,262,12,16,553,463,90,7
7558,2022-11-11 22:00:00,147,295,14,18,559,401,158,7
7559,2022-11-11 23:00:00,123,251,7,17,712,520,192,5
7560,2022-11-12 00:00:00,141,255,13,14,726,509,217,6
7561,2022-11-12 01:00:00,132,253,7,15,731,580,151,6
7562,2022-11-12 02:00:00,144,294,9,18,611,535,76,5
7563,2022-11-12 03:00:00,130,283,8,15,506,368,138,13
7564,2022-11-12 04:00:00,134,291,12,11,502,442,60,10
7565,2022-11-12 05:00:00,131,254,14,14,558,465,93,13
7566,2022-11-12 06:00:00,132,289,14,10,545,401,144,5
7567,2022-11-12 07:00:00,148,285,13,10,659,554,105,12
7568,2022-11-12 08:00:00,126,291,14,11,601,428,173,12
7569,2022-11-12 09:00:00,137,268,9,17,779,630,149,14
7570,2022-11-12 10:00:00,127,260,13,12,703,597,106,8
7571,2022-11-12 11:00:00,120,296,7,18,775,635,140,13
7572,2022-11-12 12:00:00,121,283,6,10,549,392,157,9
7573,2022-11-12 13:00:00,141,281,7,15,676,486,190,10
7574,2022-11-12 14:00:00,145,261,5,12,545,413,132,7
7575,2022-11-12 15:00:00,144,295,9,13,509,389,120,8
7576,2022-11-12 16:00:00,128,289,5,12,586,446,140,14
7577,2022-11-12 17:00:00,149,295,8,18,542,392,150,9
7578,2022-11-12 18:00:00,144,286,13,17,663,569,94,13
7579,2022-11-12 19:00:00,140,262,11,16,604,515,89,8
7580,2022-11-12 20:00:00,121,275,11,19,533,415,118,12
7581,2022-11-12 21:00:00,132,277,6,19,679,569,110,10
7582,2022-11-12 22:00:00,142,289,5,10,758,576,182,10
7583,2022-11-12 23:00:00,143,298,10,14,648,516,132,5
7584,2022-11-13 00:00:00,135,281,6,12,687,512,175,14
7585,2022-11-13 01:00:00,141,272,14,17,738,587,151,13
7586,2022-11-13 02:00:00,141,250,14,12,663,477,186,14
7587,2022-11-13 03:00:00,132,253,8,19,711,635,76,10
7588,2022-11-13 04:00:00,138,256,12,12,724,540,184,11
7589,2022-11-13 05:00:00,120,294,10,16,565,425,140,14
7590,2022-11-13 06:00:00,124,285,10,19,510,393,117,8
7591,2022-11-13 07:00:00,132,262,12,12,600,539,61,13
7592,2022-11-13 08:00:00,130,270,8,13,519,442,77,12
7593,2022-11-13 09:00:00,126,278,13,18,612,527,85,5
7594,2022-11-13 10:00:00,124,254,8,16,555,391,164,12
7595,2022-11-13 11:00:00,148,256,5,13,636,452,184,5
7596,2022-11-13 12:00:00,126,261,11,18,658,545,113,5
7597,2022-11-13 13:00:00,125,299,5,14,661,557,104,11
7598,2022-11-13 14:00:00,131,271,9,15,561,395,166,5
7599,2022-11-13 15:00:00,148,280,12,19,610,495,115,11
7600,2022-11-13 16:00:00,146,274,13,12,765,571,194,12
7601,2022-11-13 17:00:00,120,293,7,11,659,466,193,7
7602,2022-11-13 18:00:00,132,281,7,11,697,495,202,13
7603,2022-11-13 19:00:00,149,291,10,18,592,528,64,9
7604,2022-11-13 20:00:00,135,285,9,15,742,565,177,8
7605,2022-11-13 21:00:00,121,289,8,12,720,554,166,12
7606,2022-11-13 22:00:00,131,261,12,18,684,514,170,14
7607,2022-11-13 23:00:00,122,298,14,18,580,429,151,14
7608,2022-11-14 00:00:00,126,276,8,12,747,607,140,11
7609,2022-11-14 01:00:00,139,251,10,13,647,578,69,10
7610,2022-11-14 02:00:00,149,251,10,13,693,594,99,13
7611,2022-11-14 03:00:00,122,272,11,17,596,505,91,8
7612,2022-11-14 04:00:00,133,272,7,18,627,480,147,6
7613,2022-11-14 05:00:00,124,278,8,18,553,399,154,13
7614,2022-11-14 06:00:00,138,250,14,15,539,471,68,9
7615,2022-11-14 07:00:00,123,281,8,10,632,568,64,11
7616,2022-11-14 08:00:00,128,296,9,13,573,474,99,9
7617,2022-11-14 09:00:00,125,295,8,18,696,619,77,14
7618,2022-11-14 10:00:00,138,284,14,14,583,517,66,7
7619,2022-11-14 11:00:00,120,285,7,19,576,451,125,14
7620,2022-11-14 12:00:00,148,284,11,18,707,613,94,13
7621,2022-11-14 13:00:00,124,272,12,13,572,425,147,12
7622,2022-11-14 14:00:00,134,263,5,11,749,603,146,9
7623,2022-11-14 15:00:00,148,251,14,15,760,644,116,6
7624,2022-11-14 16:00:00,146,265,13,14,612,521,91,13
7625,2022-11-14 17:00:00,121,268,9,15,658,520,138,13
7626,2022-11-14 18:00:00,143,268,11,13,644,547,97,8
7627,2022-11-14 19:00:00,137,283,5,14,668,584,84,7
7628,2022-11-14 20:00:00,130,270,9,11,690,518,172,8
7629,2022-11-14 21:00:00,121,279,12,13,718,584,134,13
7630,2022-11-14 22:00:00,133,265,14,12,530,458,72,7
7631,2022-11-14 23:00:00,123,291,14,10,649,574,75,6
7632,2022-11-15 00:00:00,145,293,8,12,610,508,102,9
7633,2022-11-15 01:00:00,126,250,6,18,792,705,87,9
7634,2022-11-15 02:00:00,143,265,7,17,673,475,198,10
7635,2022-11-15 03:00:00,148,260,5,10,677,584,93,5
7636,2022-11-15 04:00:00,145,250,5,10,562,399,163,14
7637,2022-11-15 05:00:00,132,251,8,10,505,363,142,13
7638,2022-11-15 06:00:00,141,289,14,19,785,671,114,14
7639,2022-11-15 07:00:00,122,294,6,10,789,578,211,11
7640,2022-11-15 08:00:00,133,257,6,19,543,390,153,8
7641,2022-11-15 09:00:00,122,261,13,13,634,444,190,14
7642,2022-11-15 10:00:00,142,278,13,11,576,424,152,5
7643,2022-11-15 11:00:00,141,251,11,17,776,623,153,12
7644,2022-11-15 12:00:00,147,279,13,19,578,507,71,9
7645,2022-11-15 13:00:00,132,250,6,18,754,647,107,9
7646,2022-11-15 14:00:00,134,293,13,18,646,498,148,7
7647,2022-11-15 15:00:00,146,255,9,17,701,605,96,9
7648,2022-11-15 16:00:00,137,272,8,12,715,619,96,11
7649,2022-11-15 17:00:00,120,252,13,10,602,505,97,9
7650,2022-11-15 18:00:00,142,250,9,19,510,390,120,12
7651,2022-11-15 19:00:00,125,271,7,18,732,634,98,14
7652,2022-11-15 20:00:00,135,286,8,17,591,476,115,12
7653,2022-11-15 21:00:00,143,290,9,15,511,445,66,5
7654,2022-11-15 22:00:00,139,273,6,15,538,420,118,13
7655,2022-11-15 23:00:00,124,284,12,13,702,584,118,6
7656,2022-11-16 00:00:00,121,291,8,18,743,593,150,8
7657,2022-11-16 01:00:00,133,279,12,15,716,600,116,10
7658,2022-11-16 02:00:00,131,289,7,16,662,548,114,13
7659,2022-11-16 03:00:00,136,271,12,17,654,582,72,14
7660,2022-11-16 04:00:00,133,269,13,18,715,578,137,11
7661,2022-11-16 05:00:00,141,273,14,16,662,505,157,12
7662,2022-11-16 06:00:00,138,270,10,18,646,493,153,10
7663,2022-11-16 07:00:00,131,251,12,10,605,463,142,10
7664,2022-11-16 08:00:00,120,262,13,16,572,494,78,14
7665,2022-11-16 09:00:00,122,289,10,14,599,485,114,14
7666,2022-11-16 10:00:00,148,278,11,13,764,653,111,11
7667,2022-11-16 11:00:00,143,281,13,11,707,511,196,6
7668,2022-11-16 12:00:00,144,282,14,13,789,617,172,7
7669,2022-11-16 13:00:00,142,289,11,18,703,579,124,12
7670,2022-11-16 14:00:00,128,266,7,15,525,450,75,5
7671,2022-11-16 15:00:00,133,263,10,14,746,611,135,14
7672,2022-11-16 16:00:00,137,266,12,19,680,509,171,11
7673,2022-11-16 17:00:00,149,282,11,12,595,432,163,10
7674,2022-11-16 18:00:00,141,257,11,10,683,532,151,11
7675,2022-11-16 19:00:00,135,281,14,17,506,403,103,14
7676,2022-11-16 20:00:00,137,285,8,17,787,646,141,14
7677,2022-11-16 21:00:00,131,250,10,17,550,414,136,8
7678,2022-11-16 22:00:00,131,258,14,17,627,525,102,12
7679,2022-11-16 23:00:00,128,274,9,13,741,607,134,13
7680,2022-11-17 00:00:00,130,283,12,15,553,449,104,10
7681,2022-11-17 01:00:00,141,253,8,19,555,444,111,6
7682,2022-11-17 02:00:00,134,252,7,17,734,574,160,10
7683,2022-11-17 03:00:00,141,290,10,19,513,448,65,9
7684,2022-11-17 04:00:00,147,281,8,14,642,548,94,11
7685,2022-11-17 05:00:00,133,272,5,14,723,608,115,9
7686,2022-11-17 06:00:00,123,266,8,18,568,420,148,6
7687,2022-11-17 07:00:00,131,287,7,11,620,434,186,6
7688,2022-11-17 08:00:00,120,292,8,11,592,478,114,7
7689,2022-11-17 09:00:00,149,285,9,19,704,510,194,8
7690,2022-11-17 10:00:00,130,292,14,19,767,636,131,5
7691,2022-11-17 11:00:00,122,250,14,17,709,627,82,5
7692,2022-11-17 12:00:00,141,262,8,18,659,520,139,8
7693,2022-11-17 13:00:00,127,298,9,18,738,577,161,13
7694,2022-11-17 14:00:00,145,280,14,11,530,445,85,8
7695,2022-11-17 15:00:00,125,290,9,11,563,461,102,7
7696,2022-11-17 16:00:00,138,280,13,12,727,601,126,6
7697,2022-11-17 17:00:00,127,260,6,11,670,488,182,6
7698,2022-11-17 18:00:00,124,261,5,11,529,373,156,13
7699,2022-11-17 19:00:00,136,294,6,18,584,427,157,6
7700,2022-11-17 20:00:00,129,299,6,15,638,458,180,5
7701,2022-11-17 21:00:00,147,299,10,13,750,637,113,6
7702,2022-11-17 22:00:00,145,283,6,19,615,437,178,14
7703,2022-11-17 23:00:00,135,281,9,12,589,486,103,11
7704,2022-11-18 00:00:00,139,255,9,12,684,553,131,11
7705,2022-11-18 01:00:00,121,270,7,18,664,514,150,8
7706,2022-11-18 02:00:00,126,293,11,18,601,436,165,7
7707,2022-11-18 03:00:00,124,294,7,10,666,469,197,13
7708,2022-11-18 04:00:00,135,259,8,15,688,577,111,8
7709,2022-11-18 05:00:00,121,294,6,14,618,490,128,5
7710,2022-11-18 06:00:00,120,274,10,15,654,561,93,9
7711,2022-11-18 07:00:00,121,297,13,14,521,425,96,11
7712,2022-11-18 08:00:00,138,260,11,10,527,387,140,5
7713,2022-11-18 09:00:00,127,266,5,18,746,535,211,9
7714,2022-11-18 10:00:00,147,297,10,15,520,459,61,8
7715,2022-11-18 11:00:00,147,287,7,18,616,518,98,14
7716,2022-11-18 12:00:00,124,254,10,12,677,598,79,5
7717,2022-11-18 13:00:00,135,291,9,13,547,451,96,8
7718,2022-11-18 14:00:00,143,293,13,11,577,428,149,8
7719,2022-11-18 15:00:00,132,283,9,11,534,407,127,10
7720,2022-11-18 16:00:00,149,268,13,15,639,537,102,7
7721,2022-11-18 17:00:00,123,253,6,14,595,438,157,12
7722,2022-11-18 18:00:00,144,294,5,17,663,528,135,11
7723,2022-11-18 19:00:00,143,277,7,17,558,462,96,11
7724,2022-11-18 20:00:00,120,281,13,16,596,502,94,14
7725,2022-11-18 21:00:00,135,282,9,16,606,515,91,14
7726,2022-11-18 22:00:00,149,262,14,18,655,575,80,13
7727,2022-11-18 23:00:00,120,262,6,18,644,519,125,9
7728,2022-11-19 00:00:00,129,254,12,17,518,376,142,6
7729,2022-11-19 01:00:00,121,294,5,11,638,563,75,13
7730,2022-11-19 02:00:00,136,279,10,10,512,381,131,5
7731,2022-11-19 03:00:00,127,277,12,14,586,415,171,12
7732,2022-11-19 04:00:00,128,275,10,19,749,577,172,7
7733,2022-11-19 05:00:00,133,251,5,19,694,565,129,10
7734,2022-11-19 06:00:00,129,274,5,18,534,402,132,12
7735,2022-11-19 07:00:00,131,257,7,16,565,483,82,12
7736,2022-11-19 08:00:00,138,269,12,19,606,535,71,5
7737,2022-11-19 09:00:00,131,263,12,18,672,585,87,8
7738,2022-11-19 10:00:00,133,268,8,18,727,612,115,10
7739,2022-11-19 11:00:00,145,273,8,10,771,560,211,12
7740,2022-11-19 12:00:00,136,292,6,17,707,507,200,5
7741,2022-11-19 13:00:00,121,289,12,13,702,576,126,7
7742,2022-11-19 14:00:00,124,293,7,13,790,563,227,10
7743,2022-11-19 15:00:00,133,270,9,15,703,542,161,6
7744,2022-11-19 16:00:00,121,281,9,15,794,651,143,12
7745,2022-11-19 17:00:00,135,285,8,13,576,493,83,11
7746,2022-11-19 18:00:00,148,296,12,13,752,557,195,12
7747,2022-11-19 19:00:00,138,262,9,14,735,567,168,13
7748,2022-11-19 20:00:00,145,265,11,12,525,437,88,12
7749,2022-11-19 21:00:00,129,275,7,11,769,637,132,5
7750,2022-11-19 22:00:00,123,281,9,14,765,649,116,14
7751,2022-11-19 23:00:00,131,254,14,19,577,463,114,12
7752,2022-11-20 00:00:00,121,254,13,10,521,381,140,11
7753,2022-11-20 01:00:00,137,256,7,14,527,427,100,14
7754,2022-11-20 02:00:00,149,276,11,15,560,442,118,7
7755,2022-11-20 03:00:00,123,287,9,15,575,493,82,11
7756,2022-11-20 04:00:00,138,255,9,11,610,477,133,7
7757,2022-11-20 05:00:00,149,294,10,16,788,566,222,5
7758,2022-11-20 06:00:00,147,264,8,14,581,414,167,10
7759,2022-11-20 07:00:00,139,289,7,15,722,618,104,8
7760,2022-11-20 08:00:00,145,276,7,15,688,551,137,13
7761,2022-11-20 09:00:00,127,276,13,11,548,384,164,13
7762,2022-11-20 10:00:00,120,288,5,15,537,403,134,14
7763,2022-11-20 11:00:00,120,299,6,19,715,549,166,8
7764,2022-11-20 12:00:00,141,284,6,11,529,418,111,7
7765,2022-11-20 13:00:00,136,253,13,18,760,546,214,8
7766,2022-11-20 14:00:00,142,264,7,12,692,541,151,6
7767,2022-11-20 15:00:00,129,270,14,14,671,542,129,14
7768,2022-11-20 16:00:00,123,274,5,10,711,637,74,8
7769,2022-11-20 17:00:00,141,254,8,12,727,532,195,7
7770,2022-11-20 18:00:00,121,276,6,10,730,582,148,8
7771,2022-11-20 19:00:00,137,262,12,18,697,527,170,14
7772,2022-11-20 20:00:00,134,265,13,15,706,507,199,10
7773,2022-11-20 21:00:00,124,262,11,10,692,594,98,11
7774,2022-11-20 22:00:00,125,252,6,10,667,599,68,12
7775,2022-11-20 23:00:00,128,290,7,11,660,527,133,6
7776,2022-11-21 00:00:00,149,278,12,14,524,398,126,9
7777,2022-11-21 01:00:00,131,294,14,17,785,685,100,8
7778,2022-11-21 02:00:00,147,270,8,18,638,483,155,6
7779,2022-11-21 03:00:00,139,266,10,15,711,510,201,9
7780,2022-11-21 04:00:00,136,290,5,14,734,636,98,14
7781,2022-11-21 05:00:00,125,291,9,15,691,553,138,8
7782,2022-11-21 06:00:00,133,299,13,12,692,534,158,6
7783,2022-11-21 07:00:00,148,297,8,15,798,565,233,8
7784,2022-11-21 08:00:00,132,284,11,15,733,617,116,12
7785,2022-11-21 09:00:00,147,298,6,14,743,584,159,10
7786,2022-11-21 10:00:00,124,272,6,14,769,669,100,11
7787,2022-11-21 11:00:00,120,256,9,12,524,431,93,6
7788,2022-11-21 12:00:00,128,260,8,13,726,627,99,14
7789,2022-11-21 13:00:00,142,265,6,10,753,528,225,10
7790,2022-11-21 14:00:00,148,292,11,14,622,478,144,7
7791,2022-11-21 15:00:00,148,266,9,12,602,529,73,10
7792,2022-11-21 16:00:00,126,277,6,15,575,460,115,6
7793,2022-11-21 17:00:00,128,265,6,18,733,620,113,11
7794,2022-11-21 18:00:00,131,261,7,16,518,366,152,13
7795,2022-11-21 19:00:00,139,290,13,15,775,689,86,7
7796,2022-11-21 20:00:00,130,287,11,18,583,489,94,11
7797,2022-11-21 21:00:00,145,296,12,17,623,478,145,8
7798,2022-11-21 22:00:00,139,276,12,17,733,624,109,11
7799,2022-11-21 23:00:00,120,279,12,17,622,457,165,9
7800,2022-11-22 00:00:00,149,266,10,12,776,556,220,8
7801,2022-11-22 01:00:00,122,297,14,16,569,474,95,12
7802,2022-11-22 02:00:00,122,283,9,17,781,548,233,6
7803,2022-11-22 03:00:00,145,295,13,19,551,424,127,10
7804,2022-11-22 04:00:00,144,257,6,13,679,503,176,14
7805,2022-11-22 05:00:00,125,281,10,13,527,391,136,13
7806,2022-11-22 06:00:00,131,255,11,12,756,639,117,6
7807,2022-11-22 07:00:00,120,280,5,14,507,387,120,14
7808,2022-11-22 08:00:00,147,282,8,16,531,456,75,8
7809,2022-11-22 09:00:00,131,273,14,13,736,639,97,14
7810,2022-11-22 10:00:00,125,291,12,10,736,621,115,14
7811,2022-11-22 11:00:00,123,261,13,14,687,548,139,11
7812,2022-11-22 12:00:00,125,293,12,16,657,509,148,5
7813,2022-11-22 13:00:00,126,259,8,16,516,460,56,11
7814,2022-11-22 14:00:00,149,276,11,15,500,415,85,12
7815,2022-11-22 15:00:00,135,280,5,11,681,595,86,12
7816,2022-11-22 16:00:00,134,271,5,18,632,495,137,6
7817,2022-11-22 17:00:00,148,291,6,14,578,418,160,10
7818,2022-11-22 18:00:00,144,252,8,16,663,497,166,9
7819,2022-11-22 19:00:00,148,266,5,13,581,509,72,14
7820,2022-11-22 20:00:00,124,294,11,16,741,639,102,13
7821,2022-11-22 21:00:00,135,269,9,16,707,570,137,11
7822,2022-11-22 22:00:00,134,265,10,16,539,441,98,7
7823,2022-11-22 23:00:00,133,261,14,18,694,490,204,12
7824,2022-11-23 00:00:00,144,257,5,17,533,460,73,6
7825,2022-11-23 01:00:00,126,263,5,18,586,518,68,10
7826,2022-11-23 02:00:00,147,281,8,15,718,554,164,7
7827,2022-11-23 03:00:00,148,265,9,14,561,424,137,7
7828,2022-11-23 04:00:00,142,291,5,16,789,645,144,13
7829,2022-11-23 05:00:00,138,281,9,15,778,686,92,10
7830,2022-11-23 06:00:00,134,258,5,18,622,486,136,6
7831,2022-11-23 07:00:00,121,276,5,16,511,398,113,13
7832,2022-11-23 08:00:00,142,266,12,11,728,575,153,9
7833,2022-11-23 09:00:00,137,250,12,11,621,555,66,5
7834,2022-11-23 10:00:00,121,283,7,15,738,540,198,9
7835,2022-11-23 11:00:00,129,292,8,13,515,377,138,13
7836,2022-11-23 12:00:00,120,266,10,15,666,499,167,5
7837,2022-11-23 13:00:00,141,289,5,17,511,377,134,10
7838,2022-11-23 14:00:00,142,277,8,16,698,576,122,9
7839,2022-11-23 15:00:00,133,287,6,12,754,543,211,6
7840,2022-11-23 16:00:00,135,266,8,15,534,446,88,9
7841,2022-11-23 17:00:00,143,295,14,19,608,439,169,10
7842,2022-11-23 18:00:00,122,296,9,11,776,670,106,8
7843,2022-11-23 19:00:00,125,295,11,15,660,549,111,13
7844,2022-11-23 20:00:00,125,286,7,18,758,656,102,9
7845,2022-11-23 21:00:00,131,297,5,16,761,613,148,5
7846,2022-11-23 22:00:00,121,272,12,15,593,430,163,7
7847,2022-11-23 23:00:00,136,268,13,16,789,632,157,10
7848,2022-11-24 00:00:00,144,271,12,19,685,556,129,12
7849,2022-11-24 01:00:00,144,270,7,17,793,677,116,9
7850,2022-11-24 02:00:00,148,266,10,11,670,554,116,6
7851,2022-11-24 03:00:00,143,269,9,19,569,440,129,12
7852,2022-11-24 04:00:00,130,266,14,11,542,463,79,11
7853,2022-11-24 05:00:00,123,263,8,10,604,430,174,11
7854,2022-11-24 06:00:00,146,252,14,19,761,622,139,12
7855,2022-11-24 07:00:00,136,299,12,16,757,619,138,10
7856,2022-11-24 08:00:00,147,287,13,16,670,544,126,13
7857,2022-11-24 09:00:00,146,280,6,17,602,443,159,12
7858,2022-11-24 10:00:00,122,294,11,10,607,444,163,5
7859,2022-11-24 11:00:00,123,269,13,12,657,559,98,11
7860,2022-11-24 12:00:00,134,259,13,18,538,391,147,5
7861,2022-11-24 13:00:00,143,258,13,17,500,426,74,6
7862,2022-11-24 14:00:00,141,264,7,13,525,457,68,10
7863,2022-11-24 15:00:00,125,285,13,16,597,468,129,7
7864,2022-11-24 16:00:00,137,287,7,12,633,472,161,9
7865,2022-11-24 17:00:00,130,283,10,14,560,413,147,5
7866,2022-11-24 18:00:00,142,289,8,10,549,435,114,7
7867,2022-11-24 19:00:00,138,291,8,18,732,613,119,14
7868,2022-11-24 20:00:00,122,257,14,14,654,577,77,12
7869,2022-11-24 21:00:00,133,292,12,16,658,496,162,5
7870,2022-11-24 22:00:00,137,253,6,13,796,704,92,11
7871,2022-11-24 23:00:00,144,271,5,15,762,647,115,5
7872,2022-11-25 00:00:00,147,266,8,13,638,475,163,5
7873,2022-11-25 01:00:00,130,262,12,13,624,449,175,7
7874,2022-11-25 02:00:00,149,260,11,11,767,563,204,13
7875,2022-11-25 03:00:00,148,270,12,15,749,608,141,9
7876,2022-11-25 04:00:00,145,263,13,18,524,437,87,12
7877,2022-11-25 05:00:00,126,263,13,13,740,534,206,12
7878,2022-11-25 06:00:00,123,257,13,14,639,536,103,10
7879,2022-11-25 07:00:00,138,274,10,14,624,467,157,13
7880,2022-11-25 08:00:00,134,291,11,13,721,599,122,6
7881,2022-11-25 09:00:00,141,283,9,14,596,417,179,14
7882,2022-11-25 10:00:00,125,270,6,13,603,500,103,11
7883,2022-11-25 11:00:00,146,292,13,19,700,562,138,13
7884,2022-11-25 12:00:00,138,289,12,15,793,625,168,8
7885,2022-11-25 13:00:00,143,282,8,12,528,389,139,12
7886,2022-11-25 14:00:00,146,294,14,12,516,432,84,8
7887,2022-11-25 15:00:00,142,285,13,11,501,372,129,12
7888,2022-11-25 16:00:00,127,267,13,10,794,586,208,6
7889,2022-11-25 17:00:00,130,291,6,18,503,432,71,8
7890,2022-11-25 18:00:00,142,284,5,18,541,399,142,14
7891,2022-11-25 19:00:00,148,262,6,12,697,497,200,10
7892,2022-11-25 20:00:00,130,283,11,18,742,549,193,6
7893,2022-11-25 21:00:00,131,260,14,11,792,630,162,10
7894,2022-11-25 22:00:00,138,278,5,10,531,458,73,8
7895,2022-11-25 23:00:00,135,288,11,18,752,634,118,13
7896,2022-11-26 00:00:00,143,254,9,11,651,537,114,10
7897,2022-11-26 01:00:00,128,294,5,10,671,584,87,14
7898,2022-11-26 02:00:00,124,280,10,17,663,492,171,11
7899,2022-11-26 03:00:00,123,282,9,12,716,581,135,7
7900,2022-11-26 04:00:00,121,271,9,19,579,481,98,14
7901,2022-11-26 05:00:00,127,251,5,11,558,419,139,11
7902,2022-11-26 06:00:00,143,274,13,18,615,461,154,12
7903,2022-11-26 07:00:00,148,259,13,14,563,420,143,14
7904,2022-11-26 08:00:00,129,274,11,19,567,454,113,6
7905,2022-11-26 09:00:00,140,268,12,10,532,377,155,12
7906,2022-11-26 10:00:00,126,251,8,12,572,413,159,10
7907,2022-11-26 11:00:00,132,273,9,12,604,514,90,10
7908,2022-11-26 12:00:00,127,281,13,18,599,452,147,12
7909,2022-11-26 13:00:00,141,270,7,13,741,584,157,14
7910,2022-11-26 14:00:00,125,279,8,11,606,436,170,14
7911,2022-11-26 15:00:00,123,251,5,16,529,418,111,6
7912,2022-11-26 16:00:00,131,280,12,15,502,371,131,13
7913,2022-11-26 17:00:00,130,288,12,16,688,493,195,13
7914,2022-11-26 18:00:00,123,279,12,18,597,530,67,11
7915,2022-11-26 19:00:00,130,293,14,19,667,599,68,12
7916,2022-11-26 20:00:00,132,270,13,18,638,541,97,14
7917,2022-11-26 21:00:00,143,274,13,11,557,471,86,13
7918,2022-11-26 22:00:00,130,292,8,12,643,483,160,8
7919,2022-11-26 23:00:00,147,282,7,16,646,535,111,12
7920,2022-11-27 00:00:00,127,270,9,11,730,602,128,12
7921,2022-11-27 01:00:00,127,271,5,18,665,531,134,13
7922,2022-11-27 02:00:00,149,262,6,19,695,554,141,5
7923,2022-11-27 03:00:00,126,258,6,12,546,436,110,11
7924,2022-11-27 04:00:00,148,287,12,11,721,609,112,11
7925,2022-11-27 05:00:00,130,285,14,18,706,534,172,10
7926,2022-11-27 06:00:00,135,263,13,12,774,649,125,11
7927,2022-11-27 07:00:00,127,263,7,11,589,418,171,12
7928,2022-11-27 08:00:00,140,285,5,17,745,597,148,9
7929,2022-11-27 09:00:00,149,287,12,17,655,480,175,7
7930,2022-11-27 10:00:00,133,266,11,16,684,510,174,7
7931,2022-11-27 11:00:00,130,273,13,13,672,567,105,9
7932,2022-11-27 12:00:00,146,267,10,16,690,592,98,10
7933,2022-11-27 13:00:00,129,275,8,19,627,465,162,10
7934,2022-11-27 14:00:00,124,261,8,18,751,564,187,10
7935,2022-11-27 15:00:00,144,285,10,11,709,514,195,14
7936,2022-11-27 16:00:00,140,293,9,10,689,492,197,6
7937,2022-11-27 17:00:00,123,272,13,11,526,416,110,13
7938,2022-11-27 18:00:00,142,267,9,19,790,590,200,6
7939,2022-11-27 19:00:00,130,268,9,14,663,494,169,5
7940,2022-11-27 20:00:00,129,290,12,13,605,517,88,5
7941,2022-11-27 21:00:00,130,291,12,11,703,506,197,8
7942,2022-11-27 22:00:00,147,264,12,12,574,424,150,12
7943,2022-11-27 23:00:00,133,262,10,10,746,529,217,12
7944,2022-11-28 00:00:00,143,275,6,19,716,534,182,14
7945,2022-11-28 01:00:00,147,281,11,11,778,673,105,7
7946,2022-11-28 02:00:00,138,295,8,11,738,639,99,8
7947,2022-11-28 03:00:00,130,259,13,18,704,582,122,7
7948,2022-11-28 04:00:00,126,258,11,10,708,546,162,5
7949,2022-11-28 05:00:00,126,251,8,12,572,513,59,11
7950,2022-11-28 06:00:00,146,292,10,16,789,626,163,11
7951,2022-11-28 07:00:00,125,294,5,18,671,503,168,9
7952,2022-11-28 08:00:00,135,254,12,15,720,525,195,14
7953,2022-11-28 09:00:00,148,270,13,12,537,431,106,12
7954,2022-11-28 10:00:00,139,263,8,12,566,505,61,5
7955,2022-11-28 11:00:00,134,286,7,12,753,647,106,12
7956,2022-11-28 12:00:00,142,297,5,13,523,449,74,6
7957,2022-11-28 13:00:00,138,279,9,19,762,646,116,14
7958,2022-11-28 14:00:00,141,268,5,10,619,497,122,7
7959,2022-11-28 15:00:00,120,264,9,15,771,611,160,14
7960,2022-11-28 16:00:00,138,270,9,12,733,655,78,5
7961,2022-11-28 17:00:00,144,254,8,18,787,705,82,7
7962,2022-11-28 18:00:00,126,255,10,17,760,676,84,14
7963,2022-11-28 19:00:00,145,261,5,14,786,658,128,10
7964,2022-11-28 20:00:00,143,289,8,14,773,660,113,10
7965,2022-11-28 21:00:00,131,267,5,10,784,628,156,11
7966,2022-11-28 22:00:00,126,271,5,19,522,412,110,10
7967,2022-11-28 23:00:00,134,287,12,18,573,412,161,11
7968,2022-11-29 00:00:00,139,272,9,16,612,532,80,9
7969,2022-11-29 01:00:00,125,257,5,15,577,404,173,7
7970,2022-11-29 02:00:00,136,252,6,12,749,618,131,10
7971,2022-11-29 03:00:00,133,274,9,14,559,428,131,6
7972,2022-11-29 04:00:00,136,256,12,16,728,609,119,10
7973,2022-11-29 05:00:00,139,293,7,11,636,447,189,6
7974,2022-11-29 06:00:00,147,269,9,17,798,675,123,14
7975,2022-11-29 07:00:00,125,255,12,17,650,472,178,11
7976,2022-11-29 08:00:00,147,297,11,10,689,508,181,6
7977,2022-11-29 09:00:00,126,272,8,15,796,662,134,9
7978,2022-11-29 10:00:00,148,252,9,15,691,485,206,5
7979,2022-11-29 11:00:00,124,274,9,12,561,463,98,7
7980,2022-11-29 12:00:00,138,290,13,19,607,510,97,7
7981,2022-11-29 13:00:00,149,273,12,19,772,644,128,13
7982,2022-11-29 14:00:00,127,267,9,17,628,559,69,6
7983,2022-11-29 15:00:00,137,259,5,10,730,646,84,11
7984,2022-11-29 16:00:00,120,297,8,15,665,580,85,8
7985,2022-11-29 17:00:00,129,270,9,17,555,411,144,6
7986,2022-11-29 18:00:00,136,260,8,10,763,658,105,13
7987,2022-11-29 19:00:00,144,264,7,15,791,564,227,12
7988,2022-11-29 20:00:00,139,265,6,16,587,473,114,8
7989,2022-11-29 21:00:00,125,281,12,10,696,593,103,12
7990,2022-11-29 22:00:00,120,254,8,16,672,486,186,12
7991,2022-11-29 23:00:00,134,274,7,13,723,563,160,9
7992,2022-11-30 00:00:00,126,271,13,11,734,628,106,12
7993,2022-11-30 01:00:00,147,295,11,14,550,445,105,11
7994,2022-11-30 02:00:00,122,263,13,16,696,625,71,6
7995,2022-11-30 03:00:00,145,263,14,19,564,438,126,10
7996,2022-11-30 04:00:00,138,269,12,16,580,457,123,12
7997,2022-11-30 05:00:00,146,279,14,19,688,487,201,7
7998,2022-11-30 06:00:00,134,299,10,10,520,460,60,9
7999,2022-11-30 07:00:00,124,292,11,12,748,596,152,9
8000,2022-11-30 08:00:00,125,256,7,16,700,547,153,7
8001,2022-11-30 09:00:00,138,272,9,14,597,431,166,13
8002,2022-11-30 10:00:00,140,258,12,19,622,462,160,7
8003,2022-11-30 11:00:00,128,296,12,16,629,532,97,5
8004,2022-11-30 12:00:00,146,294,8,18,594,460,134,7
8005,2022-11-30 13:00:00,136,280,10,16,719,515,204,12
8006,2022-11-30 14:00:00,138,252,7,13,668,583,85,12
8007,2022-11-30 15:00:00,127,273,10,14,523,421,102,7
8008,2022-11-30 16:00:00,129,271,7,18,672,509,163,6
8009,2022-11-30 17:00:00,133,253,13,10,606,462,144,13
8010,2022-11-30 18:00:00,126,288,6,12,502,379,123,10
8011,2022-11-30 19:00:00,138,274,7,19,591,510,81,9
8012,2022-11-30 20:00:00,130,284,11,14,646,496,150,9
8013,2022-11-30 21:00:00,145,294,6,13,567,410,157,6
8014,2022-11-30 22:00:00,149,251,9,16,784,552,232,7
8015,2022-11-30 23:00:00,124,294,11,11,644,460,184,5
8016,2022-12-01 00:00:00,147,279,5,13,720,521,199,8
8017,2022-12-01 01:00:00,130,299,10,14,759,552,207,9
8018,2022-12-01 02:00:00,125,288,13,18,605,474,131,5
8019,2022-12-01 03:00:00,147,259,6,15,567,421,146,6
8020,2022-12-01 04:00:00,136,276,14,11,567,490,77,12
8021,2022-12-01 05:00:00,143,269,5,16,557,473,84,8
8022,2022-12-01 06:00:00,135,269,13,11,794,645,149,13
8023,2022-12-01 07:00:00,148,259,12,17,577,418,159,9
8024,2022-12-01 08:00:00,128,263,7,18,702,530,172,11
8025,2022-12-01 09:00:00,127,256,12,10,728,599,129,7
8026,2022-12-01 10:00:00,134,259,5,19,730,613,117,14
8027,2022-12-01 11:00:00,148,279,9,12,578,416,162,8
8028,2022-12-01 12:00:00,122,282,8,17,668,549,119,11
8029,2022-12-01 13:00:00,124,264,9,17,702,506,196,12
8030,2022-12-01 14:00:00,133,280,10,16,726,549,177,9
8031,2022-12-01 15:00:00,127,279,7,11,712,622,90,5
8032,2022-12-01 16:00:00,136,273,6,11,722,603,119,14
8033,2022-12-01 17:00:00,144,263,8,15,607,520,87,12
8034,2022-12-01 18:00:00,134,278,6,11,583,449,134,13
8035,2022-12-01 19:00:00,145,280,10,15,739,533,206,11
8036,2022-12-01 20:00:00,121,276,6,14,606,446,160,6
8037,2022-12-01 21:00:00,145,287,7,19,564,476,88,11
8038,2022-12-01 22:00:00,128,294,14,17,602,527,75,14
8039,2022-12-01 23:00:00,121,295,14,10,667,521,146,9
8040,2022-12-02 00:00:00,121,277,5,12,711,589,122,13
8041,2022-12-02 01:00:00,124,253,8,14,742,563,179,5
8042,2022-12-02 02:00:00,141,272,7,15,653,494,159,5
8043,2022-12-02 03:00:00,124,293,9,16,681,555,126,13
8044,2022-12-02 04:00:00,143,262,13,16,680,551,129,7
8045,2022-12-02 05:00:00,127,288,7,15,570,413,157,13
8046,2022-12-02 06:00:00,135,295,8,10,787,626,161,10
8047,2022-12-02 07:00:00,142,264,14,11,651,473,178,14
8048,2022-12-02 08:00:00,142,263,12,15,509,445,64,7
8049,2022-12-02 09:00:00,142,266,13,11,523,454,69,11
8050,2022-12-02 10:00:00,129,290,12,14,703,508,195,6
8051,2022-12-02 11:00:00,141,274,10,11,658,499,159,10
8052,2022-12-02 12:00:00,128,291,6,19,510,394,116,11
8053,2022-12-02 13:00:00,125,278,5,15,720,642,78,10
8054,2022-12-02 14:00:00,133,294,5,19,560,426,134,5
8055,2022-12-02 15:00:00,130,280,8,12,595,524,71,14
8056,2022-12-02 16:00:00,147,261,12,16,604,422,182,10
8057,2022-12-02 17:00:00,120,281,12,19,582,425,157,5
8058,2022-12-02 18:00:00,120,283,14,16,704,555,149,11
8059,2022-12-02 19:00:00,129,262,7,17,754,579,175,14
8060,2022-12-02 20:00:00,146,260,11,12,720,523,197,11
8061,2022-12-02 21:00:00,120,272,13,14,521,432,89,8
8062,2022-12-02 22:00:00,127,290,10,14,768,668,100,10
8063,2022-12-02 23:00:00,141,252,10,18,755,625,130,9
8064,2022-12-03 00:00:00,136,262,10,19,562,501,61,13
8065,2022-12-03 01:00:00,126,292,5,11,668,514,154,7
8066,2022-12-03 02:00:00,120,296,14,17,577,511,66,6
8067,2022-12-03 03:00:00,146,299,7,11,748,573,175,12
8068,2022-12-03 04:00:00,136,260,10,11,731,530,201,8
8069,2022-12-03 05:00:00,134,251,13,13,593,458,135,6
8070,2022-12-03 06:00:00,126,288,6,13,593,497,96,9
8071,2022-12-03 07:00:00,138,291,6,17,710,606,104,7
8072,2022-12-03 08:00:00,136,298,8,13,506,448,58,14
8073,2022-12-03 09:00:00,146,288,13,15,543,453,90,6
8074,2022-12-03 10:00:00,141,265,14,13,505,417,88,7
8075,2022-12-03 11:00:00,149,255,9,10,509,360,149,13
8076,2022-12-03 12:00:00,128,256,13,17,515,412,103,14
8077,2022-12-03 13:00:00,135,286,7,19,512,460,52,5
8078,2022-12-03 14:00:00,144,290,10,11,603,448,155,9
8079,2022-12-03 15:00:00,143,278,7,13,534,436,98,7
8080,2022-12-03 16:00:00,124,269,10,12,635,522,113,14
8081,2022-12-03 17:00:00,132,271,9,18,615,511,104,11
8082,2022-12-03 18:00:00,146,295,9,16,608,442,166,6
8083,2022-12-03 19:00:00,132,285,11,12,528,383,145,7
8084,2022-12-03 20:00:00,120,274,8,19,785,683,102,8
8085,2022-12-03 21:00:00,139,295,12,12,746,622,124,10
8086,2022-12-03 22:00:00,124,277,11,13,698,598,100,12
8087,2022-12-03 23:00:00,134,280,6,18,547,430,117,14
8088,2022-12-04 00:00:00,146,264,9,10,781,666,115,10
8089,2022-12-04 01:00:00,124,274,12,17,766,650,116,8
8090,2022-12-04 02:00:00,123,280,6,12,715,596,119,7
8091,2022-12-04 03:00:00,133,254,9,16,709,549,160,13
8092,2022-12-04 04:00:00,126,296,14,13,629,445,184,10
8093,2022-12-04 05:00:00,145,273,8,13,766,554,212,9
8094,2022-12-04 06:00:00,137,268,9,13,545,450,95,6
8095,2022-12-04 07:00:00,125,263,7,13,617,475,142,14
8096,2022-12-04 08:00:00,145,266,14,13,574,454,120,10
8097,2022-12-04 09:00:00,125,290,7,13,711,630,81,6
8098,2022-12-04 10:00:00,144,265,11,17,768,676,92,14
8099,2022-12-04 11:00:00,149,298,13,11,573,423,150,10
8100,2022-12-04 12:00:00,143,299,6,10,780,655,125,5
8101,2022-12-04 13:00:00,145,286,5,18,765,677,88,14
8102,2022-12-04 14:00:00,128,291,14,15,764,633,131,8
8103,2022-12-04 15:00:00,120,262,6,11,596,508,88,5
8104,2022-12-04 16:00:00,139,291,10,12,793,626,167,14
8105,2022-12-04 17:00:00,123,263,9,18,770,574,196,9
8106,2022-12-04 18:00:00,141,275,13,17,749,551,198,6
8107,2022-12-04 19:00:00,126,269,10,12,791,646,145,14
8108,2022-12-04 20:00:00,120,277,13,12,783,575,208,8
8109,2022-12-04 21:00:00,145,270,13,12,654,468,186,8
8110,2022-12-04 22:00:00,140,268,7,12,685,602,83,6
8111,2022-12-04 23:00:00,130,267,8,16,518,449,69,12
8112,2022-12-05 00:00:00,137,274,13,18,605,542,63,6
8113,2022-12-05 01:00:00,122,271,8,16,656,587,69,9
8114,2022-12-05 02:00:00,132,279,13,19,765,677,88,12
8115,2022-12-05 03:00:00,120,282,7,13,518,406,112,10
8116,2022-12-05 04:00:00,124,286,13,10,675,517,158,13
8117,2022-12-05 05:00:00,146,267,12,12,790,603,187,8
8118,2022-12-05 06:00:00,141,259,7,18,679,496,183,9
8119,2022-12-05 07:00:00,143,268,11,15,575,479,96,7
8120,2022-12-05 08:00:00,147,268,8,17,799,685,114,10
8121,2022-12-05 09:00:00,125,289,14,17,646,519,127,12
8122,2022-12-05 10:00:00,141,287,7,14,771,667,104,14
8123,2022-12-05 11:00:00,147,294,14,16,501,419,82,7
8124,2022-12-05 12:00:00,131,252,10,15,785,669,116,11
8125,2022-12-05 13:00:00,137,259,11,17,666,570,96,8
8126,2022-12-05 14:00:00,130,274,10,12,652,527,125,7
8127,2022-12-05 15:00:00,134,290,9,14,565,455,110,9
8128,2022-12-05 16:00:00,137,275,9,10,679,514,165,8
8129,2022-12-05 17:00:00,139,270,10,13,660,514,146,6
8130,2022-12-05 18:00:00,147,255,5,15,771,556,215,9
8131,2022-12-05 19:00:00,138,280,8,13,756,613,143,6
8132,2022-12-05 20:00:00,131,293,13,13,761,633,128,12
8133,2022-12-05 21:00:00,125,260,9,12,714,530,184,8
8134,2022-12-05 22:00:00,142,272,5,18,795,590,205,5
8135,2022-12-05 23:00:00,123,291,6,15,502,402,100,7
8136,2022-12-06 00:00:00,128,283,10,13,645,569,76,5
8137,2022-12-06 01:00:00,132,291,12,18,673,577,96,8
8138,2022-12-06 02:00:00,124,273,12,19,767,673,94,11
8139,2022-12-06 03:00:00,136,287,5,17,582,420,162,13
8140,2022-12-06 04:00:00,131,278,6,14,580,487,93,14
8141,2022-12-06 05:00:00,131,275,9,11,791,647,144,12
8142,2022-12-06 06:00:00,144,285,5,14,708,637,71,11
8143,2022-12-06 07:00:00,128,276,9,18,599,508,91,14
8144,2022-12-06 08:00:00,123,298,5,14,513,423,90,12
8145,2022-12-06 09:00:00,136,281,14,17,541,434,107,10
8146,2022-12-06 10:00:00,147,290,6,16,650,570,80,9
8147,2022-12-06 11:00:00,122,269,13,12,613,437,176,10
8148,2022-12-06 12:00:00,149,264,7,18,590,430,160,9
8149,2022-12-06 13:00:00,133,272,13,18,729,626,103,5
8150,2022-12-06 14:00:00,121,258,13,17,669,484,185,10
8151,2022-12-06 15:00:00,131,288,10,18,747,569,178,10
8152,2022-12-06 16:00:00,139,287,10,18,597,535,62,8
8153,2022-12-06 17:00:00,147,267,10,13,539,438,101,9
8154,2022-12-06 18:00:00,124,293,13,19,558,489,69,9
8155,2022-12-06 19:00:00,143,292,11,17,515,388,127,11
8156,2022-12-06 20:00:00,142,269,12,14,712,517,195,13
8157,2022-12-06 21:00:00,127,271,13,13,714,500,214,9
8158,2022-12-06 22:00:00,142,260,9,11,646,461,185,7
8159,2022-12-06 23:00:00,144,262,5,10,559,456,103,6
8160,2022-12-07 00:00:00,141,269,7,11,677,480,197,8
8161,2022-12-07 01:00:00,144,289,8,12,521,444,77,5
8162,2022-12-07 02:00:00,129,268,7,17,715,538,177,12
8163,2022-12-07 03:00:00,123,271,13,18,538,464,74,8
8164,2022-12-07 04:00:00,120,276,14,18,695,549,146,7
8165,2022-12-07 05:00:00,120,265,6,15,620,535,85,12
8166,2022-12-07 06:00:00,140,287,9,16,697,574,123,13
8167,2022-12-07 07:00:00,133,288,8,15,726,586,140,14
8168,2022-12-07 08:00:00,133,290,11,10,509,437,72,14
8169,2022-12-07 09:00:00,125,256,6,10,540,472,68,14
8170,2022-12-07 10:00:00,134,288,5,15,718,535,183,10
8171,2022-12-07 11:00:00,145,264,12,11,596,489,107,9
8172,2022-12-07 12:00:00,141,261,10,14,570,466,104,9
8173,2022-12-07 13:00:00,138,257,11,15,514,371,143,11
8174,2022-12-07 14:00:00,141,265,11,19,763,568,195,11
8175,2022-12-07 15:00:00,121,258,11,10,661,570,91,11
8176,2022-12-07 16:00:00,137,295,8,12,680,479,201,6
8177,2022-12-07 17:00:00,135,287,6,12,621,448,173,13
8178,2022-12-07 18:00:00,136,275,12,12,781,596,185,11
8179,2022-12-07 19:00:00,131,284,14,19,662,543,119,7
8180,2022-12-07 20:00:00,130,293,8,15,614,505,109,8
8181,2022-12-07 21:00:00,143,294,14,18,630,506,124,12
8182,2022-12-07 22:00:00,128,250,9,13,531,437,94,5
8183,2022-12-07 23:00:00,135,290,12,19,506,410,96,12
8184,2022-12-08 00:00:00,146,251,12,13,573,478,95,9
8185,2022-12-08 01:00:00,149,259,13,17,521,451,70,5
8186,2022-12-08 02:00:00,145,272,13,15,560,449,111,7
8187,2022-12-08 03:00:00,125,273,6,11,643,495,148,9
8188,2022-12-08 04:00:00,125,278,7,10,645,517,128,5
8189,2022-12-08 05:00:00,138,269,5,11,562,433,129,10
8190,2022-12-08 06:00:00,131,293,11,18,781,621,160,9
8191,2022-12-08 07:00:00,142,272,7,19,682,527,155,11
8192,2022-12-08 08:00:00,123,294,9,19,536,428,108,10
8193,2022-12-08 09:00:00,127,272,8,15,700,577,123,11
8194,2022-12-08 10:00:00,139,263,11,14,685,485,200,8
8195,2022-12-08 11:00:00,122,298,7,12,626,491,135,7
8196,2022-12-08 12:00:00,132,251,7,19,647,457,190,12
8197,2022-12-08 13:00:00,144,289,5,17,649,492,157,7
8198,2022-12-08 14:00:00,123,267,11,14,684,574,110,13
8199,2022-12-08 15:00:00,120,260,8,14,791,686,105,7
8200,2022-12-08 16:00:00,129,296,12,15,502,430,72,14
8201,2022-12-08 17:00:00,148,271,13,10,534,478,56,11
8202,2022-12-08 18:00:00,124,262,14,13,693,523,170,7
8203,2022-12-08 19:00:00,123,290,12,11,522,421,101,6
8204,2022-12-08 20:00:00,131,260,11,14,703,496,207,6
8205,2022-12-08 21:00:00,134,288,6,10,714,572,142,7
8206,2022-12-08 22:00:00,121,276,7,18,693,623,70,10
8207,2022-12-08 23:00:00,120,280,13,19,510,390,120,9
8208,2022-12-09 00:00:00,133,289,9,19,622,460,162,5
8209,2022-12-09 01:00:00,146,270,13,18,678,514,164,6
8210,2022-12-09 02:00:00,121,271,8,16,563,469,94,5
8211,2022-12-09 03:00:00,142,253,9,13,688,533,155,5
8212,2022-12-09 04:00:00,132,282,13,11,650,555,95,5
8213,2022-12-09 05:00:00,129,271,5,18,716,644,72,5
8214,2022-12-09 06:00:00,133,281,11,10,596,471,125,6
8215,2022-12-09 07:00:00,129,259,5,13,686,617,69,9
8216,2022-12-09 08:00:00,138,261,6,14,621,484,137,13
8217,2022-12-09 09:00:00,148,286,9,14,721,542,179,9
8218,2022-12-09 10:00:00,149,251,10,18,771,640,131,11
8219,2022-12-09 11:00:00,133,291,14,17,650,572,78,9
8220,2022-12-09 12:00:00,148,265,8,18,612,503,109,14
8221,2022-12-09 13:00:00,126,277,5,12,674,548,126,7
8222,2022-12-09 14:00:00,133,276,11,12,769,607,162,9
8223,2022-12-09 15:00:00,139,253,9,13,628,524,104,12
8224,2022-12-09 16:00:00,140,291,12,11,504,409,95,8
8225,2022-12-09 17:00:00,129,299,14,12,760,592,168,6
8226,2022-12-09 18:00:00,128,281,13,15,554,495,59,7
8227,2022-12-09 19:00:00,137,254,10,11,710,567,143,9
8228,2022-12-09 20:00:00,122,264,11,14,667,537,130,13
8229,2022-12-09 21:00:00,138,268,14,16,539,457,82,12
8230,2022-12-09 22:00:00,127,276,14,19,523,389,134,14
8231,2022-12-09 23:00:00,122,263,8,16,709,521,188,11
8232,2022-12-10 00:00:00,123,295,9,16,519,371,148,5
8233,2022-12-10 01:00:00,135,288,14,19,606,539,67,5
8234,2022-12-10 02:00:00,143,272,8,11,502,382,120,13
8235,2022-12-10 03:00:00,123,295,6,13,795,645,150,6
8236,2022-12-10 04:00:00,139,297,5,15,629,539,90,7
8237,2022-12-10 05:00:00,129,260,8,14,596,531,65,8
8238,2022-12-10 06:00:00,143,264,9,19,629,447,182,7
8239,2022-12-10 07:00:00,127,289,5,18,629,553,76,6
8240,2022-12-10 08:00:00,144,274,13,16,735,516,219,10
8241,2022-12-10 09:00:00,139,257,7,17,503,436,67,11
8242,2022-12-10 10:00:00,138,289,11,13,620,496,124,13
8243,2022-12-10 11:00:00,146,275,9,10,502,429,73,11
8244,2022-12-10 12:00:00,130,272,10,16,638,503,135,5
8245,2022-12-10 13:00:00,131,282,7,19,673,542,131,10
8246,2022-12-10 14:00:00,146,278,5,10,777,647,130,10
8247,2022-12-10 15:00:00,141,294,12,16,501,437,64,12
8248,2022-12-10 16:00:00,142,253,11,13,790,612,178,8
8249,2022-12-10 17:00:00,122,284,10,14,656,542,114,13
8250,2022-12-10 18:00:00,136,286,5,16,649,521,128,5
8251,2022-12-10 19:00:00,139,275,9,16,714,586,128,10
8252,2022-12-10 20:00:00,145,287,9,18,586,475,111,7
8253,2022-12-10 21:00:00,126,251,14,10,551,397,154,7
8254,2022-12-10 22:00:00,134,296,6,12,699,576,123,13
8255,2022-12-10 23:00:00,148,265,12,15,745,577,168,13
8256,2022-12-11 00:00:00,122,274,12,12,745,542,203,10
8257,2022-12-11 01:00:00,121,274,9,10,795,715,80,14
8258,2022-12-11 02:00:00,132,296,13,14,778,679,99,6
8259,2022-12-11 03:00:00,146,298,6,13,559,391,168,11
8260,2022-12-11 04:00:00,136,274,12,13,654,504,150,10
8261,2022-12-11 05:00:00,122,278,11,12,759,646,113,6
8262,2022-12-11 06:00:00,135,253,8,11,637,524,113,8
8263,2022-12-11 07:00:00,136,262,9,12,668,588,80,12
8264,2022-12-11 08:00:00,137,288,8,19,576,414,162,14
8265,2022-12-11 09:00:00,145,275,14,17,767,553,214,12
8266,2022-12-11 10:00:00,138,292,11,15,564,406,158,9
8267,2022-12-11 11:00:00,137,258,11,12,531,435,96,5
8268,2022-12-11 12:00:00,149,253,14,16,508,414,94,14
8269,2022-12-11 13:00:00,130,299,8,12,526,429,97,5
8270,2022-12-11 14:00:00,121,276,13,11,576,410,166,7
8271,2022-12-11 15:00:00,144,284,7,10,659,508,151,13
8272,2022-12-11 16:00:00,125,262,5,10,585,469,116,5
8273,2022-12-11 17:00:00,148,284,10,15,575,509,66,11
8274,2022-12-11 18:00:00,143,284,14,14,779,687,92,14
8275,2022-12-11 19:00:00,143,267,13,17,762,595,167,14
8276,2022-12-11 20:00:00,142,288,12,14,684,541,143,10
8277,2022-12-11 21:00:00,134,267,9,17,651,553,98,13
8278,2022-12-11 22:00:00,127,280,11,12,779,564,215,5
8279,2022-12-11 23:00:00,140,278,5,17,686,527,159,9
8280,2022-12-12 00:00:00,131,283,8,15,558,397,161,7
8281,2022-12-12 01:00:00,139,260,8,15,635,480,155,6
8282,2022-12-12 02:00:00,144,295,5,10,502,390,112,7
8283,2022-12-12 03:00:00,120,284,11,12,613,522,91,5
8284,2022-12-12 04:00:00,126,259,7,14,756,643,113,6
8285,2022-12-12 05:00:00,121,272,12,14,542,444,98,12
8286,2022-12-12 06:00:00,149,272,8,17,515,457,58,11
8287,2022-12-12 07:00:00,135,287,7,10,584,437,147,5
8288,2022-12-12 08:00:00,145,273,8,11,781,565,216,8
8289,2022-12-12 09:00:00,145,253,11,10,715,507,208,10
8290,2022-12-12 10:00:00,140,298,12,19,710,548,162,12
8291,2022-12-12 11:00:00,131,295,8,18,592,501,91,5
8292,2022-12-12 12:00:00,136,252,5,18,526,429,97,13
8293,2022-12-12 13:00:00,124,284,11,12,735,643,92,7
8294,2022-12-12 14:00:00,134,279,7,10,780,639,141,9
8295,2022-12-12 15:00:00,132,281,14,15,735,520,215,5
8296,2022-12-12 16:00:00,125,285,8,14,763,677,86,13
8297,2022-12-12 17:00:00,148,299,6,13,759,539,220,10
8298,2022-12-12 18:00:00,131,259,7,10,505,413,92,12
8299,2022-12-12 19:00:00,126,281,8,18,799,678,121,8
8300,2022-12-12 20:00:00,126,280,6,12,772,612,160,5
8301,2022-12-12 21:00:00,128,294,8,19,631,456,175,8
8302,2022-12-12 22:00:00,146,250,11,15,604,447,157,10
8303,2022-12-12 23:00:00,127,299,6,17,537,470,67,13
8304,2022-12-13 00:00:00,120,270,14,13,789,702,87,14
8305,2022-12-13 01:00:00,127,281,8,17,609,453,156,8
8306,2022-12-13 02:00:00,130,291,6,17,715,572,143,7
8307,2022-12-13 03:00:00,139,257,5,12,769,565,204,12
8308,2022-12-13 04:00:00,144,289,7,11,672,476,196,8
8309,2022-12-13 05:00:00,136,286,6,13,640,502,138,8
8310,2022-12-13 06:00:00,128,251,6,17,658,579,79,7
8311,2022-12-13 07:00:00,123,297,6,16,595,513,82,5
8312,2022-12-13 08:00:00,127,284,5,10,613,523,90,6
8313,2022-12-13 09:00:00,142,285,5,18,752,667,85,7
8314,2022-12-13 10:00:00,131,293,12,12,521,394,127,6
8315,2022-12-13 11:00:00,143,267,5,19,636,456,180,13
8316,2022-12-13 12:00:00,125,269,7,11,544,434,110,14
8317,2022-12-13 13:00:00,138,292,11,19,524,437,87,5
8318,2022-12-13 14:00:00,124,260,7,13,757,674,83,12
8319,2022-12-13 15:00:00,144,277,9,11,569,503,66,5
8320,2022-12-13 16:00:00,130,253,13,17,608,485,123,7
8321,2022-12-13 17:00:00,140,254,13,19,673,501,172,5
8322,2022-12-13 18:00:00,123,288,9,19,510,410,100,8
8323,2022-12-13 19:00:00,129,255,5,14,622,465,157,13
8324,2022-12-13 20:00:00,138,299,8,13,708,568,140,11
8325,2022-12-13 21:00:00,133,299,8,10,656,577,79,14
8326,2022-12-13 22:00:00,121,289,9,16,682,539,143,11
8327,2022-12-13 23:00:00,140,283,10,18,665,517,148,10
8328,2022-12-14 00:00:00,136,270,11,17,630,548,82,10
8329,2022-12-14 01:00:00,141,269,10,12,587,414,173,12
8330,2022-12-14 02:00:00,124,276,8,12,511,458,53,9
8331,2022-12-14 03:00:00,121,271,8,16,672,559,113,14
8332,2022-12-14 04:00:00,135,256,5,16,759,550,209,8
8333,2022-12-14 05:00:00,147,289,9,11,606,469,137,9
8334,2022-12-14 06:00:00,138,294,12,12,747,533,214,13
8335,2022-12-14 07:00:00,122,293,9,19,774,588,186,12
8336,2022-12-14 08:00:00,138,291,14,16,659,491,168,12
8337,2022-12-14 09:00:00,143,267,6,18,788,706,82,14
8338,2022-12-14 10:00:00,129,285,5,13,799,694,105,7
8339,2022-12-14 11:00:00,124,257,9,10,686,515,171,9
8340,2022-12-14 12:00:00,121,280,14,17,605,506,99,14
8341,2022-12-14 13:00:00,143,287,8,19,755,592,163,7
8342,2022-12-14 14:00:00,124,291,6,19,739,585,154,8
8343,2022-12-14 15:00:00,131,264,5,12,750,669,81,9
8344,2022-12-14 16:00:00,144,291,14,14,622,510,112,11
8345,2022-12-14 17:00:00,137,262,8,10,714,506,208,9
8346,2022-12-14 18:00:00,125,299,11,13,679,490,189,14
8347,2022-12-14 19:00:00,124,286,9,14,570,454,116,13
8348,2022-12-14 20:00:00,128,263,14,14,664,513,151,8
8349,2022-12-14 21:00:00,133,269,10,19,792,647,145,12
8350,2022-12-14 22:00:00,148,284,9,11,713,503,210,5
8351,2022-12-14 23:00:00,143,260,8,11,747,584,163,10
8352,2022-12-15 00:00:00,140,289,12,18,506,367,139,14
8353,2022-12-15 01:00:00,149,298,12,15,533,389,144,11
8354,2022-12-15 02:00:00,122,297,14,12,745,632,113,11
8355,2022-12-15 03:00:00,126,264,8,16,714,564,150,8
8356,2022-12-15 04:00:00,120,287,13,19,625,441,184,13
8357,2022-12-15 05:00:00,132,263,12,13,710,519,191,11
8358,2022-12-15 06:00:00,147,296,12,14,747,647,100,12
8359,2022-12-15 07:00:00,131,250,6,19,596,522,74,13
8360,2022-12-15 08:00:00,127,293,14,13,606,430,176,11
8361,2022-12-15 09:00:00,138,293,6,17,563,401,162,8
8362,2022-12-15 10:00:00,146,292,7,13,701,529,172,9
8363,2022-12-15 11:00:00,132,283,13,18,759,567,192,5
8364,2022-12-15 12:00:00,120,253,9,17,552,422,130,14
8365,2022-12-15 13:00:00,145,260,7,18,512,427,85,14
8366,2022-12-15 14:00:00,128,255,14,17,741,609,132,13
8367,2022-12-15 15:00:00,146,259,7,11,533,466,67,9
8368,2022-12-15 16:00:00,145,263,12,15,617,510,107,14
8369,2022-12-15 17:00:00,141,287,12,12,577,417,160,8
8370,2022-12-15 18:00:00,141,257,11,12,625,558,67,13
8371,2022-12-15 19:00:00,141,255,8,12,554,433,121,12
8372,2022-12-15 20:00:00,146,298,7,14,698,506,192,13
8373,2022-12-15 21:00:00,127,280,12,17,683,588,95,7
8374,2022-12-15 22:00:00,137,265,14,14,615,448,167,10
8375,2022-12-15 23:00:00,137,287,12,12,765,583,182,12
8376,2022-12-16 00:00:00,142,262,6,10,713,633,80,6
8377,2022-12-16 01:00:00,122,265,12,10,593,470,123,12
8378,2022-12-16 02:00:00,149,292,12,19,713,616,97,14
8379,2022-12-16 03:00:00,123,296,5,12,694,513,181,10
8380,2022-12-16 04:00:00,127,273,5,16,736,556,180,7
8381,2022-12-16 05:00:00,148,285,6,17,786,704,82,9
8382,2022-12-16 06:00:00,120,297,14,19,552,396,156,12
8383,2022-12-16 07:00:00,121,286,14,18,660,520,140,11
8384,2022-12-16 08:00:00,129,284,7,12,733,550,183,13
8385,2022-12-16 09:00:00,139,253,10,19,645,554,91,8
8386,2022-12-16 10:00:00,128,272,13,17,608,441,167,12
8387,2022-12-16 11:00:00,123,283,8,19,533,437,96,9
8388,2022-12-16 12:00:00,133,267,12,12,582,473,109,8
8389,2022-12-16 13:00:00,123,295,10,12,539,450,89,5
8390,2022-12-16 14:00:00,139,254,10,16,694,560,134,5
8391,2022-12-16 15:00:00,126,256,13,16,776,626,150,14
8392,2022-12-16 16:00:00,126,279,11,19,703,577,126,8
8393,2022-12-16 17:00:00,131,284,10,15,600,487,113,11
8394,2022-12-16 18:00:00,128,253,10,11,716,588,128,13
8395,2022-12-16 19:00:00,148,286,14,17,567,453,114,10
8396,2022-12-16 20:00:00,124,278,12,17,769,541,228,13
8397,2022-12-16 21:00:00,129,289,10,18,688,608,80,6
8398,2022-12-16 22:00:00,149,274,12,10,520,433,87,9
8399,2022-12-16 23:00:00,131,271,11,13,598,475,123,10
8400,2022-12-17 00:00:00,129,259,10,18,590,481,109,14
8401,2022-12-17 01:00:00,145,275,14,16,787,632,155,5
8402,2022-12-17 02:00:00,123,289,5,14,615,443,172,8
8403,2022-12-17 03:00:00,140,255,8,14,664,537,127,14
8404,2022-12-17 04:00:00,126,261,10,15,680,533,147,11
8405,2022-12-17 05:00:00,127,278,14,17,514,452,62,8
8406,2022-12-17 06:00:00,143,299,7,15,694,623,71,7
8407,2022-12-17 07:00:00,136,261,14,14,775,589,186,11
8408,2022-12-17 08:00:00,122,252,8,11,591,425,166,12
8409,2022-12-17 09:00:00,149,288,5,14,574,475,99,9
8410,2022-12-17 10:00:00,127,281,8,18,645,477,168,13
8411,2022-12-17 11:00:00,143,259,8,15,567,439,128,14
8412,2022-12-17 12:00:00,129,252,5,16,532,388,144,12
8413,2022-12-17 13:00:00,141,299,7,19,715,629,86,9
8414,2022-12-17 14:00:00,121,256,9,13,533,397,136,10
8415,2022-12-17 15:00:00,141,298,6,13,503,395,108,12
8416,2022-12-17 16:00:00,129,297,5,11,673,571,102,5
8417,2022-12-17 17:00:00,123,299,6,10,772,687,85,8
8418,2022-12-17 18:00:00,127,274,12,16,501,398,103,9
8419,2022-12-17 19:00:00,129,288,11,19,553,395,158,7
8420,2022-12-17 20:00:00,141,265,8,12,730,540,190,12
8421,2022-12-17 21:00:00,120,298,11,16,520,393,127,13
8422,2022-12-17 22:00:00,134,267,14,17,691,600,91,6
8423,2022-12-17 23:00:00,131,270,10,17,535,425,110,13
8424,2022-12-18 00:00:00,129,250,10,12,531,432,99,11
8425,2022-12-18 01:00:00,130,251,8,11,771,559,212,9
8426,2022-12-18 02:00:00,141,288,14,11,695,500,195,13
8427,2022-12-18 03:00:00,141,274,13,19,713,555,158,9
8428,2022-12-18 04:00:00,134,276,7,19,623,502,121,5
8429,2022-12-18 05:00:00,143,259,8,16,741,565,176,11
8430,2022-12-18 06:00:00,123,274,9,11,751,653,98,5
8431,2022-12-18 07:00:00,123,290,9,18,532,454,78,13
8432,2022-12-18 08:00:00,131,273,8,15,634,512,122,6
8433,2022-12-18 09:00:00,139,276,5,17,759,551,208,7
8434,2022-12-18 10:00:00,140,282,9,14,719,645,74,11
8435,2022-12-18 11:00:00,133,258,9,14,584,486,98,5
8436,2022-12-18 12:00:00,142,287,9,15,744,538,206,5
8437,2022-12-18 13:00:00,131,277,11,10,739,662,77,8
8438,2022-12-18 14:00:00,128,278,10,17,670,571,99,7
8439,2022-12-18 15:00:00,149,284,13,15,556,483,73,9
8440,2022-12-18 16:00:00,132,257,5,18,690,526,164,12
8441,2022-12-18 17:00:00,136,273,9,19,777,683,94,13
8442,2022-12-18 18:00:00,120,260,13,15,734,631,103,9
8443,2022-12-18 19:00:00,143,291,8,10,776,599,177,11
8444,2022-12-18 20:00:00,124,289,14,11,570,404,166,5
8445,2022-12-18 21:00:00,130,254,5,14,787,678,109,13
8446,2022-12-18 22:00:00,126,252,7,12,598,454,144,8
8447,2022-12-18 23:00:00,142,259,8,10,513,383,130,7
8448,2022-12-19 00:00:00,148,286,13,14,641,473,168,5
8449,2022-12-19 01:00:00,139,278,11,14,521,465,56,10
8450,2022-12-19 02:00:00,140,282,12,18,566,399,167,14
8451,2022-12-19 03:00:00,143,253,9,16,610,477,133,14
8452,2022-12-19 04:00:00,128,273,6,16,686,607,79,10
8453,2022-12-19 05:00:00,146,283,5,17,627,503,124,7
8454,2022-12-19 06:00:00,135,259,5,13,611,429,182,5
8455,2022-12-19 07:00:00,143,282,7,15,658,503,155,14
8456,2022-12-19 08:00:00,144,264,12,11,592,517,75,10
8457,2022-12-19 09:00:00,125,251,10,17,603,463,140,5
8458,2022-12-19 10:00:00,135,291,8,19,730,530,200,11
8459,2022-12-19 11:00:00,138,261,7,12,569,468,101,5
8460,2022-12-19 12:00:00,141,264,6,14,532,447,85,12
8461,2022-12-19 13:00:00,129,268,14,13,648,518,130,13
8462,2022-12-19 14:00:00,143,260,13,17,545,458,87,13
8463,2022-12-19 15:00:00,137,274,8,18,559,440,119,10
8464,2022-12-19 16:00:00,149,287,13,19,601,473,128,9
8465,2022-12-19 17:00:00,133,271,7,12,713,585,128,8
8466,2022-12-19 18:00:00,128,293,8,13,546,401,145,11
8467,2022-12-19 19:00:00,134,261,10,18,644,570,74,7
8468,2022-12-19 20:00:00,141,264,14,17,516,371,145,7
8469,2022-12-19 21:00:00,140,295,10,13,716,507,209,12
8470,2022-12-19 22:00:00,137,283,12,14,533,425,108,12
8471,2022-12-19 23:00:00,143,280,6,13,524,371,153,11
8472,2022-12-20 00:00:00,145,269,10,15,789,565,224,7
8473,2022-12-20 01:00:00,147,258,9,17,736,538,198,10
8474,2022-12-20 02:00:00,142,269,11,15,798,692,106,8
8475,2022-12-20 03:00:00,129,287,7,15,738,538,200,7
8476,2022-12-20 04:00:00,135,265,8,18,503,444,59,7
8477,2022-12-20 05:00:00,132,284,9,11,545,404,141,6
8478,2022-12-20 06:00:00,135,274,5,12,735,541,194,6
8479,2022-12-20 07:00:00,129,251,6,10,546,467,79,11
8480,2022-12-20 08:00:00,126,294,10,13,679,490,189,11
8481,2022-12-20 09:00:00,127,266,12,12,660,578,82,12
8482,2022-12-20 10:00:00,120,265,9,15,765,684,81,11
8483,2022-12-20 11:00:00,139,278,11,12,784,562,222,14
8484,2022-12-20 12:00:00,147,295,8,10,569,420,149,11
8485,2022-12-20 13:00:00,125,254,7,13,553,491,62,9
8486,2022-12-20 14:00:00,144,261,11,14,676,490,186,8
8487,2022-12-20 15:00:00,130,264,11,16,670,592,78,14
8488,2022-12-20 16:00:00,138,297,10,18,502,357,145,7
8489,2022-12-20 17:00:00,145,280,7,16,614,498,116,7
8490,2022-12-20 18:00:00,138,275,8,16,680,488,192,10
8491,2022-12-20 19:00:00,149,253,14,10,699,503,196,6
8492,2022-12-20 20:00:00,149,274,6,16,530,462,68,11
8493,2022-12-20 21:00:00,140,254,6,13,622,455,167,9
8494,2022-12-20 22:00:00,123,261,11,14,765,542,223,14
8495,2022-12-20 23:00:00,143,280,11,15,530,466,64,8
8496,2022-12-21 00:00:00,137,266,11,15,756,623,133,5
8497,2022-12-21 01:00:00,136,263,12,14,706,550,156,10
8498,2022-12-21 02:00:00,138,285,5,18,630,556,74,5
8499,2022-12-21 03:00:00,143,261,13,19,655,569,86,8
8500,2022-12-21 04:00:00,130,298,13,19,605,499,106,7
8501,2022-12-21 05:00:00,128,291,13,14,564,424,140,13
8502,2022-12-21 06:00:00,149,297,14,10,594,475,119,8
8503,2022-12-21 07:00:00,120,256,10,13,792,617,175,10
8504,2022-12-21 08:00:00,127,279,9,14,513,374,139,12
8505,2022-12-21 09:00:00,126,271,7,18,762,560,202,10
8506,2022-12-21 10:00:00,142,299,10,14,658,520,138,11
8507,2022-12-21 11:00:00,146,270,5,11,656,501,155,6
8508,2022-12-21 12:00:00,147,295,10,12,668,474,194,7
8509,2022-12-21 13:00:00,135,285,11,12,639,547,92,12
8510,2022-12-21 14:00:00,141,297,5,19,654,509,145,6
8511,2022-12-21 15:00:00,130,281,7,15,652,489,163,10
8512,2022-12-21 16:00:00,121,263,11,13,780,597,183,12
8513,2022-12-21 17:00:00,131,286,10,13,739,637,102,9
8514,2022-12-21 18:00:00,124,283,10,13,565,479,86,12
8515,2022-12-21 19:00:00,122,284,14,11,759,592,167,5
8516,2022-12-21 20:00:00,128,250,8,11,607,513,94,11
8517,2022-12-21 21:00:00,143,278,12,16,507,360,147,8
8518,2022-12-21 22:00:00,120,260,6,15,523,378,145,8
8519,2022-12-21 23:00:00,147,291,8,17,537,463,74,14
8520,2022-12-22 00:00:00,123,252,5,17,649,513,136,8
8521,2022-12-22 01:00:00,142,265,8,13,582,456,126,14
8522,2022-12-22 02:00:00,146,275,13,11,511,444,67,14
8523,2022-12-22 03:00:00,148,270,11,18,779,630,149,12
8524,2022-12-22 04:00:00,126,269,12,10,723,519,204,13
8525,2022-12-22 05:00:00,134,269,8,12,500,415,85,13
8526,2022-12-22 06:00:00,122,268,13,19,706,633,73,5
8527,2022-12-22 07:00:00,146,292,10,12,533,411,122,6
8528,2022-12-22 08:00:00,121,277,11,13,787,658,129,5
8529,2022-12-22 09:00:00,129,293,6,19,617,454,163,8
8530,2022-12-22 10:00:00,131,270,10,19,714,514,200,8
8531,2022-12-22 11:00:00,135,253,5,11,644,560,84,13
8532,2022-12-22 12:00:00,147,269,8,11,529,415,114,11
8533,2022-12-22 13:00:00,138,297,10,14,628,540,88,14
8534,2022-12-22 14:00:00,142,265,12,14,515,374,141,8
8535,2022-12-22 15:00:00,134,252,5,18,718,566,152,8
8536,2022-12-22 16:00:00,135,253,11,16,604,497,107,14
8537,2022-12-22 17:00:00,137,261,10,19,592,466,126,11
8538,2022-12-22 18:00:00,122,275,5,15,504,451,53,8
8539,2022-12-22 19:00:00,133,274,8,18,545,486,59,9
8540,2022-12-22 20:00:00,145,256,5,14,699,541,158,10
8541,2022-12-22 21:00:00,126,297,9,13,751,671,80,10
8542,2022-12-22 22:00:00,125,251,10,13,630,558,72,6
8543,2022-12-22 23:00:00,145,299,14,14,671,489,182,12
8544,2022-12-23 00:00:00,128,254,12,15,657,568,89,9
8545,2022-12-23 01:00:00,146,298,12,14,649,568,81,10
8546,2022-12-23 02:00:00,125,250,5,19,746,557,189,9
8547,2022-12-23 03:00:00,124,288,11,14,788,613,175,14
8548,2022-12-23 04:00:00,124,271,7,17,602,443,159,11
8549,2022-12-23 05:00:00,125,297,7,18,548,396,152,12
8550,2022-12-23 06:00:00,145,293,10,11,672,603,69,9
8551,2022-12-23 07:00:00,142,271,9,18,631,486,145,14
8552,2022-12-23 08:00:00,127,267,14,18,595,529,66,6
8553,2022-12-23 09:00:00,148,258,5,11,534,457,77,14
8554,2022-12-23 10:00:00,141,274,14,14,720,504,216,12
8555,2022-12-23 11:00:00,144,279,6,13,575,440,135,10
8556,2022-12-23 12:00:00,121,286,8,12,767,599,168,7
8557,2022-12-23 13:00:00,137,275,10,17,699,529,170,14
8558,2022-12-23 14:00:00,140,254,8,12,516,457,59,10
8559,2022-12-23 15:00:00,143,269,10,18,647,485,162,13
8560,2022-12-23 16:00:00,144,256,8,14,569,483,86,10
8561,2022-12-23 17:00:00,143,277,12,18,750,552,198,6
8562,2022-12-23 18:00:00,149,295,11,15,706,555,151,14
8563,2022-12-23 19:00:00,129,287,8,10,510,451,59,9
8564,2022-12-23 20:00:00,148,285,8,14,565,487,78,10
8565,2022-12-23 21:00:00,128,267,5,19,671,531,140,7
8566,2022-12-23 22:00:00,120,259,13,12,569,436,133,5
8567,2022-12-23 23:00:00,136,283,6,14,661,506,155,10
8568,2022-12-24 00:00:00,123,288,6,19,571,451,120,7
8569,2022-12-24 01:00:00,131,266,7,15,501,370,131,7
8570,2022-12-24 02:00:00,139,254,5,11,634,535,99,10
8571,2022-12-24 03:00:00,123,255,8,11,784,566,218,11
8572,2022-12-24 04:00:00,128,297,14,16,529,396,133,8
8573,2022-12-24 05:00:00,140,279,13,14,650,524,126,5
8574,2022-12-24 06:00:00,139,273,8,10,702,537,165,11
8575,2022-12-24 07:00:00,127,291,8,17,639,470,169,14
8576,2022-12-24 08:00:00,124,274,7,19,624,500,124,12
8577,2022-12-24 09:00:00,141,250,10,17,564,501,63,13
8578,2022-12-24 10:00:00,120,296,13,17,694,619,75,14
8579,2022-12-24 11:00:00,144,285,11,11,602,494,108,12
8580,2022-12-24 12:00:00,130,296,14,13,606,425,181,12
8581,2022-12-24 13:00:00,128,279,8,15,683,492,191,11
8582,2022-12-24 14:00:00,136,262,7,12,508,455,53,6
8583,2022-12-24 15:00:00,129,262,7,17,541,480,61,6
8584,2022-12-24 16:00:00,123,275,8,17,561,494,67,5
8585,2022-12-24 17:00:00,122,291,5,19,666,558,108,13
8586,2022-12-24 18:00:00,148,289,11,16,625,533,92,13
8587,2022-12-24 19:00:00,123,289,11,16,748,540,208,6
8588,2022-12-24 20:00:00,127,289,6,13,768,556,212,5
8589,2022-12-24 21:00:00,143,290,11,19,786,638,148,9
8590,2022-12-24 22:00:00,133,277,10,10,561,484,77,9
8591,2022-12-24 23:00:00,137,295,14,17,548,391,157,5
8592,2022-12-25 00:00:00,123,257,9,13,738,616,122,14
8593,2022-12-25 01:00:00,134,294,9,11,572,404,168,8
8594,2022-12-25 02:00:00,148,279,9,16,594,489,105,9
8595,2022-12-25 03:00:00,121,285,10,10,739,637,102,14
8596,2022-12-25 04:00:00,121,255,7,13,648,580,68,9
8597,2022-12-25 05:00:00,123,278,13,16,586,487,99,14
8598,2022-12-25 06:00:00,127,280,14,12,619,526,93,13
8599,2022-12-25 07:00:00,142,254,10,19,766,571,195,7
8600,2022-12-25 08:00:00,131,256,6,10,785,555,230,12
8601,2022-12-25 09:00:00,126,264,14,19,733,532,201,6
8602,2022-12-25 10:00:00,131,250,14,17,656,582,74,10
8603,2022-12-25 11:00:00,132,279,6,12,506,393,113,7
8604,2022-12-25 12:00:00,145,299,12,11,567,444,123,6
8605,2022-12-25 13:00:00,133,252,10,15,793,599,194,8
8606,2022-12-25 14:00:00,142,265,12,16,537,444,93,8
8607,2022-12-25 15:00:00,138,276,8,10,579,487,92,11
8608,2022-12-25 16:00:00,129,253,5,18,710,636,74,14
8609,2022-12-25 17:00:00,144,258,7,18,605,541,64,5
8610,2022-12-25 18:00:00,127,288,5,10,612,502,110,13
8611,2022-12-25 19:00:00,131,273,5,11,665,581,84,11
8612,2022-12-25 20:00:00,140,265,7,12,574,490,84,5
8613,2022-12-25 21:00:00,120,287,14,13,612,528,84,11
8614,2022-12-25 22:00:00,120,287,9,10,549,393,156,13
8615,2022-12-25 23:00:00,142,261,13,15,785,645,140,13
8616,2022-12-26 00:00:00,122,251,5,19,529,441,88,13
8617,2022-12-26 01:00:00,143,265,14,19,679,602,77,7
8618,2022-12-26 02:00:00,132,285,6,15,640,567,73,8
8619,2022-12-26 03:00:00,143,258,11,10,583,504,79,12
8620,2022-12-26 04:00:00,143,288,10,18,541,451,90,7
8621,2022-12-26 05:00:00,142,253,11,16,582,478,104,14
8622,2022-12-26 06:00:00,129,279,13,13,698,572,126,10
8623,2022-12-26 07:00:00,134,287,11,17,508,406,102,14
8624,2022-12-26 08:00:00,139,299,13,11,653,537,116,7
8625,2022-12-26 09:00:00,141,258,8,19,592,471,121,8
8626,2022-12-26 10:00:00,126,291,7,15,536,439,97,7
8627,2022-12-26 11:00:00,148,260,13,17,652,569,83,10
8628,2022-12-26 12:00:00,137,289,5,19,581,434,147,10
8629,2022-12-26 13:00:00,133,292,13,18,690,607,83,13
8630,2022-12-26 14:00:00,130,291,12,12,600,438,162,10
8631,2022-12-26 15:00:00,123,271,8,11,722,595,127,13
8632,2022-12-26 16:00:00,126,294,5,19,574,436,138,6
8633,2022-12-26 17:00:00,135,297,8,14,632,553,79,7
8634,2022-12-26 18:00:00,140,252,9,16,618,443,175,8
8635,2022-12-26 19:00:00,134,294,9,19,705,570,135,5
8636,2022-12-26 20:00:00,120,285,12,19,789,680,109,13
8637,2022-12-26 21:00:00,142,255,14,16,622,438,184,7
8638,2022-12-26 22:00:00,138,283,13,11,563,491,72,7
8639,2022-12-26 23:00:00,143,299,8,16,561,453,108,14
8640,2022-12-27 00:00:00,129,271,6,12,607,499,108,12
8641,2022-12-27 01:00:00,124,272,13,16,768,607,161,12
8642,2022-12-27 02:00:00,137,266,10,10,670,588,82,11
8643,2022-12-27 03:00:00,136,272,10,16,687,558,129,8
8644,2022-12-27 04:00:00,129,269,7,18,641,490,151,7
8645,2022-12-27 05:00:00,139,297,6,19,747,591,156,14
8646,2022-12-27 06:00:00,127,252,13,11,726,554,172,7
8647,2022-12-27 07:00:00,134,297,5,14,665,471,194,8
8648,2022-12-27 08:00:00,148,252,9,15,670,541,129,14
8649,2022-12-27 09:00:00,120,264,7,12,701,511,190,5
8650,2022-12-27 10:00:00,140,256,6,16,681,508,173,7
8651,2022-12-27 11:00:00,130,279,7,17,705,559,146,5
8652,2022-12-27 12:00:00,144,287,11,10,523,411,112,9
8653,2022-12-27 13:00:00,136,274,10,11,550,479,71,14
8654,2022-12-27 14:00:00,120,289,10,11,748,588,160,10
8655,2022-12-27 15:00:00,124,280,14,10,602,468,134,8
8656,2022-12-27 16:00:00,135,280,13,17,670,538,132,11
8657,2022-12-27 17:00:00,126,297,14,19,583,421,162,5
8658,2022-12-27 18:00:00,149,276,10,18,649,579,70,8
8659,2022-12-27 19:00:00,127,299,13,12,782,598,184,10
8660,2022-12-27 20:00:00,124,258,14,19,700,498,202,5
8661,2022-12-27 21:00:00,133,295,6,14,695,524,171,5
8662,2022-12-27 22:00:00,147,277,14,17,693,536,157,14
8663,2022-12-27 23:00:00,136,288,9,18,660,558,102,9
8664,2022-12-28 00:00:00,131,282,9,11,600,447,153,8
8665,2022-12-28 01:00:00,140,291,5,18,561,434,127,8
8666,2022-12-28 02:00:00,149,277,6,11,622,487,135,8
8667,2022-12-28 03:00:00,123,253,14,11,628,475,153,10
8668,2022-12-28 04:00:00,148,291,10,16,501,440,61,11
8669,2022-12-28 05:00:00,134,273,13,17,783,592,191,11
8670,2022-12-28 06:00:00,134,289,13,17,629,501,128,13
8671,2022-12-28 07:00:00,138,283,11,19,531,443,88,8
8672,2022-12-28 08:00:00,132,258,5,19,768,662,106,10
8673,2022-12-28 09:00:00,128,255,7,12,524,415,109,10
8674,2022-12-28 10:00:00,123,290,7,16,694,616,78,7
8675,2022-12-28 11:00:00,127,278,7,13,715,562,153,11
8676,2022-12-28 12:00:00,145,260,6,17,517,461,56,5
8677,2022-12-28 13:00:00,145,291,14,14,621,451,170,8
8678,2022-12-28 14:00:00,123,282,13,12,568,423,145,11
8679,2022-12-28 15:00:00,140,284,13,12,735,643,92,7
8680,2022-12-28 16:00:00,147,296,7,18,597,505,92,8
8681,2022-12-28 17:00:00,145,298,6,14,581,518,63,9
8682,2022-12-28 18:00:00,120,297,5,13,555,415,140,14
8683,2022-12-28 19:00:00,130,266,6,13,541,479,62,14
8684,2022-12-28 20:00:00,129,280,7,19,794,631,163,14
8685,2022-12-28 21:00:00,132,270,8,12,515,437,78,5
8686,2022-12-28 22:00:00,141,277,13,13,585,450,135,10
8687,2022-12-28 23:00:00,124,263,6,12,529,403,126,13
8688,2022-12-29 00:00:00,122,258,5,12,786,701,85,7
8689,2022-12-29 01:00:00,140,274,8,19,694,489,205,11
8690,2022-12-29 02:00:00,144,271,9,14,757,596,161,7
8691,2022-12-29 03:00:00,148,265,10,12,581,497,84,9
8692,2022-12-29 04:00:00,133,290,13,10,550,420,130,12
8693,2022-12-29 05:00:00,141,253,8,13,597,533,64,9
8694,2022-12-29 06:00:00,125,259,5,10,582,518,64,12
8695,2022-12-29 07:00:00,122,295,8,19,739,572,167,14
8696,2022-12-29 08:00:00,147,298,14,11,574,508,66,13
8697,2022-12-29 09:00:00,128,290,8,18,660,540,120,12
8698,2022-12-29 10:00:00,130,262,13,11,620,550,70,7
8699,2022-12-29 11:00:00,142,272,13,12,543,465,78,12
8700,2022-12-29 12:00:00,122,253,10,16,681,528,153,13
8701,2022-12-29 13:00:00,137,274,5,14,626,471,155,14
8702,2022-12-29 14:00:00,146,293,8,12,673,585,88,13
8703,2022-12-29 15:00:00,130,250,13,10,598,521,77,6
8704,2022-12-29 16:00:00,129,265,13,10,748,551,197,8
8705,2022-12-29 17:00:00,124,262,11,17,582,439,143,12
8706,2022-12-29 18:00:00,126,269,7,16,521,419,102,13
8707,2022-12-29 19:00:00,147,278,14,12,748,658,90,7
8708,2022-12-29 20:00:00,134,250,6,18,695,523,172,10
8709,2022-12-29 21:00:00,122,287,10,10,746,625,121,11
8710,2022-12-29 22:00:00,122,278,5,17,769,591,178,8
8711,2022-12-29 23:00:00,147,280,6,19,703,584,119,14
8712,2022-12-30 00:00:00,143,265,6,12,571,455,116,8
8713,2022-12-30 01:00:00,134,257,5,12,550,437,113,10
8714,2022-12-30 02:00:00,144,299,13,16,707,556,151,8
8715,2022-12-30 03:00:00,128,287,10,13,530,408,122,9
8716,2022-12-30 04:00:00,139,250,9,18,674,565,109,12
8717,2022-12-30 05:00:00,139,288,11,10,516,423,93,12
8718,2022-12-30 06:00:00,147,253,6,12,595,496,99,10
8719,2022-12-30 07:00:00,131,260,12,19,782,637,145,13
8720,2022-12-30 08:00:00,135,264,12,18,736,658,78,11
8721,2022-12-30 09:00:00,147,286,5,19,512,428,84,9
8722,2022-12-30 10:00:00,133,277,10,16,575,460,115,5
8723,2022-12-30 11:00:00,123,288,9,19,763,642,121,5
8724,2022-12-30 12:00:00,127,297,13,19,722,576,146,10
8725,2022-12-30 13:00:00,141,260,8,17,594,495,99,11
8726,2022-12-30 14:00:00,149,263,11,10,767,625,142,12
8727,2022-12-30 15:00:00,140,275,7,11,510,361,149,7
8728,2022-12-30 16:00:00,143,263,6,11,754,595,159,6
8729,2022-12-30 17:00:00,132,279,12,14,794,585,209,7
8730,2022-12-30 18:00:00,121,268,13,11,678,534,144,13
8731,2022-12-30 19:00:00,130,263,11,14,715,504,211,10
8732,2022-12-30 20:00:00,136,264,11,12,631,563,68,14
8733,2022-12-30 21:00:00,124,276,6,12,788,561,227,8
8734,2022-12-30 22:00:00,140,288,10,14,622,529,93,5
8735,2022-12-30 23:00:00,132,293,9,16,686,561,125,10
8736,2022-12-31 00:00:00,136,261,14,15,509,440,69,13
8737,2022-12-31 01:00:00,130,256,5,13,539,382,157,14
8738,2022-12-31 02:00:00,135,267,11,12,575,517,58,7
8739,2022-12-31 03:00:00,145,275,14,18,513,377,136,13
8740,2022-12-31 04:00:00,138,281,7,18,703,565,138,8
8741,2022-12-31 05:00:00,132,260,5,10,663,499,164,14
8742,2022-12-31 06:00:00,149,260,6,11,759,571,188,10
8743,2022-12-31 07:00:00,140,280,8,16,766,687,79,7
8744,2022-12-31 08:00:00,129,295,11,11,751,527,224,6
8745,2022-12-31 09:00:00,135,279,9,16,676,595,81,6
8746,2022-12-31 10:00:00,129,257,12,13,791,647,144,13
8747,2022-12-31 11:00:00,129,274,7,15,586,501,85,13
8748,2022-12-31 12:00:00,133,276,14,17,795,622,173,6
8749,2022-12-31 13:00:00,125,265,9,19,633,544,89,13
8750,2022-12-31 14:00:00,142,252,11,12,571,465,106,8
8751,2022-12-31 15:00:00,143,264,9,13,621,554,67,9
8752,2022-12-31 16:00:00,136,279,11,15,773,542,231,7
8753,2022-12-31 17:00:00,122,293,13,17,777,644,133,8
8754,2022-12-31 18:00:00,133,259,6,18,679,585,94,6
8755,2022-12-31 19:00:00,136,298,5,18,609,514,95,7
8756,2022-12-31 20:00:00,147,254,5,17,750,572,178,5
8757,2022-12-31 21:00:00,147,288,7,13,593,512,81,6
8758,2022-12-31 22:00:00,129,290,8,13,720,549,171,14
8759,2022-12-31 23:00:00,120,270,7,17,583,476,107,9
8760,2023-01-01 00:00:00,124,292,10,12,650,474,176,5
8761,2023-01-01 01:00:00,127,294,12,16,684,554,130,14
8762,2023-01-01 02:00:00,134,252,14,15,752,631,121,11
8763,2023-01-01 03:00:00,145,273,7,17,581,493,88,8
8764,2023-01-01 04:00:00,129,298,10,13,792,659,133,5
8765,2023-01-01 05:00:00,139,288,5,16,537,473,64,12
8766,2023-01-01 06:00:00,131,289,11,13,719,514,205,6
8767,2023-01-01 07:00:00,135,291,10,10,609,490,119,8
8768,2023-01-01 08:00:00,124,295,13,11,552,434,118,5
8769,2023-01-01 09:00:00,145,266,6,12,535,423,112,9
8770,2023-01-01 10:00:00,124,288,6,15,613,531,82,14
8771,2023-01-01 11:00:00,147,255,6,15,715,573,142,12
8772,2023-01-01 12:00:00,133,281,7,16,786,701,85,7
8773,2023-01-01 13:00:00,138,295,6,16,708,496,212,8
8774,2023-01-01 14:00:00,129,259,9,11,629,555,74,14
8775,2023-01-01 15:00:00,121,281,14,19,792,696,96,5
8776,2023-01-01 16:00:00,147,257,12,10,622,544,78,13
8777,2023-01-01 17:00:00,149,298,6,10,565,415,150,13
8778,2023-01-01 18:00:00,142,274,8,19,639,484,155,13
8779,2023-01-01 19:00:00,144,268,14,12,534,449,85,7
8780,2023-01-01 20:00:00,141,252,5,11,661,472,189,6
8781,2023-01-01 21:00:00,148,262,14,12,548,464,84,8
8782,2023-01-01 22:00:00,130,256,5,15,589,422,167,13
8783,2023-01-01 23:00:00,135,284,8,14,526,417,109,9
8784,2023-01-02 00:00:00,139,264,11,13,601,494,107,10
8785,2023-01-02 01:00:00,129,289,12,19,716,613,103,13
8786,2023-01-02 02:00:00,129,273,6,11,711,557,154,13
8787,2023-01-02 03:00:00,147,259,6,15,776,554,222,14
8788,2023-01-02 04:00:00,142,274,7,14,720,562,158,6
8789,2023-01-02 05:00:00,145,253,13,13,639,505,134,13
8790,2023-01-02 06:00:00,123,254,6,12,771,579,192,11
8791,2023-01-02 07:00:00,123,286,11,12,703,509,194,7
8792,2023-01-02 08:00:00,129,276,6,18,540,460,80,14
8793,2023-01-02 09:00:00,145,270,7,15,636,454,182,8
8794,2023-01-02 10:00:00,135,292,11,19,666,541,125,8
8795,2023-01-02 11:00:00,140,273,14,10,579,439,140,7
8796,2023-01-02 12:00:00,123,292,14,14,709,552,157,13
8797,2023-01-02 13:00:00,142,297,12,14,778,636,142,7
8798,2023-01-02 14:00:00,124,278,10,12,734,623,111,7
8799,2023-01-02 15:00:00,125,295,10,18,567,477,90,9
8800,2023-01-02 16:00:00,145,297,5,18,690,532,158,11
8801,2023-01-02 17:00:00,132,283,8,19,745,596,149,11
8802,2023-01-02 18:00:00,122,252,11,17,744,541,203,7
8803,2023-01-02 19:00:00,133,279,12,10,565,423,142,6
8804,2023-01-02 20:00:00,122,261,8,11,541,411,130,14
8805,2023-01-02 21:00:00,142,290,8,14,768,659,109,12
8806,2023-01-02 22:00:00,130,274,5,13,669,530,139,12
8807,2023-01-02 23:00:00,142,254,6,18,549,443,106,14
8808,2023-01-03 00:00:00,131,268,11,15,547,462,85,6
8809,2023-01-03 01:00:00,142,255,12,16,566,489,77,6
8810,2023-01-03 02:00:00,127,253,14,15,717,539,178,7
8811,2023-01-03 03:00:00,143,267,7,15,776,625,151,5
8812,2023-01-03 04:00:00,143,276,8,14,718,597,121,7
8813,2023-01-03 05:00:00,128,283,6,10,635,473,162,6
8814,2023-01-03 06:00:00,125,291,9,17,578,421,157,10
8815,2023-01-03 07:00:00,126,295,5,13,642,575,67,7
8816,2023-01-03 08:00:00,140,260,12,13,625,512,113,10
8817,2023-01-03 09:00:00,124,265,10,14,654,557,97,12
8818,2023-01-03 10:00:00,132,259,12,16,610,458,152,7
8819,2023-01-03 11:00:00,144,261,11,13,768,614,154,9
8820,2023-01-03 12:00:00,129,289,6,12,528,411,117,13
8821,2023-01-03 13:00:00,144,265,5,17,636,490,146,6
8822,2023-01-03 14:00:00,135,279,11,19,513,435,78,7
8823,2023-01-03 15:00:00,140,265,14,17,524,454,70,10
8824,2023-01-03 16:00:00,142,287,8,15,675,569,106,10
8825,2023-01-03 17:00:00,135,261,13,18,686,544,142,14
8826,2023-01-03 18:00:00,124,270,6,15,552,485,67,13
8827,2023-01-03 19:00:00,127,297,5,19,555,423,132,13
8828,2023-01-03 20:00:00,127,295,14,18,654,577,77,8
8829,2023-01-03 21:00:00,134,285,5,10,687,544,143,12
8830,2023-01-03 22:00:00,125,266,14,12,674,559,115,10
8831,2023-01-03 23:00:00,149,278,9,13,746,526,220,6
8832,2023-01-04 00:00:00,121,283,13,15,713,578,135,14
8833,2023-01-04 01:00:00,126,282,11,17,535,387,148,9
8834,2023-01-04 02:00:00,139,286,13,16,711,549,162,9
8835,2023-01-04 03:00:00,124,260,9,15,780,593,187,13
8836,2023-01-04 04:00:00,139,285,5,11,731,630,101,11
8837,2023-01-04 05:00:00,144,278,10,10,740,614,126,5
8838,2023-01-04 06:00:00,136,262,8,19,675,596,79,12
8839,2023-01-04 07:00:00,122,253,13,13,607,481,126,9
8840,2023-01-04 08:00:00,130,281,13,16,723,522,201,8
8841,2023-01-04 09:00:00,148,278,5,14,686,571,115,9
8842,2023-01-04 10:00:00,136,293,7,12,608,508,100,7
8843,2023-01-04 11:00:00,126,273,5,11,603,496,107,9
8844,2023-01-04 12:00:00,138,258,5,10,750,673,77,9
8845,2023-01-04 13:00:00,143,263,8,15,617,451,166,14
8846,2023-01-04 14:00:00,140,290,5,17,608,504,104,13
8847,2023-01-04 15:00:00,147,257,10,15,505,362,143,11
8848,2023-01-04 16:00:00,129,275,5,18,653,503,150,6
8849,2023-01-04 17:00:00,131,291,7,17,685,496,189,14
8850,2023-01-04 18:00:00,124,250,13,10,567,422,145,8
8851,2023-01-04 19:00:00,126,277,14,10,618,539,79,10
8852,2023-01-04 20:00:00,138,268,11,17,638,571,67,6
8853,2023-01-04 21:00:00,130,251,11,13,549,393,156,7
8854,2023-01-04 22:00:00,122,263,9,16,540,401,139,13
8855,2023-01-04 23:00:00,121,273,6,15,560,429,131,14
8856,2023-01-05 00:00:00,147,276,14,15,538,387,151,13
8857,2023-01-05 01:00:00,139,263,13,19,649,574,75,8
8858,2023-01-05 02:00:00,130,279,10,12,777,609,168,12
8859,2023-01-05 03:00:00,136,256,14,17,581,453,128,6
8860,2023-01-05 04:00:00,126,288,11,19,783,668,115,14
8861,2023-01-05 05:00:00,144,282,7,11,710,567,143,13
8862,2023-01-05 06:00:00,121,278,12,11,675,587,88,10
8863,2023-01-05 07:00:00,130,296,5,11,695,616,79,14
8864,2023-01-05 08:00:00,121,281,5,14,558,439,119,9
8865,2023-01-05 09:00:00,137,272,12,13,536,449,87,6
8866,2023-01-05 10:00:00,147,288,11,18,526,446,80,10
8867,2023-01-05 11:00:00,139,258,7,14,619,506,113,13
8868,2023-01-05 12:00:00,143,294,14,12,714,601,113,7
8869,2023-01-05 13:00:00,123,265,6,17,546,388,158,6
8870,2023-01-05 14:00:00,145,297,7,13,793,576,217,9
8871,2023-01-05 15:00:00,147,294,7,15,625,531,94,5
8872,2023-01-05 16:00:00,123,269,8,13,500,366,134,10
8873,2023-01-05 17:00:00,139,277,9,19,577,508,69,12
8874,2023-01-05 18:00:00,137,299,7,15,757,589,168,9
8875,2023-01-05 19:00:00,135,295,7,18,568,490,78,8
8876,2023-01-05 20:00:00,126,293,7,12,629,447,182,6
8877,2023-01-05 21:00:00,141,274,7,17,617,536,81,12
8878,2023-01-05 22:00:00,148,269,12,10,713,622,91,10
8879,2023-01-05 23:00:00,122,291,9,10,777,553,224,11
8880,2023-01-06 00:00:00,140,264,11,15,785,569,216,7
8881,2023-01-06 01:00:00,121,297,13,12,725,596,129,14
8882,2023-01-06 02:00:00,134,268,13,15,601,423,178,6
8883,2023-01-06 03:00:00,148,279,11,11,774,653,121,11
8884,2023-01-06 04:00:00,144,270,12,12,631,507,124,8
8885,2023-01-06 05:00:00,125,299,6,13,561,438,123,12
8886,2023-01-06 06:00:00,135,260,5,15,529,475,54,12
8887,2023-01-06 07:00:00,147,271,12,17,634,500,134,6
8888,2023-01-06 08:00:00,127,259,10,11,613,470,143,10
8889,2023-01-06 09:00:00,124,274,10,16,799,709,90,5
8890,2023-01-06 10:00:00,123,284,12,18,644,478,166,11
8891,2023-01-06 11:00:00,138,266,11,13,669,489,180,6
8892,2023-01-06 12:00:00,122,263,8,19,749,536,213,11
8893,2023-01-06 13:00:00,142,285,5,11,717,558,159,8
8894,2023-01-06 14:00:00,148,279,14,14,718,640,78,8
8895,2023-01-06 15:00:00,148,275,13,16,694,616,78,11
8896,2023-01-06 16:00:00,147,255,9,18,700,550,150,12
8897,2023-01-06 17:00:00,143,254,7,16,598,430,168,10
8898,2023-01-06 18:00:00,134,277,10,16,518,429,89,5
8899,2023-01-06 19:00:00,123,257,9,19,752,558,194,14
8900,2023-01-06 20:00:00,127,257,10,12,737,562,175,5
8901,2023-01-06 21:00:00,139,263,9,18,518,421,97,8
8902,2023-01-06 22:00:00,146,250,7,10,504,428,76,13
8903,2023-01-06 23:00:00,131,286,13,16,600,525,75,10
8904,2023-01-07 00:00:00,138,252,8,19,519,415,104,6
8905,2023-01-07 01:00:00,132,295,9,12,518,388,130,7
8906,2023-01-07 02:00:00,145,261,12,10,798,582,216,9
8907,2023-01-07 03:00:00,141,295,9,17,671,582,89,5
8908,2023-01-07 04:00:00,125,285,7,15,727,652,75,6
8909,2023-01-07 05:00:00,141,286,11,14,696,579,117,10
8910,2023-01-07 06:00:00,131,285,5,14,613,435,178,10
8911,2023-01-07 07:00:00,123,263,12,11,636,545,91,10
8912,2023-01-07 08:00:00,123,272,12,10,581,462,119,8
8913,2023-01-07 09:00:00,129,258,11,14,524,404,120,11
8914,2023-01-07 10:00:00,145,290,12,15,617,534,83,7
8915,2023-01-07 11:00:00,123,288,8,19,654,507,147,12
8916,2023-01-07 12:00:00,128,277,12,13,646,509,137,8
8917,2023-01-07 13:00:00,144,259,10,17,569,434,135,6
8918,2023-01-07 14:00:00,120,277,5,11,513,447,66,9
8919,2023-01-07 15:00:00,122,263,10,18,604,511,93,8
8920,2023-01-07 16:00:00,126,276,7,19,631,550,81,7
8921,2023-01-07 17:00:00,126,252,10,14,636,531,105,14
8922,2023-01-07 18:00:00,138,273,7,12,730,645,85,5
8923,2023-01-07 19:00:00,145,268,8,16,598,508,90,9
8924,2023-01-07 20:00:00,127,294,10,11,763,537,226,10
8925,2023-01-07 21:00:00,146,253,9,13,500,422,78,5
8926,2023-01-07 22:00:00,144,291,14,14,732,540,192,5
8927,2023-01-07 23:00:00,129,256,11,18,532,403,129,8
8928,2023-01-08 00:00:00,136,297,13,16,633,449,184,8
8929,2023-01-08 01:00:00,130,266,12,11,770,616,154,13
8930,2023-01-08 02:00:00,148,294,9,16,521,388,133,12
8931,2023-01-08 03:00:00,128,265,13,13,640,528,112,10
8932,2023-01-08 04:00:00,144,268,7,14,683,523,160,7
8933,2023-01-08 05:00:00,122,264,9,12,533,460,73,8
8934,2023-01-08 06:00:00,147,254,5,16,508,430,78,11
8935,2023-01-08 07:00:00,141,283,9,14,532,467,65,10
8936,2023-01-08 08:00:00,142,288,7,10,624,477,147,6
8937,2023-01-08 09:00:00,142,294,7,16,570,420,150,12
8938,2023-01-08 10:00:00,136,294,5,11,650,516,134,8
8939,2023-01-08 11:00:00,138,294,8,18,522,427,95,14
8940,2023-01-08 12:00:00,139,286,10,12,787,629,158,13
8941,2023-01-08 13:00:00,131,255,6,18,723,528,195,11
8942,2023-01-08 14:00:00,148,295,6,16,701,546,155,10
8943,2023-01-08 15:00:00,124,262,12,17,574,437,137,13
8944,2023-01-08 16:00:00,125,275,13,12,781,644,137,7
8945,2023-01-08 17:00:00,125,291,13,17,583,477,106,6
8946,2023-01-08 18:00:00,129,283,12,12,529,410,119,11
8947,2023-01-08 19:00:00,139,259,9,13,723,643,80,8
8948,2023-01-08 20:00:00,130,298,9,14,793,621,172,8
8949,2023-01-08 21:00:00,138,280,14,16,568,458,110,6
8950,2023-01-08 22:00:00,146,256,14,13,736,649,87,13
8951,2023-01-08 23:00:00,123,269,6,10,724,594,130,14
8952,2023-01-09 00:00:00,133,256,12,15,559,419,140,12
8953,2023-01-09 01:00:00,128,272,12,13,763,664,99,6
8954,2023-01-09 02:00:00,129,275,13,18,744,645,99,10
8955,2023-01-09 03:00:00,123,258,7,14,725,646,79,8
8956,2023-01-09 04:00:00,138,278,10,11,735,657,78,7
8957,2023-01-09 05:00:00,122,259,9,16,786,650,136,12
8958,2023-01-09 06:00:00,145,264,8,19,635,549,86,12
8959,2023-01-09 07:00:00,134,265,7,19,667,468,199,7
8960,2023-01-09 08:00:00,149,285,12,14,545,450,95,6
8961,2023-01-09 09:00:00,132,293,8,10,550,457,93,13
8962,2023-01-09 10:00:00,148,260,10,11,750,670,80,5
8963,2023-01-09 11:00:00,138,266,8,16,673,551,122,5
8964,2023-01-09 12:00:00,132,254,7,12,772,595,177,14
8965,2023-01-09 13:00:00,147,268,6,10,620,474,146,5
8966,2023-01-09 14:00:00,142,289,13,19,582,423,159,14
8967,2023-01-09 15:00:00,144,268,5,17,642,576,66,13
8968,2023-01-09 16:00:00,122,259,11,14,658,501,157,5
8969,2023-01-09 17:00:00,128,295,8,10,687,565,122,6
8970,2023-01-09 18:00:00,141,262,11,18,700,538,162,9
8971,2023-01-09 19:00:00,148,267,8,15,739,525,214,9
8972,2023-01-09 20:00:00,135,257,7,14,530,380,150,13
8973,2023-01-09 21:00:00,136,261,6,18,690,616,74,5
8974,2023-01-09 22:00:00,148,280,9,17,752,655,97,11
8975,2023-01-09 23:00:00,146,279,8,10,785,637,148,8
8976,2023-01-10 00:00:00,120,285,7,14,732,594,138,6
8977,2023-01-10 01:00:00,142,270,9,11,720,515,205,9
8978,2023-01-10 02:00:00,125,273,12,18,564,448,116,14
8979,2023-01-10 03:00:00,134,289,12,14,738,570,168,11
8980,2023-01-10 04:00:00,126,260,6,10,764,677,87,9
8981,2023-01-10 05:00:00,148,272,11,10,535,451,84,5
8982,2023-01-10 06:00:00,139,276,5,14,749,544,205,5
8983,2023-01-10 07:00:00,149,284,9,17,782,662,120,11
8984,2023-01-10 08:00:00,125,293,11,12,793,583,210,11
8985,2023-01-10 09:00:00,132,295,7,14,741,659,82,10
8986,2023-01-10 10:00:00,125,251,8,13,694,618,76,7
8987,2023-01-10 11:00:00,133,261,12,19,596,485,111,7
8988,2023-01-10 12:00:00,128,288,12,11,577,475,102,14
8989,2023-01-10 13:00:00,131,265,12,14,774,673,101,8
8990,2023-01-10 14:00:00,136,267,14,19,643,534,109,12
8991,2023-01-10 15:00:00,140,291,6,16,530,458,72,7
8992,2023-01-10 16:00:00,129,251,10,12,577,465,112,14
8993,2023-01-10 17:00:00,123,293,10,19,721,569,152,6
8994,2023-01-10 18:00:00,134,267,8,19,623,491,132,10
8995,2023-01-10 19:00:00,132,271,7,18,779,694,85,7
8996,2023-01-10 20:00:00,148,262,13,19,510,410,100,5
8997,2023-01-10 21:00:00,132,257,8,11,502,433,69,5
8998,2023-01-10 22:00:00,141,250,8,17,786,647,139,12
8999,2023-01-10 23:00:00,142,259,7,19,519,384,135,9
9000,2023-01-11 00:00:00,125,290,7,16,547,405,142,6
9001,2023-01-11 01:00:00,130,281,7,10,511,439,72,10
9002,2023-01-11 02:00:00,121,282,13,12,562,457,105,12
9003,2023-01-11 03:00:00,134,258,12,17,672,488,184,14
9004,2023-01-11 04:00:00,137,286,14,14,611,523,88,11
9005,2023-01-11 05:00:00,148,276,6,10,605,499,106,5
9006,2023-01-11 06:00:00,149,274,7,16,592,485,107,6
9007,2023-01-11 07:00:00,146,284,6,13,560,491,69,13
9008,2023-01-11 08:00:00,132,264,5,13,610,523,87,13
9009,2023-01-11 09:00:00,120,278,6,13,768,640,128,13
9010,2023-01-11 10:00:00,137,268,14,14,737,617,120,5
9011,2023-01-11 11:00:00,129,294,10,13,552,407,145,10
9012,2023-01-11 12:00:00,144,269,11,12,790,618,172,8
9013,2023-01-11 13:00:00,133,295,13,11,514,378,136,11
9014,2023-01-11 14:00:00,132,278,8,16,639,566,73,12
9015,2023-01-11 15:00:00,143,256,8,14,736,579,157,5
9016,2023-01-11 16:00:00,127,263,5,10,737,517,220,14
9017,2023-01-11 17:00:00,146,263,8,16,741,584,157,8
9018,2023-01-11 18:00:00,149,253,12,12,714,518,196,6
9019,2023-01-11 19:00:00,124,285,9,12,626,462,164,14
9020,2023-01-11 20:00:00,121,297,5,13,638,505,133,7
9021,2023-01-11 21:00:00,122,293,9,16,525,369,156,7
9022,2023-01-11 22:00:00,139,278,8,14,689,516,173,10
9023,2023-01-11 23:00:00,129,265,11,11,620,535,85,5
9024,2023-01-12 00:00:00,130,254,7,16,681,576,105,11
9025,2023-01-12 01:00:00,125,256,10,18,528,405,123,10
9026,2023-01-12 02:00:00,148,252,9,10,557,490,67,10
9027,2023-01-12 03:00:00,140,265,11,16,784,576,208,14
9028,2023-01-12 04:00:00,138,259,13,12,665,544,121,8
9029,2023-01-12 05:00:00,138,280,13,11,579,514,65,13
9030,2023-01-12 06:00:00,149,287,5,16,708,631,77,9
9031,2023-01-12 07:00:00,130,257,14,18,672,554,118,10
9032,2023-01-12 08:00:00,124,250,11,10,630,483,147,8
9033,2023-01-12 09:00:00,123,294,10,11,700,609,91,12
9034,2023-01-12 10:00:00,123,270,5,13,644,453,191,8
9035,2023-01-12 11:00:00,136,268,9,18,663,467,196,13
9036,2023-01-12 12:00:00,148,277,12,13,790,557,233,14
9037,2023-01-12 13:00:00,136,262,13,13,518,376,142,12
9038,2023-01-12 14:00:00,138,278,5,11,666,518,148,8
9039,2023-01-12 15:00:00,137,283,12,18,665,571,94,6
9040,2023-01-12 16:00:00,148,275,5,17,696,617,79,12
9041,2023-01-12 17:00:00,130,262,12,13,542,448,94,7
9042,2023-01-12 18:00:00,123,275,9,18,525,420,105,8
9043,2023-01-12 19:00:00,128,294,8,12,756,676,80,12
9044,2023-01-12 20:00:00,139,265,10,14,658,480,178,6
9045,2023-01-12 21:00:00,126,279,12,18,697,517,180,7
9046,2023-01-12 22:00:00,146,290,11,17,658,485,173,13
9047,2023-01-12 23:00:00,144,273,6,16,685,505,180,6
9048,2023-01-13 00:00:00,148,254,5,18,669,593,76,14
9049,2023-01-13 01:00:00,130,281,11,17,789,704,85,11
9050,2023-01-13 02:00:00,148,292,6,15,551,406,145,11
9051,2023-01-13 03:00:00,128,276,8,14,596,485,111,13
9052,2023-01-13 04:00:00,125,252,5,17,603,424,179,7
9053,2023-01-13 05:00:00,146,272,14,13,671,500,171,13
9054,2023-01-13 06:00:00,135,269,5,15,759,591,168,12
9055,2023-01-13 07:00:00,138,278,5,14,775,611,164,5
9056,2023-01-13 08:00:00,125,269,7,10,701,607,94,9
9057,2023-01-13 09:00:00,141,289,13,14,704,633,71,12
9058,2023-01-13 10:00:00,121,251,11,19,505,392,113,9
9059,2023-01-13 11:00:00,123,293,9,17,685,496,189,9
9060,2023-01-13 12:00:00,123,287,14,10,506,435,71,6
9061,2023-01-13 13:00:00,146,270,11,16,796,698,98,11
9062,2023-01-13 14:00:00,143,286,6,14,797,690,107,7
9063,2023-01-13 15:00:00,139,273,6,10,534,475,59,14
9064,2023-01-13 16:00:00,132,285,5,12,657,514,143,9
9065,2023-01-13 17:00:00,135,295,12,10,747,579,168,5
9066,2023-01-13 18:00:00,126,298,9,19,778,567,211,8
9067,2023-01-13 19:00:00,146,293,9,13,755,558,197,11
9068,2023-01-13 20:00:00,121,258,7,17,557,401,156,8
9069,2023-01-13 21:00:00,120,296,12,13,562,499,63,12
9070,2023-01-13 22:00:00,146,297,7,12,695,602,93,9
9071,2023-01-13 23:00:00,132,281,6,15,664,477,187,5
9072,2023-01-14 00:00:00,133,268,11,12,563,441,122,8
9073,2023-01-14 01:00:00,141,283,9,11,540,378,162,13
9074,2023-01-14 02:00:00,141,259,13,10,589,433,156,11
9075,2023-01-14 03:00:00,148,275,12,13,546,402,144,6
9076,2023-01-14 04:00:00,144,298,14,13,702,534,168,6
9077,2023-01-14 05:00:00,132,281,5,11,750,628,122,7
9078,2023-01-14 06:00:00,123,289,13,14,724,619,105,13
9079,2023-01-14 07:00:00,123,269,11,16,724,561,163,10
9080,2023-01-14 08:00:00,147,291,7,11,770,582,188,8
9081,2023-01-14 09:00:00,126,253,6,16,691,606,85,12
9082,2023-01-14 10:00:00,141,296,5,11,574,405,169,5
9083,2023-01-14 11:00:00,120,259,10,12,551,487,64,10
9084,2023-01-14 12:00:00,149,295,6,19,667,540,127,8
9085,2023-01-14 13:00:00,146,272,13,19,501,403,98,7
9086,2023-01-14 14:00:00,123,274,12,16,617,539,78,9
9087,2023-01-14 15:00:00,149,265,14,18,516,459,57,9
9088,2023-01-14 16:00:00,146,261,8,19,798,617,181,6
9089,2023-01-14 17:00:00,135,263,11,13,625,504,121,13
9090,2023-01-14 18:00:00,126,266,14,14,597,514,83,14
9091,2023-01-14 19:00:00,143,260,9,19,616,500,116,11
9092,2023-01-14 20:00:00,125,285,5,10,523,437,86,13
9093,2023-01-14 21:00:00,128,283,14,12,518,456,62,5
9094,2023-01-14 22:00:00,130,299,6,16,523,428,95,7
9095,2023-01-14 23:00:00,146,255,6,19,533,427,106,13
9096,2023-01-15 00:00:00,126,252,13,14,664,489,175,13
9097,2023-01-15 01:00:00,147,257,7,19,532,377,155,7
9098,2023-01-15 02:00:00,146,250,11,18,589,438,151,11
9099,2023-01-15 03:00:00,132,279,14,17,726,534,192,5
9100,2023-01-15 04:00:00,123,258,12,14,668,536,132,5
9101,2023-01-15 05:00:00,128,277,14,18,765,567,198,10
9102,2023-01-15 06:00:00,136,270,8,18,672,546,126,8
9103,2023-01-15 07:00:00,134,272,9,12,545,384,161,6
9104,2023-01-15 08:00:00,132,280,7,13,703,511,192,13
9105,2023-01-15 09:00:00,128,276,13,12,755,551,204,13
9106,2023-01-15 10:00:00,147,252,14,11,719,540,179,12
9107,2023-01-15 11:00:00,139,298,11,18,634,525,109,11
9108,2023-01-15 12:00:00,145,260,9,15,588,448,140,12
9109,2023-01-15 13:00:00,123,256,6,16,541,440,101,8
9110,2023-01-15 14:00:00,147,272,11,19,679,503,176,12
9111,2023-01-15 15:00:00,134,295,5,13,513,436,77,5
9112,2023-01-15 16:00:00,121,265,8,12,696,548,148,8
9113,2023-01-15 17:00:00,128,252,11,16,722,638,84,6
9114,2023-01-15 18:00:00,147,298,11,16,531,458,73,14
9115,2023-01-15 19:00:00,143,287,8,15,611,503,108,9
9116,2023-01-15 20:00:00,143,265,8,19,572,454,118,12
9117,2023-01-15 21:00:00,140,264,12,12,781,655,126,14
9118,2023-01-15 22:00:00,135,277,5,14,548,444,104,12
9119,2023-01-15 23:00:00,127,258,10,15,720,591,129,10
9120,2023-01-16 00:00:00,133,287,11,11,674,570,104,7
9121,2023-01-16 01:00:00,129,266,14,17,762,672,90,8
9122,2023-01-16 02:00:00,137,293,13,18,634,556,78,8
9123,2023-01-16 03:00:00,125,270,6,18,555,426,129,13
9124,2023-01-16 04:00:00,147,294,14,19,714,621,93,12
9125,2023-01-16 05:00:00,130,280,9,13,662,468,194,5
9126,2023-01-16 06:00:00,148,292,12,13,680,581,99,12
9127,2023-01-16 07:00:00,142,274,12,13,650,496,154,6
9128,2023-01-16 08:00:00,141,287,14,15,635,486,149,13
9129,2023-01-16 09:00:00,147,277,9,15,589,454,135,9
9130,2023-01-16 10:00:00,126,273,7,10,588,452,136,10
9131,2023-01-16 11:00:00,142,250,8,13,544,436,108,6
9132,2023-01-16 12:00:00,141,288,7,14,746,591,155,6
9133,2023-01-16 13:00:00,137,279,5,15,723,639,84,6
9134,2023-01-16 14:00:00,135,294,10,18,796,628,168,11
9135,2023-01-16 15:00:00,140,261,10,11,673,559,114,12
9136,2023-01-16 16:00:00,143,262,5,16,784,682,102,14
9137,2023-01-16 17:00:00,126,259,11,11,570,467,103,9
9138,2023-01-16 18:00:00,140,251,12,18,629,532,97,11
9139,2023-01-16 19:00:00,149,286,12,10,695,501,194,5
9140,2023-01-16 20:00:00,126,250,10,15,740,532,208,7
9141,2023-01-16 21:00:00,144,260,11,17,775,594,181,5
9142,2023-01-16 22:00:00,143,281,13,12,623,485,138,12
9143,2023-01-16 23:00:00,146,264,9,12,689,518,171,10
9144,2023-01-17 00:00:00,124,263,5,18,642,534,108,11
9145,2023-01-17 01:00:00,133,279,9,15,686,582,104,14
9146,2023-01-17 02:00:00,121,271,9,12,706,600,106,7
9147,2023-01-17 03:00:00,140,257,5,18,549,459,90,6
9148,2023-01-17 04:00:00,124,274,8,14,532,382,150,5
9149,2023-01-17 05:00:00,120,299,11,18,646,540,106,13
9150,2023-01-17 06:00:00,123,277,14,13,502,404,98,14
9151,2023-01-17 07:00:00,143,298,9,11,508,442,66,12
9152,2023-01-17 08:00:00,140,251,8,17,533,464,69,13
9153,2023-01-17 09:00:00,121,270,6,15,702,630,72,8
9154,2023-01-17 10:00:00,138,292,5,14,510,427,83,14
9155,2023-01-17 11:00:00,147,277,7,10,604,446,158,14
9156,2023-01-17 12:00:00,127,271,10,14,596,454,142,10
9157,2023-01-17 13:00:00,125,267,11,10,594,475,119,9
9158,2023-01-17 14:00:00,126,296,14,13,734,608,126,13
9159,2023-01-17 15:00:00,141,258,11,13,722,638,84,10
9160,2023-01-17 16:00:00,122,279,11,11,788,668,120,12
9161,2023-01-17 17:00:00,147,283,10,13,517,376,141,11
9162,2023-01-17 18:00:00,124,285,12,11,795,655,140,11
9163,2023-01-17 19:00:00,128,266,9,12,641,450,191,14
9164,2023-01-17 20:00:00,140,275,11,16,585,476,109,6
9165,2023-01-17 21:00:00,144,269,13,16,735,565,170,5
9166,2023-01-17 22:00:00,135,292,14,10,521,434,87,11
9167,2023-01-17 23:00:00,121,261,12,18,788,577,211,5
9168,2023-01-18 00:00:00,120,252,12,12,731,641,90,7
9169,2023-01-18 01:00:00,132,286,11,13,563,495,68,11
9170,2023-01-18 02:00:00,146,267,13,15,681,606,75,9
9171,2023-01-18 03:00:00,144,258,13,10,606,434,172,12
9172,2023-01-18 04:00:00,132,276,10,13,789,575,214,11
9173,2023-01-18 05:00:00,148,257,6,15,779,638,141,12
9174,2023-01-18 06:00:00,149,297,8,10,767,629,138,13
9175,2023-01-18 07:00:00,140,265,12,18,775,661,114,7
9176,2023-01-18 08:00:00,128,284,11,13,776,553,223,13
9177,2023-01-18 09:00:00,139,283,10,13,512,420,92,13
9178,2023-01-18 10:00:00,141,292,12,17,769,605,164,10
9179,2023-01-18 11:00:00,125,290,5,13,542,467,75,9
9180,2023-01-18 12:00:00,131,292,5,18,641,486,155,13
9181,2023-01-18 13:00:00,121,282,14,16,608,441,167,11
9182,2023-01-18 14:00:00,148,253,8,10,719,611,108,6
9183,2023-01-18 15:00:00,122,275,11,16,668,485,183,14
9184,2023-01-18 16:00:00,137,273,7,19,767,674,93,5
9185,2023-01-18 17:00:00,142,293,12,13,779,547,232,10
9186,2023-01-18 18:00:00,133,257,10,11,637,498,139,11
9187,2023-01-18 19:00:00,143,267,11,13,509,415,94,9
9188,2023-01-18 20:00:00,137,271,11,15,595,420,175,5
9189,2023-01-18 21:00:00,126,262,7,15,593,443,150,12
9190,2023-01-18 22:00:00,131,284,7,13,510,433,77,7
9191,2023-01-18 23:00:00,144,288,11,15,666,469,197,5
9192,2023-01-19 00:00:00,133,271,9,18,564,399,165,10
9193,2023-01-19 01:00:00,130,265,13,14,671,489,182,10
9194,2023-01-19 02:00:00,134,295,11,14,514,423,91,9
9195,2023-01-19 03:00:00,138,277,14,11,520,461,59,14
9196,2023-01-19 04:00:00,144,291,8,18,715,596,119,10
9197,2023-01-19 05:00:00,135,292,11,19,506,377,129,10
9198,2023-01-19 06:00:00,134,253,10,17,520,406,114,13
9199,2023-01-19 07:00:00,143,274,8,14,683,586,97,5
9200,2023-01-19 08:00:00,129,277,12,19,751,611,140,11
9201,2023-01-19 09:00:00,144,294,6,12,710,632,78,9
9202,2023-01-19 10:00:00,122,255,11,11,544,389,155,5
9203,2023-01-19 11:00:00,131,293,10,19,584,432,152,6
9204,2023-01-19 12:00:00,139,262,8,13,595,467,128,10
9205,2023-01-19 13:00:00,121,275,8,17,637,484,153,11
9206,2023-01-19 14:00:00,133,262,10,19,752,544,208,6
9207,2023-01-19 15:00:00,145,293,13,11,504,449,55,12
9208,2023-01-19 16:00:00,147,288,6,16,509,360,149,6
9209,2023-01-19 17:00:00,146,250,9,18,526,375,151,10
9210,2023-01-19 18:00:00,121,258,7,11,591,527,64,14
9211,2023-01-19 19:00:00,138,255,8,17,559,409,150,6
9212,2023-01-19 20:00:00,122,273,6,13,610,459,151,6
9213,2023-01-19 21:00:00,147,291,12,13,604,522,82,12
9214,2023-01-19 22:00:00,127,286,5,18,641,452,189,12
9215,2023-01-19 23:00:00,140,277,5,11,774,591,183,14
9216,2023-01-20 00:00:00,131,253,8,10,664,479,185,11
9217,2023-01-20 01:00:00,131,257,6,12,537,477,60,14
9218,2023-01-20 02:00:00,142,256,7,15,715,613,102,13
9219,2023-01-20 03:00:00,136,266,9,16,737,569,168,9
9220,2023-01-20 04:00:00,128,254,8,17,582,452,130,7
9221,2023-01-20 05:00:00,143,291,9,18,583,510,73,12
9222,2023-01-20 06:00:00,149,270,11,15,567,474,93,9
9223,2023-01-20 07:00:00,136,280,13,16,755,628,127,9
9224,2023-01-20 08:00:00,136,267,14,17,775,613,162,8
9225,2023-01-20 09:00:00,139,283,14,18,592,521,71,12
9226,2023-01-20 10:00:00,137,252,6,19,753,562,191,13
9227,2023-01-20 11:00:00,136,282,10,19,553,393,160,9
9228,2023-01-20 12:00:00,140,279,9,16,517,394,123,11
9229,2023-01-20 13:00:00,130,279,11,17,593,477,116,7
9230,2023-01-20 14:00:00,144,285,14,17,550,446,104,11
9231,2023-01-20 15:00:00,128,279,7,18,664,521,143,12
9232,2023-01-20 16:00:00,144,278,14,16,617,484,133,13
9233,2023-01-20 17:00:00,129,262,6,19,670,577,93,10
9234,2023-01-20 18:00:00,147,291,11,10,795,616,179,11
9235,2023-01-20 19:00:00,127,279,7,10,625,521,104,6
9236,2023-01-20 20:00:00,145,257,13,12,586,467,119,5
9237,2023-01-20 21:00:00,142,250,5,17,692,501,191,9
9238,2023-01-20 22:00:00,149,292,11,13,753,598,155,11
9239,2023-01-20 23:00:00,144,255,7,18,663,534,129,8
9240,2023-01-21 00:00:00,129,289,9,19,568,491,77,12
9241,2023-01-21 01:00:00,135,297,7,16,741,586,155,11
9242,2023-01-21 02:00:00,121,257,10,19,701,555,146,5
9243,2023-01-21 03:00:00,123,268,10,10,600,527,73,5
9244,2023-01-21 04:00:00,127,252,9,10,782,647,135,6
9245,2023-01-21 05:00:00,144,250,13,17,704,619,85,9
9246,2023-01-21 06:00:00,138,297,9,15,764,654,110,7
9247,2023-01-21 07:00:00,124,260,12,18,695,503,192,12
9248,2023-01-21 08:00:00,140,276,6,19,714,500,214,6
9249,2023-01-21 09:00:00,140,272,6,17,773,636,137,10
9250,2023-01-21 10:00:00,127,255,6,15,654,470,184,8
9251,2023-01-21 11:00:00,123,280,9,10,783,565,218,13
9252,2023-01-21 12:00:00,148,265,7,17,630,527,103,7
9253,2023-01-21 13:00:00,124,272,14,10,764,602,162,10
9254,2023-01-21 14:00:00,139,299,14,11,576,430,146,10
9255,2023-01-21 15:00:00,123,271,9,15,711,511,200,7
9256,2023-01-21 16:00:00,129,299,14,10,651,562,89,13
9257,2023-01-21 17:00:00,145,275,12,11,727,595,132,11
9258,2023-01-21 18:00:00,121,263,14,13,521,396,125,13
9259,2023-01-21 19:00:00,125,260,14,12,513,395,118,13
9260,2023-01-21 20:00:00,124,283,13,15,594,446,148,14
9261,2023-01-21 21:00:00,148,290,11,14,658,509,149,10
9262,2023-01-21 22:00:00,124,285,5,12,579,485,94,14
9263,2023-01-21 23:00:00,128,291,10,18,568,432,136,7
9264,2023-01-22 00:00:00,126,284,7,18,501,379,122,11
9265,2023-01-22 01:00:00,124,265,12,15,720,604,116,6
9266,2023-01-22 02:00:00,139,257,9,11,596,430,166,7
9267,2023-01-22 03:00:00,133,260,13,15,675,534,141,8
9268,2023-01-22 04:00:00,137,258,14,11,724,541,183,11
9269,2023-01-22 05:00:00,120,292,10,11,568,414,154,12
9270,2023-01-22 06:00:00,139,285,8,17,781,592,189,14
9271,2023-01-22 07:00:00,125,287,8,18,536,469,67,8
9272,2023-01-22 08:00:00,148,277,8,18,792,707,85,12
9273,2023-01-22 09:00:00,148,285,8,13,515,422,93,14
9274,2023-01-22 10:00:00,145,298,12,19,576,496,80,9
9275,2023-01-22 11:00:00,121,262,10,12,502,389,113,14
9276,2023-01-22 12:00:00,140,251,7,19,761,584,177,12
9277,2023-01-22 13:00:00,131,268,10,17,622,462,160,13
9278,2023-01-22 14:00:00,130,277,10,11,613,440,173,9
9279,2023-01-22 15:00:00,131,256,8,14,731,610,121,14
9280,2023-01-22 16:00:00,138,261,6,19,577,458,119,13
9281,2023-01-22 17:00:00,148,290,7,17,619,458,161,7
9282,2023-01-22 18:00:00,141,271,10,17,563,472,91,13
9283,2023-01-22 19:00:00,137,257,6,16,611,536,75,5
9284,2023-01-22 20:00:00,126,283,13,11,555,448,107,11
9285,2023-01-22 21:00:00,147,268,8,12,639,495,144,10
9286,2023-01-22 22:00:00,141,265,14,13,545,419,126,12
9287,2023-01-22 23:00:00,140,293,5,18,632,492,140,10
9288,2023-01-23 00:00:00,129,277,11,15,624,453,171,8
9289,2023-01-23 01:00:00,120,276,5,16,687,559,128,11
9290,2023-01-23 02:00:00,128,266,14,18,501,447,54,8
9291,2023-01-23 03:00:00,128,252,14,15,647,463,184,9
9292,2023-01-23 04:00:00,139,270,13,12,776,668,108,6
9293,2023-01-23 05:00:00,124,288,8,13,580,432,148,9
9294,2023-01-23 06:00:00,131,292,9,11,638,567,71,14
9295,2023-01-23 07:00:00,136,295,8,17,748,551,197,7
9296,2023-01-23 08:00:00,121,297,6,15,708,570,138,11
9297,2023-01-23 09:00:00,132,255,8,14,526,470,56,5
9298,2023-01-23 10:00:00,128,267,12,16,517,460,57,7
9299,2023-01-23 11:00:00,136,253,11,12,712,523,189,9
9300,2023-01-23 12:00:00,121,290,10,17,630,516,114,5
9301,2023-01-23 13:00:00,132,258,14,12,759,582,177,13
9302,2023-01-23 14:00:00,149,272,6,12,618,524,94,13
9303,2023-01-23 15:00:00,125,297,9,15,589,442,147,10
9304,2023-01-23 16:00:00,129,250,10,12,508,439,69,5
9305,2023-01-23 17:00:00,134,252,10,14,646,457,189,13
9306,2023-01-23 18:00:00,149,294,8,10,500,438,62,8
9307,2023-01-23 19:00:00,126,298,12,18,513,432,81,14
9308,2023-01-23 20:00:00,132,267,8,13,589,415,174,8
9309,2023-01-23 21:00:00,120,262,11,19,675,575,100,12
9310,2023-01-23 22:00:00,132,254,10,15,531,425,106,13
9311,2023-01-23 23:00:00,132,262,6,14,722,571,151,12
9312,2023-01-24 00:00:00,130,297,6,10,548,448,100,14
9313,2023-01-24 01:00:00,131,274,11,19,556,453,103,13
9314,2023-01-24 02:00:00,123,262,10,12,670,487,183,11
9315,2023-01-24 03:00:00,132,297,12,10,791,577,214,14
9316,2023-01-24 04:00:00,133,287,13,17,618,538,80,12
9317,2023-01-24 05:00:00,131,260,6,12,735,547,188,9
9318,2023-01-24 06:00:00,140,279,6,16,616,437,179,8
9319,2023-01-24 07:00:00,141,254,9,18,593,470,123,10
9320,2023-01-24 08:00:00,126,286,11,19,671,571,100,5
9321,2023-01-24 09:00:00,121,259,6,11,611,510,101,12
9322,2023-01-24 10:00:00,135,258,13,18,611,540,71,7
9323,2023-01-24 11:00:00,149,262,6,12,515,397,118,8
9324,2023-01-24 12:00:00,129,296,11,10,551,495,56,8
9325,2023-01-24 13:00:00,135,260,6,13,733,604,129,12
9326,2023-01-24 14:00:00,123,264,7,10,596,502,94,8
9327,2023-01-24 15:00:00,140,267,10,12,681,581,100,5
9328,2023-01-24 16:00:00,143,288,14,14,650,496,154,8
9329,2023-01-24 17:00:00,130,271,5,16,695,584,111,11
9330,2023-01-24 18:00:00,124,295,14,15,695,520,175,14
9331,2023-01-24 19:00:00,135,276,10,12,734,618,116,10
9332,2023-01-24 20:00:00,149,254,11,15,555,468,87,12
9333,2023-01-24 21:00:00,146,298,9,12,686,538,148,13
9334,2023-01-24 22:00:00,140,258,11,13,677,476,201,6
9335,2023-01-24 23:00:00,137,297,8,19,598,500,98,13
9336,2023-01-25 00:00:00,123,295,8,17,501,406,95,10
9337,2023-01-25 01:00:00,145,264,6,11,761,567,194,10
9338,2023-01-25 02:00:00,141,285,9,10,730,638,92,11
9339,2023-01-25 03:00:00,130,280,7,11,523,373,150,11
9340,2023-01-25 04:00:00,141,283,12,14,534,426,108,10
9341,2023-01-25 05:00:00,139,262,14,17,537,382,155,11
9342,2023-01-25 06:00:00,126,295,6,10,721,578,143,9
9343,2023-01-25 07:00:00,148,254,5,14,790,625,165,5
9344,2023-01-25 08:00:00,146,279,8,19,609,493,116,13
9345,2023-01-25 09:00:00,120,297,12,12,750,569,181,8
9346,2023-01-25 10:00:00,131,279,11,19,563,503,60,11
9347,2023-01-25 11:00:00,127,282,14,15,623,545,78,10
9348,2023-01-25 12:00:00,137,294,7,18,773,623,150,10
9349,2023-01-25 13:00:00,144,298,13,19,666,536,130,12
9350,2023-01-25 14:00:00,144,296,12,18,754,629,125,11
9351,2023-01-25 15:00:00,122,265,11,17,762,535,227,12
9352,2023-01-25 16:00:00,136,269,8,19,682,579,103,6
9353,2023-01-25 17:00:00,123,262,12,15,719,535,184,5
9354,2023-01-25 18:00:00,135,258,14,15,761,593,168,13
9355,2023-01-25 19:00:00,145,281,6,13,631,469,162,10
9356,2023-01-25 20:00:00,120,285,7,11,672,526,146,9
9357,2023-01-25 21:00:00,147,283,5,11,724,643,81,12
9358,2023-01-25 22:00:00,136,251,11,12,538,413,125,12
9359,2023-01-25 23:00:00,134,256,12,11,743,650,93,5
9360,2023-01-26 00:00:00,127,299,8,12,573,427,146,11
9361,2023-01-26 01:00:00,138,291,14,12,621,509,112,13
9362,2023-01-26 02:00:00,133,291,12,16,789,559,230,7
9363,2023-01-26 03:00:00,146,265,13,18,663,591,72,13
9364,2023-01-26 04:00:00,141,285,14,14,690,603,87,13
9365,2023-01-26 05:00:00,139,250,11,14,607,502,105,7
9366,2023-01-26 06:00:00,127,288,5,19,580,473,107,11
9367,2023-01-26 07:00:00,139,278,11,12,596,482,114,9
9368,2023-01-26 08:00:00,123,261,7,10,531,372,159,12
9369,2023-01-26 09:00:00,123,297,11,11,758,531,227,11
9370,2023-01-26 10:00:00,131,273,14,14,723,544,179,12
9371,2023-01-26 11:00:00,142,252,12,11,653,519,134,14
9372,2023-01-26 12:00:00,143,265,7,16,521,457,64,14
9373,2023-01-26 13:00:00,120,289,8,16,702,577,125,8
9374,2023-01-26 14:00:00,132,259,10,10,753,621,132,10
9375,2023-01-26 15:00:00,149,262,9,13,744,534,210,11
9376,2023-01-26 16:00:00,139,284,8,14,760,614,146,10
9377,2023-01-26 17:00:00,130,298,5,11,755,614,141,12
9378,2023-01-26 18:00:00,135,272,10,12,653,545,108,8
9379,2023-01-26 19:00:00,142,273,5,18,680,597,83,11
9380,2023-01-26 20:00:00,139,257,9,14,537,440,97,11
9381,2023-01-26 21:00:00,143,298,12,12,661,513,148,13
9382,2023-01-26 22:00:00,126,288,13,17,550,396,154,13
9383,2023-01-26 23:00:00,130,282,14,14,658,559,99,14
9384,2023-01-27 00:00:00,147,299,12,13,654,574,80,8
9385,2023-01-27 01:00:00,141,263,10,14,549,474,75,5
9386,2023-01-27 02:00:00,145,283,13,13,507,378,129,11
9387,2023-01-27 03:00:00,130,292,12,18,773,542,231,8
9388,2023-01-27 04:00:00,133,266,14,14,771,631,140,5
9389,2023-01-27 05:00:00,144,274,13,13,505,359,146,13
9390,2023-01-27 06:00:00,134,297,13,18,795,622,173,13
9391,2023-01-27 07:00:00,149,284,10,14,553,470,83,8
9392,2023-01-27 08:00:00,148,257,5,16,708,632,76,12
9393,2023-01-27 09:00:00,129,254,6,19,524,400,124,10
9394,2023-01-27 10:00:00,130,298,10,13,608,472,136,6
9395,2023-01-27 11:00:00,123,297,11,17,734,629,105,14
9396,2023-01-27 12:00:00,130,260,13,12,745,644,101,6
9397,2023-01-27 13:00:00,126,262,9,13,688,552,136,8
9398,2023-01-27 14:00:00,120,269,6,14,565,477,88,14
9399,2023-01-27 15:00:00,139,267,5,13,581,515,66,13
9400,2023-01-27 16:00:00,130,293,9,18,743,567,176,8
9401,2023-01-27 17:00:00,141,291,8,19,710,580,130,5
9402,2023-01-27 18:00:00,144,260,11,17,613,452,161,10
9403,2023-01-27 19:00:00,144,269,8,19,770,690,80,6
9404,2023-01-27 20:00:00,120,264,5,12,656,499,157,11
9405,2023-01-27 21:00:00,130,265,12,11,778,605,173,9
9406,2023-01-27 22:00:00,129,270,13,16,625,526,99,11
9407,2023-01-27 23:00:00,128,265,5,10,749,666,83,9
9408,2023-01-28 00:00:00,142,288,11,14,662,539,123,7
9409,2023-01-28 01:00:00,142,265,7,10,506,399,107,12
9410,2023-01-28 02:00:00,143,287,8,19,774,562,212,10
9411,2023-01-28 03:00:00,126,280,13,12,526,411,115,12
9412,2023-01-28 04:00:00,123,289,6,11,572,506,66,7
9413,2023-01-28 05:00:00,122,266,13,15,568,436,132,9
9414,2023-01-28 06:00:00,134,287,9,13,519,413,106,14
9415,2023-01-28 07:00:00,133,278,9,17,646,532,114,9
9416,2023-01-28 08:00:00,139,281,10,15,532,377,155,9
9417,2023-01-28 09:00:00,121,259,11,15,797,624,173,9
9418,2023-01-28 10:00:00,138,270,8,15,760,545,215,9
9419,2023-01-28 11:00:00,135,268,5,15,618,553,65,13
9420,2023-01-28 12:00:00,141,282,13,16,650,551,99,11
9421,2023-01-28 13:00:00,133,277,11,17,781,699,82,9
9422,2023-01-28 14:00:00,149,270,6,17,636,492,144,10
9423,2023-01-28 15:00:00,135,285,13,12,574,441,133,14
9424,2023-01-28 16:00:00,147,286,8,12,613,430,183,6
9425,2023-01-28 17:00:00,143,298,9,16,512,385,127,10
9426,2023-01-28 18:00:00,135,293,5,14,793,635,158,5
9427,2023-01-28 19:00:00,141,285,7,19,798,629,169,9
9428,2023-01-28 20:00:00,141,252,5,19,759,588,171,13
9429,2023-01-28 21:00:00,130,265,7,12,505,453,52,6
9430,2023-01-28 22:00:00,136,293,13,13,573,506,67,5
9431,2023-01-28 23:00:00,137,266,10,13,558,460,98,13
9432,2023-01-29 00:00:00,140,267,6,12,717,628,89,12
9433,2023-01-29 01:00:00,124,290,12,11,585,423,162,13
9434,2023-01-29 02:00:00,140,252,9,15,776,684,92,5
9435,2023-01-29 03:00:00,134,276,9,10,726,625,101,13
9436,2023-01-29 04:00:00,128,293,8,16,779,668,111,10
9437,2023-01-29 05:00:00,133,270,9,12,505,420,85,5
9438,2023-01-29 06:00:00,139,283,13,18,616,460,156,7
9439,2023-01-29 07:00:00,124,266,10,18,608,504,104,8
9440,2023-01-29 08:00:00,148,267,13,14,768,579,189,5
9441,2023-01-29 09:00:00,131,256,8,15,605,521,84,6
9442,2023-01-29 10:00:00,134,298,7,11,668,496,172,12
9443,2023-01-29 11:00:00,122,291,10,12,751,646,105,10
9444,2023-01-29 12:00:00,141,267,9,15,513,386,127,10
9445,2023-01-29 13:00:00,124,273,14,10,544,403,141,13
9446,2023-01-29 14:00:00,120,274,10,14,564,482,82,11
9447,2023-01-29 15:00:00,146,255,11,15,577,511,66,6
9448,2023-01-29 16:00:00,135,271,9,14,602,500,102,13
9449,2023-01-29 17:00:00,120,255,11,18,714,631,83,12
9450,2023-01-29 18:00:00,137,287,9,19,638,456,182,13
9451,2023-01-29 19:00:00,129,283,11,15,613,539,74,13
9452,2023-01-29 20:00:00,148,283,8,14,781,640,141,5
9453,2023-01-29 21:00:00,138,256,8,11,616,458,158,14
9454,2023-01-29 22:00:00,135,269,10,11,732,582,150,7
9455,2023-01-29 23:00:00,145,268,14,19,768,594,174,12
9456,2023-01-30 00:00:00,134,282,13,17,557,393,164,11
9457,2023-01-30 01:00:00,133,253,10,16,789,691,98,5
9458,2023-01-30 02:00:00,129,256,12,11,741,611,130,11
9459,2023-01-30 03:00:00,121,261,12,14,632,487,145,6
9460,2023-01-30 04:00:00,128,254,12,18,600,526,74,10
9461,2023-01-30 05:00:00,146,258,7,12,780,694,86,12
9462,2023-01-30 06:00:00,128,288,13,13,773,567,206,5
9463,2023-01-30 07:00:00,141,264,14,19,678,481,197,9
9464,2023-01-30 08:00:00,142,272,14,13,622,551,71,6
9465,2023-01-30 09:00:00,147,297,6,14,513,370,143,12
9466,2023-01-30 10:00:00,122,274,8,16,540,415,125,14
9467,2023-01-30 11:00:00,143,282,6,12,701,525,176,6
9468,2023-01-30 12:00:00,131,254,8,14,518,440,78,10
9469,2023-01-30 13:00:00,140,255,13,16,598,423,175,5
9470,2023-01-30 14:00:00,136,287,10,19,779,590,189,8
9471,2023-01-30 15:00:00,141,276,11,17,500,360,140,11
9472,2023-01-30 16:00:00,124,264,13,16,777,622,155,7
9473,2023-01-30 17:00:00,149,282,14,13,731,561,170,5
9474,2023-01-30 18:00:00,137,261,9,18,665,590,75,12
9475,2023-01-30 19:00:00,135,258,11,13,523,404,119,10
9476,2023-01-30 20:00:00,138,287,12,13,527,447,80,6
9477,2023-01-30 21:00:00,139,298,6,17,587,464,123,13
9478,2023-01-30 22:00:00,137,288,9,16,569,458,111,10
9479,2023-01-30 23:00:00,128,265,10,11,772,656,116,8
9480,2023-01-31 00:00:00,121,279,11,16,782,671,111,5
9481,2023-01-31 01:00:00,134,280,11,15,568,492,76,13
9482,2023-01-31 02:00:00,137,265,12,15,538,430,108,5
9483,2023-01-31 03:00:00,136,274,8,18,681,501,180,5
9484,2023-01-31 04:00:00,148,290,12,10,736,596,140,10
9485,2023-01-31 05:00:00,127,287,10,13,754,619,135,5
9486,2023-01-31 06:00:00,138,257,6,13,536,471,65,10
9487,2023-01-31 07:00:00,139,266,6,13,769,540,229,8
9488,2023-01-31 08:00:00,139,288,11,15,701,606,95,6
9489,2023-01-31 09:00:00,139,259,10,18,694,542,152,13
9490,2023-01-31 10:00:00,130,262,12,18,756,532,224,8
9491,2023-01-31 11:00:00,132,299,13,14,679,556,123,7
9492,2023-01-31 12:00:00,120,299,11,18,659,539,120,14
9493,2023-01-31 13:00:00,135,276,13,13,614,529,85,8
9494,2023-01-31 14:00:00,148,290,12,15,564,445,119,7
9495,2023-01-31 15:00:00,121,298,7,14,749,612,137,10
9496,2023-01-31 16:00:00,148,278,14,13,640,459,181,10
9497,2023-01-31 17:00:00,143,291,9,14,521,452,69,9
9498,2023-01-31 18:00:00,134,254,12,11,508,435,73,5
9499,2023-01-31 19:00:00,132,273,7,11,566,466,100,5
9500,2023-01-31 20:00:00,133,262,14,16,620,434,186,9
9501,2023-01-31 21:00:00,122,260,6,13,556,490,66,8
9502,2023-01-31 22:00:00,120,252,9,18,757,632,125,14
9503,2023-01-31 23:00:00,126,288,8,11,700,590,110,11
9504,2023-02-01 00:00:00,127,254,13,16,714,639,75,14
9505,2023-02-01 01:00:00,124,257,7,12,642,510,132,10
9506,2023-02-01 02:00:00,128,268,10,12,553,388,165,8
9507,2023-02-01 03:00:00,121,258,11,18,501,395,106,8
9508,2023-02-01 04:00:00,137,265,5,19,676,600,76,8
9509,2023-02-01 05:00:00,129,291,11,16,526,438,88,9
9510,2023-02-01 06:00:00,145,265,9,14,763,607,156,11
9511,2023-02-01 07:00:00,147,295,10,19,647,481,166,12
9512,2023-02-01 08:00:00,140,299,9,19,724,577,147,13
9513,2023-02-01 09:00:00,129,285,14,13,665,572,93,8
9514,2023-02-01 10:00:00,134,258,5,15,684,560,124,7
9515,2023-02-01 11:00:00,146,272,14,16,548,413,135,7
9516,2023-02-01 12:00:00,132,286,14,14,792,649,143,11
9517,2023-02-01 13:00:00,135,252,8,13,728,648,80,11
9518,2023-02-01 14:00:00,120,258,11,10,532,432,100,10
9519,2023-02-01 15:00:00,149,279,10,11,558,435,123,11
9520,2023-02-01 16:00:00,129,286,10,19,746,667,79,8
9521,2023-02-01 17:00:00,123,278,11,14,749,647,102,9
9522,2023-02-01 18:00:00,141,252,7,16,728,580,148,11
9523,2023-02-01 19:00:00,125,260,9,13,783,626,157,7
9524,2023-02-01 20:00:00,143,285,14,13,703,539,164,9
9525,2023-02-01 21:00:00,126,295,8,14,577,457,120,8
9526,2023-02-01 22:00:00,148,290,8,13,650,519,131,7
9527,2023-02-01 23:00:00,136,255,14,17,536,397,139,14
9528,2023-02-02 00:00:00,139,256,12,17,564,474,90,5
9529,2023-02-02 01:00:00,120,265,5,16,532,450,82,14
9530,2023-02-02 02:00:00,126,296,6,10,725,636,89,6
9531,2023-02-02 03:00:00,122,295,14,19,607,426,181,14
9532,2023-02-02 04:00:00,137,254,9,18,675,520,155,7
9533,2023-02-02 05:00:00,133,251,10,10,551,494,57,9
9534,2023-02-02 06:00:00,126,293,9,10,798,599,199,11
9535,2023-02-02 07:00:00,123,252,9,18,578,456,122,10
9536,2023-02-02 08:00:00,137,266,11,14,632,508,124,6
9537,2023-02-02 09:00:00,124,262,14,13,605,521,84,5
9538,2023-02-02 10:00:00,131,292,10,12,766,602,164,8
9539,2023-02-02 11:00:00,127,279,13,12,788,666,122,7
9540,2023-02-02 12:00:00,130,281,9,15,712,599,113,14
9541,2023-02-02 13:00:00,147,260,13,17,576,407,169,12
9542,2023-02-02 14:00:00,121,257,7,16,624,460,164,5
9543,2023-02-02 15:00:00,143,296,12,18,613,523,90,9
9544,2023-02-02 16:00:00,133,296,11,10,634,557,77,11
9545,2023-02-02 17:00:00,124,264,13,18,646,461,185,8
9546,2023-02-02 18:00:00,138,296,10,14,520,403,117,5
9547,2023-02-02 19:00:00,131,271,9,16,650,574,76,10
9548,2023-02-02 20:00:00,140,268,14,19,708,513,195,7
9549,2023-02-02 21:00:00,140,289,5,14,524,455,69,7
9550,2023-02-02 22:00:00,134,270,9,17,737,640,97,5
9551,2023-02-02 23:00:00,123,266,14,17,513,424,89,12
9552,2023-02-03 00:00:00,149,290,9,10,667,566,101,10
9553,2023-02-03 01:00:00,121,288,6,19,718,588,130,9
9554,2023-02-03 02:00:00,126,270,8,18,657,501,156,8
9555,2023-02-03 03:00:00,141,257,9,13,642,519,123,11
9556,2023-02-03 04:00:00,133,277,8,15,533,413,120,10
9557,2023-02-03 05:00:00,128,298,13,15,684,485,199,7
9558,2023-02-03 06:00:00,144,264,6,19,697,593,104,10
9559,2023-02-03 07:00:00,145,281,12,17,620,436,184,9
9560,2023-02-03 08:00:00,144,267,8,13,606,429,177,11
9561,2023-02-03 09:00:00,121,278,5,16,538,414,124,13
9562,2023-02-03 10:00:00,134,279,8,13,583,486,97,6
9563,2023-02-03 11:00:00,143,285,13,19,667,544,123,8
9564,2023-02-03 12:00:00,143,283,9,17,559,476,83,14
9565,2023-02-03 13:00:00,126,260,5,19,767,589,178,12
9566,2023-02-03 14:00:00,131,271,6,15,785,572,213,12
9567,2023-02-03 15:00:00,127,251,5,18,564,493,71,8
9568,2023-02-03 16:00:00,129,297,13,10,646,475,171,6
9569,2023-02-03 17:00:00,129,266,13,10,610,488,122,7
9570,2023-02-03 18:00:00,148,298,9,12,663,501,162,9
9571,2023-02-03 19:00:00,128,257,13,14,653,548,105,5
9572,2023-02-03 20:00:00,149,297,6,17,584,464,120,5
9573,2023-02-03 21:00:00,144,254,8,17,657,587,70,10
9574,2023-02-03 22:00:00,126,284,11,14,603,498,105,13
9575,2023-02-03 23:00:00,139,297,13,14,615,523,92,13
9576,2023-02-04 00:00:00,136,287,6,18,595,461,134,13
9577,2023-02-04 01:00:00,122,275,6,12,649,538,111,8
9578,2023-02-04 02:00:00,139,274,8,11,776,640,136,12
9579,2023-02-04 03:00:00,147,265,13,14,625,533,92,14
9580,2023-02-04 04:00:00,147,274,7,18,772,611,161,5
9581,2023-02-04 05:00:00,140,281,13,11,730,603,127,13
9582,2023-02-04 06:00:00,142,293,8,13,684,479,205,11
9583,2023-02-04 07:00:00,122,280,7,18,626,484,142,14
9584,2023-02-04 08:00:00,136,288,6,13,569,444,125,5
9585,2023-02-04 09:00:00,143,278,14,11,609,510,99,13
9586,2023-02-04 10:00:00,132,282,10,15,613,538,75,7
9587,2023-02-04 11:00:00,140,269,9,12,786,557,229,11
9588,2023-02-04 12:00:00,138,292,8,14,584,492,92,7
9589,2023-02-04 13:00:00,140,257,7,19,523,450,73,7
9590,2023-02-04 14:00:00,130,255,14,19,777,580,197,10
9591,2023-02-04 15:00:00,128,265,9,15,672,533,139,10
9592,2023-02-04 16:00:00,132,262,6,12,708,609,99,7
9593,2023-02-04 17:00:00,137,271,5,11,540,466,74,8
9594,2023-02-04 18:00:00,132,277,7,15,763,586,177,13
9595,2023-02-04 19:00:00,123,288,5,19,721,593,128,6
9596,2023-02-04 20:00:00,127,253,14,11,749,578,171,14
9597,2023-02-04 21:00:00,145,287,6,14,590,447,143,7
9598,2023-02-04 22:00:00,138,264,8,11,550,472,78,8
9599,2023-02-04 23:00:00,122,261,9,15,735,548,187,9
9600,2023-02-05 00:00:00,142,286,14,18,752,639,113,12
9601,2023-02-05 01:00:00,138,269,9,17,509,362,147,12
9602,2023-02-05 02:00:00,148,263,12,14,570,427,143,13
9603,2023-02-05 03:00:00,126,268,14,11,562,458,104,9
9604,2023-02-05 04:00:00,123,250,10,18,534,377,157,6
9605,2023-02-05 05:00:00,134,271,5,13,798,559,239,5
9606,2023-02-05 06:00:00,135,273,5,11,593,459,134,9
9607,2023-02-05 07:00:00,127,282,8,12,731,565,166,10
9608,2023-02-05 08:00:00,122,296,10,17,665,516,149,8
9609,2023-02-05 09:00:00,138,263,12,11,574,441,133,7
9610,2023-02-05 10:00:00,123,298,7,16,681,542,139,13
9611,2023-02-05 11:00:00,136,278,14,19,640,519,121,6
9612,2023-02-05 12:00:00,126,283,9,10,761,671,90,13
9613,2023-02-05 13:00:00,120,255,14,12,753,661,92,12
9614,2023-02-05 14:00:00,147,261,6,16,580,482,98,9
9615,2023-02-05 15:00:00,143,297,13,15,634,486,148,13
9616,2023-02-05 16:00:00,126,274,9,16,521,408,113,10
9617,2023-02-05 17:00:00,149,265,7,10,695,530,165,12
9618,2023-02-05 18:00:00,146,284,10,16,545,443,102,5
9619,2023-02-05 19:00:00,124,282,11,14,760,660,100,11
9620,2023-02-05 20:00:00,126,264,11,19,628,556,72,12
9621,2023-02-05 21:00:00,130,288,9,15,532,425,107,11
9622,2023-02-05 22:00:00,129,262,13,15,555,397,158,5
9623,2023-02-05 23:00:00,148,275,13,12,652,463,189,7
9624,2023-02-06 00:00:00,140,276,6,16,633,519,114,11
9625,2023-02-06 01:00:00,148,253,11,19,694,536,158,10
9626,2023-02-06 02:00:00,125,272,14,15,639,480,159,6
9627,2023-02-06 03:00:00,138,264,14,12,655,509,146,14
9628,2023-02-06 04:00:00,139,274,9,17,776,546,230,13
9629,2023-02-06 05:00:00,148,264,6,15,624,488,136,10
9630,2023-02-06 06:00:00,142,254,9,13,797,655,142,14
9631,2023-02-06 07:00:00,124,256,13,19,790,698,92,11
9632,2023-02-06 08:00:00,124,283,5,17,569,464,105,6
9633,2023-02-06 09:00:00,136,254,13,11,633,541,92,11
9634,2023-02-06 10:00:00,123,287,5,10,667,491,176,13
9635,2023-02-06 11:00:00,132,251,10,12,564,470,94,10
9636,2023-02-06 12:00:00,147,284,5,19,647,570,77,9
9637,2023-02-06 13:00:00,142,262,7,19,771,643,128,8
9638,2023-02-06 14:00:00,140,258,5,14,744,589,155,9
9639,2023-02-06 15:00:00,146,271,11,19,521,406,115,11
9640,2023-02-06 16:00:00,143,291,14,18,642,471,171,11
9641,2023-02-06 17:00:00,133,251,14,17,779,671,108,9
9642,2023-02-06 18:00:00,142,250,13,11,536,425,111,7
9643,2023-02-06 19:00:00,134,298,10,18,602,506,96,10
9644,2023-02-06 20:00:00,135,290,11,12,609,511,98,12
9645,2023-02-06 21:00:00,129,255,12,10,685,561,124,6
9646,2023-02-06 22:00:00,125,289,6,13,652,456,196,10
9647,2023-02-06 23:00:00,139,269,10,19,700,511,189,7
9648,2023-02-07 00:00:00,125,270,6,19,702,517,185,7
9649,2023-02-07 01:00:00,125,296,5,14,724,611,113,6
9650,2023-02-07 02:00:00,133,273,12,11,798,569,229,8
9651,2023-02-07 03:00:00,135,266,8,16,737,568,169,6
9652,2023-02-07 04:00:00,129,270,8,18,557,402,155,6
9653,2023-02-07 05:00:00,125,284,12,18,648,542,106,6
9654,2023-02-07 06:00:00,144,289,5,13,664,558,106,11
9655,2023-02-07 07:00:00,148,283,7,14,725,618,107,14
9656,2023-02-07 08:00:00,133,298,6,12,629,517,112,8
9657,2023-02-07 09:00:00,138,269,11,16,623,553,70,7
9658,2023-02-07 10:00:00,123,285,5,12,692,599,93,13
9659,2023-02-07 11:00:00,125,259,12,10,678,532,146,9
9660,2023-02-07 12:00:00,148,289,8,12,683,478,205,10
9661,2023-02-07 13:00:00,146,284,14,16,614,543,71,9
9662,2023-02-07 14:00:00,136,299,8,17,574,440,134,10
9663,2023-02-07 15:00:00,141,298,5,16,659,501,158,13
9664,2023-02-07 16:00:00,128,282,8,11,581,481,100,8
9665,2023-02-07 17:00:00,138,258,5,13,744,657,87,6
9666,2023-02-07 18:00:00,144,266,5,13,652,500,152,5
9667,2023-02-07 19:00:00,125,280,14,19,623,461,162,13
9668,2023-02-07 20:00:00,127,262,8,14,538,381,157,7
9669,2023-02-07 21:00:00,140,293,10,16,653,497,156,10
9670,2023-02-07 22:00:00,149,253,13,11,635,448,187,14
9671,2023-02-07 23:00:00,121,267,6,10,758,677,81,13
9672,2023-02-08 00:00:00,135,256,5,16,580,493,87,7
9673,2023-02-08 01:00:00,121,298,5,17,611,535,76,6
9674,2023-02-08 02:00:00,138,289,8,14,568,423,145,13
9675,2023-02-08 03:00:00,129,265,7,15,531,390,141,7
9676,2023-02-08 04:00:00,126,278,7,10,786,683,103,14
9677,2023-02-08 05:00:00,125,265,12,14,781,584,197,8
9678,2023-02-08 06:00:00,140,299,13,12,694,594,100,8
9679,2023-02-08 07:00:00,128,253,5,16,558,436,122,10
9680,2023-02-08 08:00:00,139,290,6,11,552,408,144,9
9681,2023-02-08 09:00:00,149,290,9,16,690,511,179,13
9682,2023-02-08 10:00:00,134,293,7,14,689,564,125,13
9683,2023-02-08 11:00:00,135,271,11,12,638,516,122,8
9684,2023-02-08 12:00:00,139,284,12,11,517,365,152,10
9685,2023-02-08 13:00:00,132,295,11,10,522,414,108,13
9686,2023-02-08 14:00:00,141,289,9,12,638,551,87,14
9687,2023-02-08 15:00:00,127,282,13,10,590,505,85,13
9688,2023-02-08 16:00:00,140,274,7,18,631,541,90,11
9689,2023-02-08 17:00:00,136,274,11,17,663,565,98,5
9690,2023-02-08 18:00:00,137,251,12,16,633,528,105,6
9691,2023-02-08 19:00:00,137,256,13,18,795,708,87,9
9692,2023-02-08 20:00:00,136,255,9,11,516,411,105,6
9693,2023-02-08 21:00:00,129,274,11,19,619,435,184,7
9694,2023-02-08 22:00:00,134,281,6,14,784,606,178,9
9695,2023-02-08 23:00:00,144,264,10,18,663,521,142,10
9696,2023-02-09 00:00:00,134,293,10,12,664,504,160,14
9697,2023-02-09 01:00:00,123,288,13,19,561,471,90,10
9698,2023-02-09 02:00:00,122,281,6,15,601,483,118,8
9699,2023-02-09 03:00:00,141,282,6,18,627,499,128,11
9700,2023-02-09 04:00:00,137,278,12,11,618,525,93,14
9701,2023-02-09 05:00:00,126,250,6,18,746,580,166,13
9702,2023-02-09 06:00:00,144,279,14,14,532,430,102,8
9703,2023-02-09 07:00:00,143,257,7,15,705,504,201,10
9704,2023-02-09 08:00:00,133,261,5,19,666,511,155,11
9705,2023-02-09 09:00:00,137,266,5,12,757,619,138,11
9706,2023-02-09 10:00:00,131,296,13,16,776,662,114,11
9707,2023-02-09 11:00:00,140,292,5,12,526,459,67,9
9708,2023-02-09 12:00:00,135,293,11,15,755,603,152,6
9709,2023-02-09 13:00:00,130,266,6,16,703,631,72,7
9710,2023-02-09 14:00:00,139,270,7,15,629,510,119,13
9711,2023-02-09 15:00:00,144,280,13,10,737,650,87,6
9712,2023-02-09 16:00:00,143,269,5,18,647,468,179,13
9713,2023-02-09 17:00:00,144,299,11,12,780,575,205,6
9714,2023-02-09 18:00:00,148,259,7,15,537,438,99,6
9715,2023-02-09 19:00:00,132,292,7,14,668,514,154,13
9716,2023-02-09 20:00:00,139,275,11,14,742,592,150,13
9717,2023-02-09 21:00:00,129,268,9,15,540,401,139,13
9718,2023-02-09 22:00:00,136,254,9,10,518,394,124,14
9719,2023-02-09 23:00:00,148,275,14,19,639,541,98,5
9720,2023-02-10 00:00:00,137,283,11,10,521,375,146,14
9721,2023-02-10 01:00:00,129,274,12,17,709,508,201,6
9722,2023-02-10 02:00:00,134,278,10,19,781,614,167,14
9723,2023-02-10 03:00:00,127,273,9,11,790,609,181,9
9724,2023-02-10 04:00:00,134,255,7,17,781,580,201,14
9725,2023-02-10 05:00:00,138,291,13,13,627,493,134,8
9726,2023-02-10 06:00:00,146,298,8,10,664,516,148,5
9727,2023-02-10 07:00:00,132,291,11,18,729,595,134,6
9728,2023-02-10 08:00:00,143,298,11,13,744,529,215,9
9729,2023-02-10 09:00:00,123,286,7,17,785,693,92,10
9730,2023-02-10 10:00:00,130,289,5,18,645,569,76,6
9731,2023-02-10 11:00:00,129,279,13,16,590,474,116,6
9732,2023-02-10 12:00:00,130,272,11,19,718,618,100,12
9733,2023-02-10 13:00:00,149,266,7,13,707,539,168,13
9734,2023-02-10 14:00:00,126,260,8,15,725,515,210,14
9735,2023-02-10 15:00:00,121,266,11,13,755,531,224,10
9736,2023-02-10 16:00:00,148,262,7,10,701,512,189,14
9737,2023-02-10 17:00:00,140,259,5,11,721,526,195,6
9738,2023-02-10 18:00:00,137,281,14,13,533,470,63,9
9739,2023-02-10 19:00:00,147,284,11,16,660,587,73,5
9740,2023-02-10 20:00:00,127,269,13,11,595,424,171,7
9741,2023-02-10 21:00:00,143,256,9,13,769,657,112,11
9742,2023-02-10 22:00:00,131,296,5,15,706,577,129,9
9743,2023-02-10 23:00:00,129,285,7,14,728,586,142,10
9744,2023-02-11 00:00:00,136,295,14,19,759,682,77,6
9745,2023-02-11 01:00:00,130,284,14,12,698,616,82,5
9746,2023-02-11 02:00:00,122,269,10,10,522,383,139,10
9747,2023-02-11 03:00:00,121,282,11,17,635,447,188,12
9748,2023-02-11 04:00:00,135,290,6,11,770,690,80,7
9749,2023-02-11 05:00:00,120,273,12,16,698,603,95,14
9750,2023-02-11 06:00:00,149,283,9,10,673,508,165,6
9751,2023-02-11 07:00:00,123,259,6,16,657,546,111,13
9752,2023-02-11 08:00:00,143,279,7,13,696,617,79,7
9753,2023-02-11 09:00:00,130,261,8,14,629,496,133,9
9754,2023-02-11 10:00:00,141,298,8,11,631,529,102,10
9755,2023-02-11 11:00:00,132,278,14,15,657,559,98,9
9756,2023-02-11 12:00:00,127,259,9,11,763,619,144,6
9757,2023-02-11 13:00:00,134,263,9,16,719,616,103,9
9758,2023-02-11 14:00:00,147,251,12,17,721,631,90,13
9759,2023-02-11 15:00:00,138,288,14,18,505,437,68,9
9760,2023-02-11 16:00:00,126,268,14,13,771,691,80,10
9761,2023-02-11 17:00:00,136,276,7,18,650,557,93,8
9762,2023-02-11 18:00:00,149,288,6,18,692,588,104,5
9763,2023-02-11 19:00:00,148,256,8,19,754,650,104,6
9764,2023-02-11 20:00:00,140,253,10,11,563,437,126,9
9765,2023-02-11 21:00:00,121,299,11,17,683,612,71,14
9766,2023-02-11 22:00:00,138,283,7,14,505,410,95,10
9767,2023-02-11 23:00:00,132,252,6,14,673,593,80,11
9768,2023-02-12 00:00:00,140,268,11,13,608,509,99,11
9769,2023-02-12 01:00:00,139,264,11,16,589,499,90,13
9770,2023-02-12 02:00:00,144,291,11,11,654,541,113,9
9771,2023-02-12 03:00:00,136,264,11,19,690,587,103,14
9772,2023-02-12 04:00:00,130,271,13,18,634,545,89,10
9773,2023-02-12 05:00:00,148,253,6,13,628,475,153,13
9774,2023-02-12 06:00:00,148,259,9,19,682,557,125,11
9775,2023-02-12 07:00:00,143,258,14,15,640,520,120,5
9776,2023-02-12 08:00:00,142,256,13,17,797,610,187,14
9777,2023-02-12 09:00:00,149,260,14,12,693,521,172,11
9778,2023-02-12 10:00:00,137,263,5,15,657,545,112,11
9779,2023-02-12 11:00:00,148,277,5,13,518,378,140,14
9780,2023-02-12 12:00:00,134,266,8,18,592,487,105,6
9781,2023-02-12 13:00:00,129,292,9,14,661,470,191,13
9782,2023-02-12 14:00:00,132,279,7,17,758,631,127,5
9783,2023-02-12 15:00:00,145,263,5,15,787,590,197,14
9784,2023-02-12 16:00:00,145,264,6,11,523,398,125,13
9785,2023-02-12 17:00:00,148,261,6,17,550,402,148,9
9786,2023-02-12 18:00:00,147,283,13,17,679,598,81,12
9787,2023-02-12 19:00:00,126,283,5,14,520,372,148,11
9788,2023-02-12 20:00:00,126,292,13,13,641,523,118,12
9789,2023-02-12 21:00:00,149,255,13,10,632,471,161,12
9790,2023-02-12 22:00:00,142,260,7,11,640,503,137,13
9791,2023-02-12 23:00:00,139,254,11,15,706,548,158,6
9792,2023-02-13 00:00:00,132,270,5,11,513,429,84,10
9793,2023-02-13 01:00:00,120,272,14,17,737,639,98,13
9794,2023-02-13 02:00:00,130,289,11,10,766,580,186,14
9795,2023-02-13 03:00:00,136,279,5,19,680,567,113,14
9796,2023-02-13 04:00:00,133,299,5,15,715,574,141,5
9797,2023-02-13 05:00:00,128,269,8,14,791,692,99,14
9798,2023-02-13 06:00:00,147,270,7,14,568,433,135,8
9799,2023-02-13 07:00:00,137,258,5,13,567,416,151,10
9800,2023-02-13 08:00:00,140,282,14,14,767,685,82,10
9801,2023-02-13 09:00:00,134,297,9,18,557,491,66,14
9802,2023-02-13 10:00:00,147,281,13,18,771,642,129,9
9803,2023-02-13 11:00:00,128,251,7,13,686,541,145,5
9804,2023-02-13 12:00:00,135,289,7,17,572,479,93,6
9805,2023-02-13 13:00:00,129,293,14,10,584,517,67,9
9806,2023-02-13 14:00:00,138,259,9,19,611,433,178,14
9807,2023-02-13 15:00:00,123,276,8,17,500,425,75,12
9808,2023-02-13 16:00:00,123,252,13,19,715,606,109,10
9809,2023-02-13 17:00:00,147,299,14,19,621,507,114,9
9810,2023-02-13 18:00:00,123,293,14,14,679,541,138,6
9811,2023-02-13 19:00:00,126,267,12,19,703,571,132,8
9812,2023-02-13 20:00:00,133,273,12,10,720,535,185,7
9813,2023-02-13 21:00:00,140,285,9,14,765,633,132,6
9814,2023-02-13 22:00:00,144,250,6,17,735,638,97,11
9815,2023-02-13 23:00:00,123,266,7,11,502,365,137,11
9816,2023-02-14 00:00:00,136,251,13,11,607,526,81,10
9817,2023-02-14 01:00:00,121,270,10,13,727,530,197,7
9818,2023-02-14 02:00:00,125,279,13,13,527,373,154,11
9819,2023-02-14 03:00:00,145,275,7,15,760,643,117,5
9820,2023-02-14 04:00:00,140,258,11,13,676,570,106,6
9821,2023-02-14 05:00:00,128,281,6,16,687,499,188,10
9822,2023-02-14 06:00:00,146,258,14,18,790,658,132,10
9823,2023-02-14 07:00:00,123,268,14,14,540,422,118,8
9824,2023-02-14 08:00:00,122,287,11,11,783,568,215,14
9825,2023-02-14 09:00:00,126,264,11,15,506,430,76,12
9826,2023-02-14 10:00:00,145,290,8,16,747,586,161,13
9827,2023-02-14 11:00:00,141,284,8,15,798,689,109,10
9828,2023-02-14 12:00:00,140,270,7,11,679,516,163,13
9829,2023-02-14 13:00:00,125,292,10,14,775,632,143,10
9830,2023-02-14 14:00:00,126,255,9,14,598,505,93,6
9831,2023-02-14 15:00:00,121,271,9,19,551,449,102,7
9832,2023-02-14 16:00:00,140,286,13,18,651,572,79,9
9833,2023-02-14 17:00:00,144,252,5,17,775,658,117,10
9834,2023-02-14 18:00:00,135,297,11,16,550,405,145,9
9835,2023-02-14 19:00:00,124,293,7,10,572,427,145,6
9836,2023-02-14 20:00:00,135,252,9,10,549,386,163,7
9837,2023-02-14 21:00:00,126,259,10,12,772,592,180,9
9838,2023-02-14 22:00:00,146,263,7,10,614,486,128,5
9839,2023-02-14 23:00:00,145,269,7,13,595,456,139,7
9840,2023-02-15 00:00:00,128,275,8,18,580,455,125,9
9841,2023-02-15 01:00:00,135,280,9,16,773,572,201,12
9842,2023-02-15 02:00:00,137,275,9,12,553,423,130,9
9843,2023-02-15 03:00:00,133,266,14,11,668,526,142,13
9844,2023-02-15 04:00:00,121,296,10,16,691,567,124,12
9845,2023-02-15 05:00:00,126,286,13,15,728,592,136,11
9846,2023-02-15 06:00:00,136,279,9,10,581,463,118,13
9847,2023-02-15 07:00:00,147,250,10,14,788,592,196,12
9848,2023-02-15 08:00:00,142,280,11,17,519,456,63,9
9849,2023-02-15 09:00:00,137,257,6,19,597,500,97,12
9850,2023-02-15 10:00:00,138,256,9,14,505,430,75,5
9851,2023-02-15 11:00:00,132,259,10,16,510,454,56,7
9852,2023-02-15 12:00:00,147,296,7,13,549,467,82,13
9853,2023-02-15 13:00:00,142,263,5,17,729,630,99,7
9854,2023-02-15 14:00:00,145,275,9,18,713,589,124,9
9855,2023-02-15 15:00:00,137,257,8,11,723,561,162,11
9856,2023-02-15 16:00:00,138,266,8,16,719,607,112,8
9857,2023-02-15 17:00:00,140,278,11,12,602,441,161,9
9858,2023-02-15 18:00:00,147,264,5,16,633,549,84,9
9859,2023-02-15 19:00:00,141,272,5,14,598,498,100,7
9860,2023-02-15 20:00:00,123,253,7,16,605,505,100,12
9861,2023-02-15 21:00:00,131,252,9,10,566,498,68,8
9862,2023-02-15 22:00:00,132,281,13,17,502,363,139,12
9863,2023-02-15 23:00:00,124,281,10,16,588,482,106,10
9864,2023-02-16 00:00:00,134,295,7,14,539,449,90,12
9865,2023-02-16 01:00:00,120,292,11,18,630,556,74,5
9866,2023-02-16 02:00:00,136,254,6,12,501,385,116,13
9867,2023-02-16 03:00:00,138,290,5,13,707,627,80,12
9868,2023-02-16 04:00:00,142,291,13,13,795,560,235,12
9869,2023-02-16 05:00:00,148,255,6,15,769,595,174,5
9870,2023-02-16 06:00:00,124,282,10,16,734,638,96,9
9871,2023-02-16 07:00:00,130,277,9,13,757,551,206,13
9872,2023-02-16 08:00:00,121,285,13,13,793,640,153,8
9873,2023-02-16 09:00:00,137,299,6,18,667,530,137,9
9874,2023-02-16 10:00:00,133,292,5,10,631,522,109,12
9875,2023-02-16 11:00:00,134,263,14,11,690,596,94,13
9876,2023-02-16 12:00:00,135,267,6,14,603,488,115,13
9877,2023-02-16 13:00:00,140,273,7,13,623,465,158,12
9878,2023-02-16 14:00:00,148,251,14,15,781,660,121,13
9879,2023-02-16 15:00:00,134,275,8,13,616,549,67,8
9880,2023-02-16 16:00:00,130,255,9,10,777,571,206,7
9881,2023-02-16 17:00:00,129,261,11,19,528,430,98,7
9882,2023-02-16 18:00:00,142,258,12,17,628,561,67,9
9883,2023-02-16 19:00:00,133,265,13,16,533,457,76,5
9884,2023-02-16 20:00:00,149,268,11,18,547,451,96,6
9885,2023-02-16 21:00:00,121,281,10,13,624,501,123,7
9886,2023-02-16 22:00:00,129,289,9,10,733,559,174,12
9887,2023-02-16 23:00:00,123,273,5,18,532,465,67,9
9888,2023-02-17 00:00:00,126,297,5,10,570,452,118,8
9889,2023-02-17 01:00:00,143,277,13,19,682,504,178,11
9890,2023-02-17 02:00:00,149,260,7,19,629,500,129,5
9891,2023-02-17 03:00:00,120,252,6,15,569,421,148,9
9892,2023-02-17 04:00:00,121,284,14,10,511,372,139,12
9893,2023-02-17 05:00:00,141,251,8,19,534,389,145,13
9894,2023-02-17 06:00:00,133,298,6,13,672,583,89,13
9895,2023-02-17 07:00:00,126,275,11,14,539,397,142,5
9896,2023-02-17 08:00:00,120,296,10,14,510,453,57,10
9897,2023-02-17 09:00:00,126,254,7,18,643,476,167,10
9898,2023-02-17 10:00:00,129,289,5,12,550,431,119,8
9899,2023-02-17 11:00:00,134,282,10,12,764,551,213,9
9900,2023-02-17 12:00:00,127,257,8,13,680,576,104,9
9901,2023-02-17 13:00:00,146,261,12,10,784,626,158,14
9902,2023-02-17 14:00:00,125,290,6,19,515,395,120,11
9903,2023-02-17 15:00:00,149,275,5,16,522,461,61,7
9904,2023-02-17 16:00:00,148,279,13,13,692,521,171,9
9905,2023-02-17 17:00:00,136,252,6,17,724,651,73,13
9906,2023-02-17 18:00:00,127,264,10,18,727,597,130,5
9907,2023-02-17 19:00:00,131,277,12,13,576,476,100,5
9908,2023-02-17 20:00:00,132,284,9,13,628,546,82,13
9909,2023-02-17 21:00:00,122,297,7,10,628,537,91,9
9910,2023-02-17 22:00:00,125,289,6,16,542,438,104,6
9911,2023-02-17 23:00:00,133,259,5,16,796,699,97,10
9912,2023-02-18 00:00:00,125,296,7,19,584,430,154,9
9913,2023-02-18 01:00:00,136,261,11,18,674,481,193,12
9914,2023-02-18 02:00:00,147,277,9,13,638,467,171,11
9915,2023-02-18 03:00:00,129,297,7,19,745,670,75,6
9916,2023-02-18 04:00:00,132,287,10,17,582,456,126,11
9917,2023-02-18 05:00:00,121,282,10,19,564,482,82,14
9918,2023-02-18 06:00:00,148,278,13,15,726,509,217,12
9919,2023-02-18 07:00:00,127,287,11,17,640,485,155,12
9920,2023-02-18 08:00:00,131,287,8,13,555,434,121,6
9921,2023-02-18 09:00:00,131,298,10,19,725,618,107,11
9922,2023-02-18 10:00:00,139,284,8,15,762,641,121,14
9923,2023-02-18 11:00:00,125,275,8,14,501,413,88,11
9924,2023-02-18 12:00:00,122,273,5,17,789,667,122,6
9925,2023-02-18 13:00:00,133,286,14,14,778,629,149,9
9926,2023-02-18 14:00:00,139,296,6,11,733,580,153,6
9927,2023-02-18 15:00:00,134,278,5,16,574,431,143,14
9928,2023-02-18 16:00:00,143,288,13,13,625,439,186,14
9929,2023-02-18 17:00:00,120,252,14,18,537,423,114,8
9930,2023-02-18 18:00:00,139,298,6,12,624,533,91,10
9931,2023-02-18 19:00:00,140,283,8,13,625,480,145,10
9932,2023-02-18 20:00:00,146,299,9,10,598,478,120,7
9933,2023-02-18 21:00:00,134,264,13,10,528,448,80,11
9934,2023-02-18 22:00:00,145,299,6,15,612,523,89,10
9935,2023-02-18 23:00:00,120,272,11,18,744,577,167,13
9936,2023-02-19 00:00:00,124,299,6,14,502,449,53,10
9937,2023-02-19 01:00:00,120,299,9,12,656,459,197,7
9938,2023-02-19 02:00:00,122,290,7,16,777,632,145,5
9939,2023-02-19 03:00:00,127,296,7,14,556,428,128,14
9940,2023-02-19 04:00:00,138,267,5,15,712,528,184,6
9941,2023-02-19 05:00:00,136,263,8,12,717,640,77,13
9942,2023-02-19 06:00:00,120,277,8,14,707,505,202,14
9943,2023-02-19 07:00:00,143,257,9,15,701,492,209,5
9944,2023-02-19 08:00:00,120,257,10,19,544,402,142,5
9945,2023-02-19 09:00:00,122,287,14,12,539,419,120,14
9946,2023-02-19 10:00:00,131,257,10,18,554,400,154,8
9947,2023-02-19 11:00:00,144,293,9,14,601,435,166,13
9948,2023-02-19 12:00:00,139,287,6,19,695,577,118,10
9949,2023-02-19 13:00:00,148,260,7,16,512,432,80,14
9950,2023-02-19 14:00:00,136,290,8,14,604,449,155,12
9951,2023-02-19 15:00:00,122,264,12,10,610,515,95,11
9952,2023-02-19 16:00:00,142,291,10,17,724,567,157,10
9953,2023-02-19 17:00:00,144,282,9,19,706,528,178,8
9954,2023-02-19 18:00:00,134,250,12,11,634,470,164,6
9955,2023-02-19 19:00:00,144,258,6,12,615,513,102,7
9956,2023-02-19 20:00:00,128,294,11,12,586,467,119,11
9957,2023-02-19 21:00:00,149,290,6,11,640,494,146,6
9958,2023-02-19 22:00:00,145,285,7,12,749,672,77,12
9959,2023-02-19 23:00:00,125,276,6,18,795,587,208,14
9960,2023-02-20 00:00:00,124,285,11,16,750,649,101,11
9961,2023-02-20 01:00:00,132,293,11,17,617,460,157,5
9962,2023-02-20 02:00:00,145,282,14,12,572,448,124,9
9963,2023-02-20 03:00:00,140,280,7,13,599,475,124,6
9964,2023-02-20 04:00:00,127,260,7,15,666,521,145,8
9965,2023-02-20 05:00:00,149,286,9,14,626,442,184,14
9966,2023-02-20 06:00:00,142,283,6,12,621,501,120,8
9967,2023-02-20 07:00:00,125,276,6,15,664,556,108,6
9968,2023-02-20 08:00:00,139,264,13,13,564,455,109,8
9969,2023-02-20 09:00:00,135,260,5,14,535,398,137,8
9970,2023-02-20 10:00:00,132,295,5,19,569,402,167,13
9971,2023-02-20 11:00:00,139,299,11,10,680,588,92,9
9972,2023-02-20 12:00:00,128,287,12,13,519,434,85,10
9973,2023-02-20 13:00:00,147,284,6,19,726,648,78,8
9974,2023-02-20 14:00:00,123,297,5,19,627,490,137,9
9975,2023-02-20 15:00:00,124,251,11,18,537,383,154,13
9976,2023-02-20 16:00:00,145,282,7,14,790,611,179,9
9977,2023-02-20 17:00:00,131,273,5,15,782,660,122,8
9978,2023-02-20 18:00:00,137,275,7,11,693,561,132,13
9979,2023-02-20 19:00:00,138,253,14,14,769,607,162,7
9980,2023-02-20 20:00:00,149,288,6,10,605,485,120,8
9981,2023-02-20 21:00:00,124,259,9,12,502,353,149,10
9982,2023-02-20 22:00:00,120,291,13,17,642,569,73,8
9983,2023-02-20 23:00:00,148,251,6,12,760,600,160,5
9984,2023-02-21 00:00:00,147,284,11,17,633,552,81,9
9985,2023-02-21 01:00:00,125,299,9,11,540,381,159,8
9986,2023-02-21 02:00:00,124,276,8,11,540,420,120,8
9987,2023-02-21 03:00:00,132,286,6,13,750,669,81,7
9988,2023-02-21 04:00:00,139,267,12,17,715,507,208,7
9989,2023-02-21 05:00:00,126,251,10,14,725,566,159,7
9990,2023-02-21 06:00:00,128,259,12,15,715,560,155,7
9991,2023-02-21 07:00:00,149,281,7,12,710,516,194,8
9992,2023-02-21 08:00:00,139,274,7,12,513,417,96,10
9993,2023-02-21 09:00:00,132,290,11,19,520,369,151,14
9994,2023-02-21 10:00:00,131,278,13,18,711,562,149,10
9995,2023-02-21 11:00:00,120,266,6,14,585,474,111,7
9996,2023-02-21 12:00:00,120,265,10,18,584,432,152,10
9997,2023-02-21 13:00:00,137,280,8,17,509,425,84,5
9998,2023-02-21 14:00:00,138,298,10,19,642,528,114,5
9999,2023-02-21 15:00:00,133,251,9,13,794,666,128,6
10000,2023-02-21 16:00:00,122,266,12,12,504,369,135,6
10001,2023-02-21 17:00:00,132,278,13,16,659,566,93,13
10002,2023-02-21 18:00:00,140,254,8,13,522,397,125,6
10003,2023-02-21 19:00:00,135,281,5,16,779,697,82,5
10004,2023-02-21 20:00:00,149,255,9,18,799,595,204,7
10005,2023-02-21 21:00:00,120,261,7,11,774,590,184,9
10006,2023-02-21 22:00:00,132,276,10,12,520,436,84,11
10007,2023-02-21 23:00:00,147,292,13,16,508,367,141,6
10008,2023-02-22 00:00:00,137,299,9,11,569,442,127,12
10009,2023-02-22 01:00:00,137,287,14,16,704,503,201,14
10010,2023-02-22 02:00:00,128,264,6,19,572,503,69,13
10011,2023-02-22 03:00:00,132,274,7,17,705,583,122,7
10012,2023-02-22 04:00:00,133,291,12,14,663,556,107,14
10013,2023-02-22 05:00:00,120,290,5,15,517,459,58,13
10014,2023-02-22 06:00:00,149,266,12,17,778,578,200,11
10015,2023-02-22 07:00:00,137,280,13,17,785,700,85,8
10016,2023-02-22 08:00:00,141,285,6,18,632,553,79,11
10017,2023-02-22 09:00:00,129,264,14,11,541,404,137,7
10018,2023-02-22 10:00:00,144,283,9,15,529,390,139,9
10019,2023-02-22 11:00:00,131,265,14,17,718,617,101,5
10020,2023-02-22 12:00:00,128,275,9,13,692,599,93,5
10021,2023-02-22 13:00:00,120,293,6,11,640,476,164,9
10022,2023-02-22 14:00:00,144,297,11,19,565,438,127,10
10023,2023-02-22 15:00:00,146,284,8,12,635,484,151,12
10024,2023-02-22 16:00:00,132,286,6,19,604,519,85,10
10025,2023-02-22 17:00:00,146,294,13,14,776,638,138,8
10026,2023-02-22 18:00:00,143,294,14,15,744,583,161,7
10027,2023-02-22 19:00:00,135,281,8,14,601,453,148,6
10028,2023-02-22 20:00:00,147,299,11,14,625,444,181,6
10029,2023-02-22 21:00:00,137,295,6,15,783,674,109,6
10030,2023-02-22 22:00:00,141,288,8,16,632,555,77,13
10031,2023-02-22 23:00:00,141,290,11,19,675,537,138,10
10032,2023-02-23 00:00:00,136,288,13,10,794,607,187,10
10033,2023-02-23 01:00:00,143,271,12,17,654,466,188,7
10034,2023-02-23 02:00:00,126,299,10,12,747,557,190,7
10035,2023-02-23 03:00:00,146,255,8,10,728,533,195,14
10036,2023-02-23 04:00:00,149,293,8,19,667,522,145,11
10037,2023-02-23 05:00:00,130,255,9,13,518,462,56,7
10038,2023-02-23 06:00:00,143,269,11,19,529,470,59,6
10039,2023-02-23 07:00:00,127,264,8,12,781,594,187,14
10040,2023-02-23 08:00:00,123,283,10,15,783,603,180,6
10041,2023-02-23 09:00:00,120,283,11,11,516,427,89,14
10042,2023-02-23 10:00:00,137,285,10,14,664,466,198,14
10043,2023-02-23 11:00:00,121,272,12,16,770,652,118,8
10044,2023-02-23 12:00:00,141,298,6,12,772,650,122,6
10045,2023-02-23 13:00:00,123,291,13,16,524,454,70,14
10046,2023-02-23 14:00:00,137,292,6,13,747,552,195,7
10047,2023-02-23 15:00:00,130,286,13,14,626,493,133,8
10048,2023-02-23 16:00:00,130,292,7,17,571,461,110,11
10049,2023-02-23 17:00:00,138,268,5,11,534,465,69,6
10050,2023-02-23 18:00:00,134,279,10,13,777,697,80,14
10051,2023-02-23 19:00:00,121,269,9,19,679,610,69,6
10052,2023-02-23 20:00:00,129,262,14,15,797,613,184,8
10053,2023-02-23 21:00:00,125,288,6,18,609,430,179,11
10054,2023-02-23 22:00:00,139,268,14,17,516,451,65,13
10055,2023-02-23 23:00:00,143,263,12,18,742,590,152,13
10056,2023-02-24 00:00:00,136,286,5,12,755,575,180,13
10057,2023-02-24 01:00:00,131,277,5,19,545,475,70,8
10058,2023-02-24 02:00:00,140,273,8,12,758,600,158,8
10059,2023-02-24 03:00:00,132,259,9,14,713,518,195,5
10060,2023-02-24 04:00:00,147,270,5,11,588,447,141,11
10061,2023-02-24 05:00:00,125,288,6,12,577,445,132,8
10062,2023-02-24 06:00:00,133,274,11,14,668,582,86,5
10063,2023-02-24 07:00:00,134,278,7,14,701,575,126,7
10064,2023-02-24 08:00:00,127,280,14,14,517,370,147,14
10065,2023-02-24 09:00:00,121,290,12,18,579,442,137,8
10066,2023-02-24 10:00:00,145,276,9,13,778,665,113,9
10067,2023-02-24 11:00:00,120,298,5,14,798,584,214,11
10068,2023-02-24 12:00:00,127,272,6,13,768,675,93,10
10069,2023-02-24 13:00:00,141,266,11,15,636,504,132,12
10070,2023-02-24 14:00:00,149,261,13,18,792,605,187,11
10071,2023-02-24 15:00:00,138,273,8,18,783,615,168,7
10072,2023-02-24 16:00:00,121,291,7,14,551,386,165,12
10073,2023-02-24 17:00:00,143,286,8,12,727,570,157,9
10074,2023-02-24 18:00:00,125,264,10,12,593,429,164,5
10075,2023-02-24 19:00:00,129,264,6,17,553,460,93,11
10076,2023-02-24 20:00:00,148,285,7,13,570,447,123,9
10077,2023-02-24 21:00:00,147,288,5,17,551,493,58,6
10078,2023-02-24 22:00:00,125,288,6,18,725,578,147,5
10079,2023-02-24 23:00:00,143,257,6,14,656,473,183,11
10080,2023-02-25 00:00:00,134,294,10,13,623,481,142,13
10081,2023-02-25 01:00:00,126,289,14,12,699,519,180,14
10082,2023-02-25 02:00:00,143,266,10,16,688,591,97,14
10083,2023-02-25 03:00:00,131,252,7,19,723,575,148,5
10084,2023-02-25 04:00:00,126,259,14,15,778,656,122,13
10085,2023-02-25 05:00:00,133,297,7,17,613,465,148,14
10086,2023-02-25 06:00:00,143,268,12,12,769,543,226,11
10087,2023-02-25 07:00:00,126,280,13,10,756,606,150,8
10088,2023-02-25 08:00:00,145,272,7,16,763,674,89,10
10089,2023-02-25 09:00:00,131,296,11,18,510,424,86,14
10090,2023-02-25 10:00:00,138,281,10,14,754,651,103,13
10091,2023-02-25 11:00:00,128,279,14,19,544,463,81,11
10092,2023-02-25 12:00:00,143,280,11,15,635,478,157,14
10093,2023-02-25 13:00:00,138,278,10,13,615,478,137,10
10094,2023-02-25 14:00:00,121,256,7,16,691,603,88,13
10095,2023-02-25 15:00:00,143,294,13,18,565,497,68,14
10096,2023-02-25 16:00:00,130,290,7,15,509,429,80,11
10097,2023-02-25 17:00:00,124,261,11,17,783,570,213,13
10098,2023-02-25 18:00:00,130,281,9,12,535,389,146,5
10099,2023-02-25 19:00:00,136,274,8,15,753,595,158,13
10100,2023-02-25 20:00:00,142,274,12,13,727,617,110,12
10101,2023-02-25 21:00:00,123,297,14,18,565,442,123,10
10102,2023-02-25 22:00:00,129,299,9,19,528,411,117,9
10103,2023-02-25 23:00:00,134,254,13,16,506,436,70,6
10104,2023-02-26 00:00:00,142,258,5,10,731,530,201,11
10105,2023-02-26 01:00:00,132,280,10,10,566,436,130,9
10106,2023-02-26 02:00:00,142,274,14,10,651,491,160,12
10107,2023-02-26 03:00:00,128,284,10,10,662,577,85,9
10108,2023-02-26 04:00:00,123,273,9,10,644,554,90,6
10109,2023-02-26 05:00:00,128,252,13,14,519,394,125,5
10110,2023-02-26 06:00:00,138,278,5,18,677,555,122,13
10111,2023-02-26 07:00:00,139,258,11,19,766,570,196,8
10112,2023-02-26 08:00:00,125,286,12,10,628,557,71,13
10113,2023-02-26 09:00:00,133,292,7,17,621,491,130,14
10114,2023-02-26 10:00:00,135,266,12,10,519,455,64,10
10115,2023-02-26 11:00:00,132,272,12,10,789,692,97,8
10116,2023-02-26 12:00:00,122,279,7,12,644,454,190,5
10117,2023-02-26 13:00:00,149,282,13,12,624,515,109,13
10118,2023-02-26 14:00:00,140,267,7,19,519,402,117,11
10119,2023-02-26 15:00:00,126,286,9,10,523,386,137,9
10120,2023-02-26 16:00:00,142,291,7,16,526,421,105,14
10121,2023-02-26 17:00:00,142,289,14,19,764,633,131,10
10122,2023-02-26 18:00:00,137,297,7,16,769,604,165,8
10123,2023-02-26 19:00:00,137,297,10,10,568,416,152,8
10124,2023-02-26 20:00:00,136,284,5,15,525,427,98,13
10125,2023-02-26 21:00:00,134,261,14,13,799,594,205,6
10126,2023-02-26 22:00:00,125,294,11,19,646,544,102,6
10127,2023-02-26 23:00:00,126,295,13,10,686,613,73,7
10128,2023-02-27 00:00:00,134,266,14,11,725,543,182,10
10129,2023-02-27 01:00:00,148,291,6,13,781,698,83,5
10130,2023-02-27 02:00:00,136,264,14,11,745,581,164,12
10131,2023-02-27 03:00:00,140,297,7,16,642,551,91,7
10132,2023-02-27 04:00:00,141,281,7,13,662,542,120,8
10133,2023-02-27 05:00:00,123,280,9,10,644,470,174,9
10134,2023-02-27 06:00:00,142,263,13,10,521,368,153,9
10135,2023-02-27 07:00:00,143,284,7,17,795,709,86,5
10136,2023-02-27 08:00:00,137,272,13,17,733,529,204,5
10137,2023-02-27 09:00:00,142,293,11,11,653,548,105,7
10138,2023-02-27 10:00:00,135,269,9,14,620,538,82,7
10139,2023-02-27 11:00:00,133,291,8,11,720,509,211,9
10140,2023-02-27 12:00:00,130,288,7,18,594,524,70,9
10141,2023-02-27 13:00:00,148,272,14,16,669,541,128,13
10142,2023-02-27 14:00:00,127,284,12,11,660,484,176,12
10143,2023-02-27 15:00:00,121,255,9,14,611,547,64,14
10144,2023-02-27 16:00:00,131,299,6,10,769,665,104,13
10145,2023-02-27 17:00:00,123,293,14,12,784,601,183,11
10146,2023-02-27 18:00:00,127,266,6,10,600,463,137,13
10147,2023-02-27 19:00:00,123,251,5,16,778,612,166,6
10148,2023-02-27 20:00:00,128,267,10,11,601,429,172,8
10149,2023-02-27 21:00:00,121,282,14,16,725,508,217,8
10150,2023-02-27 22:00:00,149,288,13,12,661,506,155,8
10151,2023-02-27 23:00:00,148,291,8,18,569,409,160,6
10152,2023-02-28 00:00:00,136,276,9,10,799,705,94,12
10153,2023-02-28 01:00:00,120,289,11,10,672,535,137,11
10154,2023-02-28 02:00:00,128,269,9,12,679,546,133,14
10155,2023-02-28 03:00:00,127,250,7,13,608,504,104,10
10156,2023-02-28 04:00:00,144,275,6,16,798,676,122,13
10157,2023-02-28 05:00:00,138,250,14,10,769,662,107,10
10158,2023-02-28 06:00:00,127,253,7,19,572,488,84,10
10159,2023-02-28 07:00:00,128,280,6,10,690,513,177,9
10160,2023-02-28 08:00:00,131,252,11,16,721,532,189,7
10161,2023-02-28 09:00:00,126,279,7,12,632,454,178,13
10162,2023-02-28 10:00:00,134,256,14,14,666,512,154,11
10163,2023-02-28 11:00:00,128,295,7,17,793,573,220,9
10164,2023-02-28 12:00:00,126,265,9,18,627,468,159,11
10165,2023-02-28 13:00:00,123,258,9,18,632,550,82,10
10166,2023-02-28 14:00:00,130,285,7,15,586,459,127,14
10167,2023-02-28 15:00:00,128,278,14,14,690,548,142,7
10168,2023-02-28 16:00:00,122,275,6,11,543,420,123,10
10169,2023-02-28 17:00:00,142,262,5,14,767,557,210,13
10170,2023-02-28 18:00:00,145,276,9,19,542,467,75,7
10171,2023-02-28 19:00:00,138,297,8,16,528,409,119,10
10172,2023-02-28 20:00:00,135,299,7,18,778,587,191,13
10173,2023-02-28 21:00:00,134,259,14,11,692,594,98,14
10174,2023-02-28 22:00:00,128,298,6,14,745,561,184,9
10175,2023-02-28 23:00:00,130,292,7,13,764,592,172,13
10176,2023-03-01 00:00:00,148,264,5,14,702,524,178,12
10177,2023-03-01 01:00:00,123,292,9,14,548,454,94,12
10178,2023-03-01 02:00:00,141,294,8,10,544,482,62,13
10179,2023-03-01 03:00:00,140,273,13,17,652,535,117,14
10180,2023-03-01 04:00:00,136,290,13,12,567,481,86,10
10181,2023-03-01 05:00:00,143,258,8,12,678,549,129,7
10182,2023-03-01 06:00:00,146,276,7,16,617,449,168,11
10183,2023-03-01 07:00:00,132,289,9,12,712,577,135,12
10184,2023-03-01 08:00:00,130,295,9,17,572,489,83,11
10185,2023-03-01 09:00:00,145,289,9,15,647,481,166,14
10186,2023-03-01 10:00:00,143,252,7,17,513,377,136,6
10187,2023-03-01 11:00:00,124,292,6,12,602,533,69,13
10188,2023-03-01 12:00:00,143,252,12,14,799,687,112,5
10189,2023-03-01 13:00:00,122,293,12,16,500,386,114,9
10190,2023-03-01 14:00:00,131,274,5,13,640,553,87,13
10191,2023-03-01 15:00:00,142,294,9,17,576,411,165,8
10192,2023-03-01 16:00:00,132,274,7,12,689,492,197,11
10193,2023-03-01 17:00:00,123,279,5,13,568,410,158,11
10194,2023-03-01 18:00:00,127,278,11,18,615,451,164,8
10195,2023-03-01 19:00:00,140,298,6,13,679,480,199,13
10196,2023-03-01 20:00:00,128,275,8,10,514,429,85,12
10197,2023-03-01 21:00:00,146,282,5,12,556,393,163,13
10198,2023-03-01 22:00:00,135,293,7,11,555,488,67,6
10199,2023-03-01 23:00:00,132,258,6,19,517,419,98,7
10200,2023-03-02 00:00:00,137,271,12,14,747,589,158,6
10201,2023-03-02 01:00:00,127,279,7,18,563,489,74,7
10202,2023-03-02 02:00:00,134,280,14,18,707,613,94,13
10203,2023-03-02 03:00:00,124,265,5,14,759,552,207,14
10204,2023-03-02 04:00:00,134,252,13,13,634,544,90,10
10205,2023-03-02 05:00:00,141,291,8,18,780,594,186,12
10206,2023-03-02 06:00:00,120,288,7,15,618,532,86,12
10207,2023-03-02 07:00:00,128,289,5,16,794,635,159,5
10208,2023-03-02 08:00:00,142,296,10,12,709,604,105,7
10209,2023-03-02 09:00:00,122,299,10,12,690,567,123,13
10210,2023-03-02 10:00:00,123,267,10,14,648,544,104,7
10211,2023-03-02 11:00:00,146,291,12,18,698,498,200,5
10212,2023-03-02 12:00:00,121,293,13,19,645,564,81,10
10213,2023-03-02 13:00:00,131,257,5,14,504,440,64,12
10214,2023-03-02 14:00:00,146,261,7,13,673,485,188,7
10215,2023-03-02 15:00:00,133,261,7,19,746,568,178,13
10216,2023-03-02 16:00:00,126,259,14,11,604,486,118,10
10217,2023-03-02 17:00:00,148,264,9,18,655,564,91,12
10218,2023-03-02 18:00:00,141,280,14,17,774,547,227,14
10219,2023-03-02 19:00:00,129,269,9,16,738,572,166,5
10220,2023-03-02 20:00:00,122,280,14,18,531,437,94,5
10221,2023-03-02 21:00:00,125,289,5,19,630,539,91,8
10222,2023-03-02 22:00:00,124,271,6,14,658,538,120,7
10223,2023-03-02 23:00:00,140,286,8,14,760,681,79,10
10224,2023-03-03 00:00:00,134,265,9,13,608,472,136,7
10225,2023-03-03 01:00:00,124,278,8,10,679,531,148,12
10226,2023-03-03 02:00:00,142,275,12,13,575,428,147,5
10227,2023-03-03 03:00:00,124,291,14,12,518,425,93,9
10228,2023-03-03 04:00:00,140,262,14,15,611,428,183,5
10229,2023-03-03 05:00:00,123,255,12,14,701,566,135,14
10230,2023-03-03 06:00:00,133,286,6,12,581,493,88,5
10231,2023-03-03 07:00:00,129,263,13,14,516,375,141,8
10232,2023-03-03 08:00:00,120,254,6,18,681,580,101,12
10233,2023-03-03 09:00:00,122,252,10,13,735,656,79,14
10234,2023-03-03 10:00:00,130,297,7,13,776,641,135,8
10235,2023-03-03 11:00:00,129,286,11,15,600,491,109,9
10236,2023-03-03 12:00:00,134,252,11,17,542,417,125,10
10237,2023-03-03 13:00:00,134,262,10,14,598,432,166,8
10238,2023-03-03 14:00:00,144,277,12,19,513,439,74,6
10239,2023-03-03 15:00:00,132,276,14,12,784,688,96,7
10240,2023-03-03 16:00:00,140,280,11,18,559,494,65,14
10241,2023-03-03 17:00:00,130,287,11,11,632,474,158,12
10242,2023-03-03 18:00:00,125,271,6,12,657,536,121,9
10243,2023-03-03 19:00:00,137,296,13,10,793,619,174,14
10244,2023-03-03 20:00:00,122,264,5,13,742,628,114,10
10245,2023-03-03 21:00:00,134,291,11,12,760,669,91,14
10246,2023-03-03 22:00:00,120,289,11,18,621,558,63,8
10247,2023-03-03 23:00:00,128,266,14,18,685,512,173,12
10248,2023-03-04 00:00:00,125,283,14,14,584,421,163,5
10249,2023-03-04 01:00:00,127,298,11,10,512,451,61,7
10250,2023-03-04 02:00:00,144,291,10,14,786,574,212,5
10251,2023-03-04 03:00:00,149,264,11,18,559,435,124,5
10252,2023-03-04 04:00:00,141,269,11,11,561,495,66,10
10253,2023-03-04 05:00:00,129,298,12,12,504,360,144,11
10254,2023-03-04 06:00:00,148,289,11,17,559,476,83,13
10255,2023-03-04 07:00:00,149,281,13,15,612,526,86,9
10256,2023-03-04 08:00:00,132,267,6,18,787,618,169,14
10257,2023-03-04 09:00:00,123,295,6,15,513,449,64,10
10258,2023-03-04 10:00:00,149,264,11,12,689,571,118,5
10259,2023-03-04 11:00:00,125,269,11,11,659,564,95,11
10260,2023-03-04 12:00:00,127,278,13,18,582,467,115,12
10261,2023-03-04 13:00:00,120,251,5,10,613,486,127,14
10262,2023-03-04 14:00:00,124,295,14,17,737,586,151,5
10263,2023-03-04 15:00:00,138,251,10,16,583,448,135,14
10264,2023-03-04 16:00:00,147,295,9,15,523,388,135,11
10265,2023-03-04 17:00:00,144,277,6,12,577,469,108,10
10266,2023-03-04 18:00:00,147,266,10,10,694,500,194,8
10267,2023-03-04 19:00:00,139,250,9,12,565,441,124,10
10268,2023-03-04 20:00:00,142,269,9,13,750,659,91,8
10269,2023-03-04 21:00:00,145,266,9,11,551,411,140,13
10270,2023-03-04 22:00:00,148,283,7,18,766,583,183,12
10271,2023-03-04 23:00:00,136,280,10,16,564,491,73,7
10272,2023-03-05 00:00:00,133,272,11,13,766,674,92,10
10273,2023-03-05 01:00:00,148,294,8,10,721,562,159,12
10274,2023-03-05 02:00:00,127,299,11,19,601,463,138,5
10275,2023-03-05 03:00:00,124,287,6,17,610,469,141,6
10276,2023-03-05 04:00:00,139,287,14,18,789,611,178,10
10277,2023-03-05 05:00:00,122,284,13,12,506,365,141,11
10278,2023-03-05 06:00:00,133,272,6,17,676,477,199,9
10279,2023-03-05 07:00:00,130,290,5,11,672,524,148,12
10280,2023-03-05 08:00:00,129,280,6,15,683,551,132,9
10281,2023-03-05 09:00:00,136,250,13,16,788,679,109,10
10282,2023-03-05 10:00:00,138,263,5,13,604,491,113,9
10283,2023-03-05 11:00:00,146,297,9,18,625,484,141,5
10284,2023-03-05 12:00:00,121,256,7,11,550,468,82,7
10285,2023-03-05 13:00:00,141,277,9,12,710,558,152,12
10286,2023-03-05 14:00:00,139,285,12,14,540,453,87,7
10287,2023-03-05 15:00:00,120,256,11,10,706,574,132,11
10288,2023-03-05 16:00:00,127,265,11,12,670,593,77,14
10289,2023-03-05 17:00:00,145,296,12,15,710,533,177,13
10290,2023-03-05 18:00:00,147,255,14,12,753,528,225,14
10291,2023-03-05 19:00:00,123,294,5,12,783,551,232,14
10292,2023-03-05 20:00:00,120,280,7,11,659,526,133,7
10293,2023-03-05 21:00:00,123,278,8,10,656,480,176,13
10294,2023-03-05 22:00:00,147,253,12,16,515,427,88,14
10295,2023-03-05 23:00:00,148,288,13,16,710,510,200,9
10296,2023-03-06 00:00:00,129,285,14,12,560,393,167,5
10297,2023-03-06 01:00:00,148,260,6,17,602,466,136,7
10298,2023-03-06 02:00:00,142,295,14,15,506,438,68,7
10299,2023-03-06 03:00:00,122,295,6,10,625,490,135,5
10300,2023-03-06 04:00:00,143,257,7,15,655,507,148,8
10301,2023-03-06 05:00:00,145,281,7,12,510,362,148,6
10302,2023-03-06 06:00:00,130,256,8,13,785,570,215,14
10303,2023-03-06 07:00:00,131,287,6,17,792,644,148,5
10304,2023-03-06 08:00:00,135,272,7,12,748,644,104,10
10305,2023-03-06 09:00:00,124,257,13,12,537,392,145,8
10306,2023-03-06 10:00:00,141,289,10,16,731,554,177,6
10307,2023-03-06 11:00:00,135,293,12,14,766,610,156,9
10308,2023-03-06 12:00:00,140,287,6,16,551,478,73,8
10309,2023-03-06 13:00:00,138,266,14,19,723,594,129,10
10310,2023-03-06 14:00:00,123,272,7,19,596,502,94,10
10311,2023-03-06 15:00:00,125,267,11,18,713,629,84,12
10312,2023-03-06 16:00:00,132,262,9,17,649,545,104,13
10313,2023-03-06 17:00:00,149,261,7,11,772,619,153,14
10314,2023-03-06 18:00:00,120,286,10,10,746,651,95,14
10315,2023-03-06 19:00:00,121,257,12,17,519,448,71,13
10316,2023-03-06 20:00:00,131,291,7,12,502,400,102,12
10317,2023-03-06 21:00:00,133,257,11,11,797,641,156,14
10318,2023-03-06 22:00:00,142,271,6,18,618,535,83,14
10319,2023-03-06 23:00:00,147,294,7,11,599,508,91,12
10320,2023-03-07 00:00:00,143,296,12,16,669,541,128,10
10321,2023-03-07 01:00:00,136,271,11,16,717,612,105,5
10322,2023-03-07 02:00:00,143,257,5,16,757,627,130,13
10323,2023-03-07 03:00:00,135,293,8,12,669,558,111,14
10324,2023-03-07 04:00:00,142,298,7,11,704,537,167,6
10325,2023-03-07 05:00:00,121,289,5,10,527,390,137,11
10326,2023-03-07 06:00:00,144,258,9,16,584,490,94,9
10327,2023-03-07 07:00:00,131,256,6,18,745,668,77,8
10328,2023-03-07 08:00:00,125,252,10,15,580,521,59,9
10329,2023-03-07 09:00:00,149,251,9,18,713,600,113,10
10330,2023-03-07 10:00:00,123,278,8,10,508,394,114,6
10331,2023-03-07 11:00:00,124,276,9,15,609,521,88,6
10332,2023-03-07 12:00:00,134,267,12,17,764,649,115,5
10333,2023-03-07 13:00:00,125,287,12,16,575,481,94,8
10334,2023-03-07 14:00:00,129,269,11,10,618,509,109,5
10335,2023-03-07 15:00:00,132,285,6,17,678,518,160,6
10336,2023-03-07 16:00:00,129,270,13,12,590,508,82,6
10337,2023-03-07 17:00:00,128,297,11,16,617,492,125,9
10338,2023-03-07 18:00:00,132,274,6,18,544,386,158,11
10339,2023-03-07 19:00:00,127,264,13,14,687,584,103,12
10340,2023-03-07 20:00:00,146,297,10,15,693,608,85,5
10341,2023-03-07 21:00:00,133,278,9,10,621,453,168,7
10342,2023-03-07 22:00:00,123,274,12,15,600,427,173,12
10343,2023-03-07 23:00:00,132,265,8,19,653,564,89,6
10344,2023-03-08 00:00:00,125,269,11,17,698,525,173,10
10345,2023-03-08 01:00:00,144,258,12,15,590,518,72,5
10346,2023-03-08 02:00:00,149,282,12,10,695,586,109,13
10347,2023-03-08 03:00:00,135,293,5,12,642,475,167,14
10348,2023-03-08 04:00:00,122,285,9,12,682,480,202,13
10349,2023-03-08 05:00:00,141,277,10,11,553,433,120,8
10350,2023-03-08 06:00:00,128,266,8,15,657,537,120,5
10351,2023-03-08 07:00:00,146,297,12,10,789,709,80,5
10352,2023-03-08 08:00:00,121,277,14,13,647,489,158,10
10353,2023-03-08 09:00:00,137,298,6,19,755,628,127,10
10354,2023-03-08 10:00:00,122,280,6,13,639,537,102,12
10355,2023-03-08 11:00:00,148,270,10,13,644,499,145,5
10356,2023-03-08 12:00:00,139,263,11,11,590,447,143,9
10357,2023-03-08 13:00:00,146,288,8,17,654,479,175,10
10358,2023-03-08 14:00:00,135,292,6,12,503,439,64,7
10359,2023-03-08 15:00:00,136,297,14,14,793,713,80,11
10360,2023-03-08 16:00:00,126,276,5,11,532,415,117,10
10361,2023-03-08 17:00:00,136,257,8,12,799,711,88,10
10362,2023-03-08 18:00:00,146,299,13,18,573,438,135,7
10363,2023-03-08 19:00:00,144,275,10,10,698,600,98,11
10364,2023-03-08 20:00:00,135,275,7,15,648,560,88,10
10365,2023-03-08 21:00:00,144,299,12,14,611,513,98,9
10366,2023-03-08 22:00:00,121,291,10,11,533,376,157,11
10367,2023-03-08 23:00:00,147,293,13,18,584,522,62,6
10368,2023-03-09 00:00:00,134,293,7,12,561,487,74,13
10369,2023-03-09 01:00:00,141,279,11,16,593,527,66,7
10370,2023-03-09 02:00:00,139,280,10,12,664,560,104,5
10371,2023-03-09 03:00:00,138,288,6,19,528,376,152,13
10372,2023-03-09 04:00:00,145,289,12,13,517,412,105,5
10373,2023-03-09 05:00:00,133,275,5,17,667,523,144,9
10374,2023-03-09 06:00:00,122,279,8,11,712,592,120,6
10375,2023-03-09 07:00:00,128,298,10,19,547,385,162,8
10376,2023-03-09 08:00:00,125,299,9,19,708,539,169,7
10377,2023-03-09 09:00:00,129,269,14,12,796,590,206,14
10378,2023-03-09 10:00:00,141,293,6,13,692,522,170,13
10379,2023-03-09 11:00:00,132,289,9,12,557,436,121,11
10380,2023-03-09 12:00:00,146,252,12,14,769,574,195,6
10381,2023-03-09 13:00:00,126,272,12,12,756,533,223,8
10382,2023-03-09 14:00:00,140,282,6,17,647,488,159,7
10383,2023-03-09 15:00:00,124,257,8,12,511,458,53,11
10384,2023-03-09 16:00:00,136,293,11,13,589,466,123,14
10385,2023-03-09 17:00:00,139,270,5,11,687,522,165,6
10386,2023-03-09 18:00:00,139,296,5,13,645,502,143,13
10387,2023-03-09 19:00:00,149,282,6,12,768,627,141,11
10388,2023-03-09 20:00:00,142,286,11,15,618,555,63,8
10389,2023-03-09 21:00:00,125,284,8,11,634,503,131,9
10390,2023-03-09 22:00:00,121,297,12,13,584,415,169,9
10391,2023-03-09 23:00:00,145,281,8,19,763,584,179,12
10392,2023-03-10 00:00:00,129,289,13,11,794,564,230,11
10393,2023-03-10 01:00:00,134,289,10,10,731,593,138,10
10394,2023-03-10 02:00:00,142,277,6,14,728,618,110,5
10395,2023-03-10 03:00:00,120,278,10,18,779,613,166,12
10396,2023-03-10 04:00:00,124,275,11,17,729,576,153,5
10397,2023-03-10 05:00:00,148,264,5,17,788,606,182,10
10398,2023-03-10 06:00:00,134,281,7,14,641,552,89,14
10399,2023-03-10 07:00:00,141,270,13,18,642,523,119,7
10400,2023-03-10 08:00:00,142,258,11,19,624,534,90,11
10401,2023-03-10 09:00:00,137,255,14,16,640,473,167,9
10402,2023-03-10 10:00:00,120,257,7,18,519,401,118,6
10403,2023-03-10 11:00:00,125,250,6,19,590,430,160,10
10404,2023-03-10 12:00:00,138,269,14,12,566,494,72,10
10405,2023-03-10 13:00:00,139,258,7,15,629,548,81,13
10406,2023-03-10 14:00:00,122,289,11,15,716,563,153,9
10407,2023-03-10 15:00:00,134,291,10,15,551,409,142,8
10408,2023-03-10 16:00:00,129,250,7,15,683,577,106,8
10409,2023-03-10 17:00:00,137,295,12,17,520,467,53,9
10410,2023-03-10 18:00:00,125,256,8,19,634,466,168,6
10411,2023-03-10 19:00:00,122,297,12,17,778,673,105,11
10412,2023-03-10 20:00:00,133,295,7,19,547,406,141,11
10413,2023-03-10 21:00:00,131,263,10,18,673,522,151,10
10414,2023-03-10 22:00:00,145,263,6,12,536,380,156,14
10415,2023-03-10 23:00:00,142,271,6,13,763,686,77,6
10416,2023-03-11 00:00:00,138,287,12,16,618,552,66,6
10417,2023-03-11 01:00:00,132,257,11,13,599,519,80,14
10418,2023-03-11 02:00:00,138,287,12,11,613,524,89,7
10419,2023-03-11 03:00:00,127,272,8,12,728,509,219,14
10420,2023-03-11 04:00:00,139,260,9,15,741,540,201,11
10421,2023-03-11 05:00:00,125,280,7,16,715,570,145,14
10422,2023-03-11 06:00:00,120,281,6,15,709,577,132,9
10423,2023-03-11 07:00:00,149,261,11,13,523,433,90,13
10424,2023-03-11 08:00:00,142,285,12,14,514,375,139,13
10425,2023-03-11 09:00:00,145,261,8,19,655,509,146,6
10426,2023-03-11 10:00:00,148,257,8,10,796,600,196,11
10427,2023-03-11 11:00:00,124,258,12,10,545,414,131,9
10428,2023-03-11 12:00:00,134,281,13,11,541,477,64,10
10429,2023-03-11 13:00:00,123,280,8,11,727,573,154,10
10430,2023-03-11 14:00:00,129,267,7,10,585,518,67,5
10431,2023-03-11 15:00:00,132,290,5,12,734,552,182,8
10432,2023-03-11 16:00:00,133,264,5,19,774,614,160,7
10433,2023-03-11 17:00:00,144,291,12,10,585,436,149,5
10434,2023-03-11 18:00:00,136,294,12,19,639,566,73,14
10435,2023-03-11 19:00:00,143,254,8,15,691,552,139,11
10436,2023-03-11 20:00:00,133,285,11,12,514,449,65,14
10437,2023-03-11 21:00:00,135,250,11,18,688,617,71,10
10438,2023-03-11 22:00:00,143,258,6,10,610,462,148,10
10439,2023-03-11 23:00:00,147,257,12,19,692,564,128,8
10440,2023-03-12 00:00:00,124,286,9,16,536,451,85,6
10441,2023-03-12 01:00:00,125,284,6,11,610,431,179,11
10442,2023-03-12 02:00:00,124,290,11,12,747,655,92,8
10443,2023-03-12 03:00:00,143,252,14,13,711,603,108,10
10444,2023-03-12 04:00:00,131,254,8,11,738,619,119,6
10445,2023-03-12 05:00:00,129,268,5,13,776,671,105,7
10446,2023-03-12 06:00:00,124,298,6,16,515,365,150,11
10447,2023-03-12 07:00:00,138,262,8,12,726,583,143,9
10448,2023-03-12 08:00:00,146,271,8,11,534,409,125,10
10449,2023-03-12 09:00:00,137,271,5,19,631,556,75,12
10450,2023-03-12 10:00:00,142,287,6,12,729,572,157,7
10451,2023-03-12 11:00:00,120,280,8,14,683,580,103,5
10452,2023-03-12 12:00:00,123,260,11,12,514,420,94,14
10453,2023-03-12 13:00:00,148,259,10,12,614,491,123,10
10454,2023-03-12 14:00:00,147,295,6,11,602,516,86,6
10455,2023-03-12 15:00:00,141,262,5,17,775,577,198,9
10456,2023-03-12 16:00:00,147,276,6,18,524,411,113,6
10457,2023-03-12 17:00:00,127,285,13,18,787,688,99,6
10458,2023-03-12 18:00:00,137,291,8,15,693,557,136,10
10459,2023-03-12 19:00:00,146,283,8,15,660,466,194,9
10460,2023-03-12 20:00:00,128,278,11,17,766,685,81,11
10461,2023-03-12 21:00:00,143,266,10,14,698,518,180,8
10462,2023-03-12 22:00:00,122,254,14,17,544,464,80,12
10463,2023-03-12 23:00:00,139,274,11,15,702,600,102,14
10464,2023-03-13 00:00:00,135,260,9,19,707,562,145,11
10465,2023-03-13 01:00:00,124,269,9,15,749,557,192,14
10466,2023-03-13 02:00:00,126,284,8,16,737,654,83,13
10467,2023-03-13 03:00:00,146,296,12,19,568,466,102,7
10468,2023-03-13 04:00:00,138,278,9,15,773,647,126,11
10469,2023-03-13 05:00:00,128,281,9,12,775,623,152,13
10470,2023-03-13 06:00:00,139,270,13,11,779,622,157,14
10471,2023-03-13 07:00:00,148,285,13,12,616,529,87,10
10472,2023-03-13 08:00:00,125,279,10,17,751,635,116,12
10473,2023-03-13 09:00:00,139,292,8,18,567,460,107,9
10474,2023-03-13 10:00:00,131,272,11,19,524,408,116,7
10475,2023-03-13 11:00:00,132,283,12,10,622,447,175,10
10476,2023-03-13 12:00:00,139,297,6,13,797,677,120,9
10477,2023-03-13 13:00:00,129,282,8,14,519,409,110,11
10478,2023-03-13 14:00:00,135,257,13,12,548,397,151,5
10479,2023-03-13 15:00:00,127,298,12,13,697,568,129,14
10480,2023-03-13 16:00:00,133,293,12,16,584,446,138,8
10481,2023-03-13 17:00:00,133,253,11,17,670,565,105,13
10482,2023-03-13 18:00:00,126,287,8,12,722,540,182,10
10483,2023-03-13 19:00:00,138,282,10,10,633,521,112,13
10484,2023-03-13 20:00:00,139,250,9,19,708,543,165,9
10485,2023-03-13 21:00:00,143,267,9,16,718,576,142,5
10486,2023-03-13 22:00:00,144,259,9,11,538,407,131,13
10487,2023-03-13 23:00:00,122,282,8,18,788,613,175,13
10488,2023-03-14 00:00:00,145,289,8,16,504,406,98,14
10489,2023-03-14 01:00:00,141,282,10,14,664,526,138,7
10490,2023-03-14 02:00:00,130,279,11,11,764,537,227,9
10491,2023-03-14 03:00:00,133,289,12,11,729,578,151,13
10492,2023-03-14 04:00:00,120,272,13,13,583,473,110,6
10493,2023-03-14 05:00:00,143,291,13,17,738,610,128,9
10494,2023-03-14 06:00:00,129,293,11,15,535,414,121,5
10495,2023-03-14 07:00:00,132,288,11,12,782,701,81,9
10496,2023-03-14 08:00:00,133,261,8,17,628,525,103,14
10497,2023-03-14 09:00:00,146,299,11,14,619,522,97,5
10498,2023-03-14 10:00:00,134,286,8,17,668,530,138,5
10499,2023-03-14 11:00:00,135,261,9,19,573,421,152,12
10500,2023-03-14 12:00:00,133,264,10,12,638,471,167,10
10501,2023-03-14 13:00:00,142,271,6,19,684,515,169,6
10502,2023-03-14 14:00:00,137,263,10,13,684,534,150,8
10503,2023-03-14 15:00:00,133,286,11,10,501,443,58,11
10504,2023-03-14 16:00:00,125,266,14,16,615,446,169,14
10505,2023-03-14 17:00:00,124,293,6,11,714,567,147,9
10506,2023-03-14 18:00:00,147,262,10,11,704,613,91,11
10507,2023-03-14 19:00:00,145,288,6,13,799,713,86,8
10508,2023-03-14 20:00:00,134,293,8,17,679,602,77,11
10509,2023-03-14 21:00:00,135,261,9,15,717,609,108,8
10510,2023-03-14 22:00:00,139,288,10,16,712,527,185,7
10511,2023-03-14 23:00:00,134,281,12,15,540,417,123,8
10512,2023-03-15 00:00:00,143,272,5,17,720,561,159,11
10513,2023-03-15 01:00:00,132,256,5,11,781,636,145,6
10514,2023-03-15 02:00:00,146,291,7,11,601,485,116,13
10515,2023-03-15 03:00:00,149,255,14,13,543,402,141,13
10516,2023-03-15 04:00:00,139,263,9,15,531,433,98,13
10517,2023-03-15 05:00:00,142,271,11,19,522,425,97,12
10518,2023-03-15 06:00:00,144,295,6,12,646,480,166,8
10519,2023-03-15 07:00:00,130,283,8,18,652,490,162,11
10520,2023-03-15 08:00:00,134,263,5,18,683,535,148,5
10521,2023-03-15 09:00:00,143,258,7,10,705,631,74,13
10522,2023-03-15 10:00:00,131,290,9,18,556,432,124,7
10523,2023-03-15 11:00:00,142,273,5,15,506,365,141,9
10524,2023-03-15 12:00:00,129,279,11,13,589,455,134,11
10525,2023-03-15 13:00:00,135,291,14,12,629,520,109,8
10526,2023-03-15 14:00:00,142,251,6,16,787,611,176,13
10527,2023-03-15 15:00:00,121,256,14,14,699,541,158,11
10528,2023-03-15 16:00:00,136,250,9,11,589,512,77,7
10529,2023-03-15 17:00:00,139,255,10,10,589,432,157,8
10530,2023-03-15 18:00:00,149,269,9,15,645,522,123,11
10531,2023-03-15 19:00:00,143,298,5,16,764,644,120,9
10532,2023-03-15 20:00:00,136,298,7,18,733,638,95,11
10533,2023-03-15 21:00:00,137,274,7,11,683,583,100,8
10534,2023-03-15 22:00:00,139,271,11,15,609,428,181,12
10535,2023-03-15 23:00:00,134,274,10,10,713,528,185,10
10536,2023-03-16 00:00:00,145,298,13,14,575,479,96,13
10537,2023-03-16 01:00:00,141,269,10,11,602,442,160,8
10538,2023-03-16 02:00:00,141,277,5,11,592,429,163,10
10539,2023-03-16 03:00:00,147,285,11,12,737,624,113,5
10540,2023-03-16 04:00:00,129,267,6,12,755,635,120,5
10541,2023-03-16 05:00:00,141,254,8,17,535,464,71,6
10542,2023-03-16 06:00:00,121,288,11,19,641,533,108,8
10543,2023-03-16 07:00:00,145,260,9,18,677,504,173,8
10544,2023-03-16 08:00:00,143,266,9,18,713,637,76,9
10545,2023-03-16 09:00:00,128,295,12,18,538,477,61,12
10546,2023-03-16 10:00:00,141,279,9,16,657,571,86,10
10547,2023-03-16 11:00:00,127,257,11,19,552,471,81,6
10548,2023-03-16 12:00:00,124,295,11,19,591,431,160,13
10549,2023-03-16 13:00:00,133,268,8,12,677,482,195,13
10550,2023-03-16 14:00:00,149,266,10,14,590,432,158,10
10551,2023-03-16 15:00:00,140,274,5,18,568,489,79,12
10552,2023-03-16 16:00:00,123,272,10,17,757,532,225,13
10553,2023-03-16 17:00:00,126,297,9,11,719,641,78,6
10554,2023-03-16 18:00:00,123,272,12,19,799,660,139,7
10555,2023-03-16 19:00:00,127,259,13,18,793,586,207,14
10556,2023-03-16 20:00:00,133,278,12,19,532,439,93,9
10557,2023-03-16 21:00:00,149,265,14,19,537,469,68,8
10558,2023-03-16 22:00:00,133,269,11,19,569,436,133,13
10559,2023-03-16 23:00:00,143,299,12,15,503,398,105,13
10560,2023-03-17 00:00:00,130,270,9,14,588,523,65,9
10561,2023-03-17 01:00:00,122,250,14,14,793,573,220,5
10562,2023-03-17 02:00:00,128,263,11,18,634,478,156,14
10563,2023-03-17 03:00:00,132,275,7,19,758,654,104,13
10564,2023-03-17 04:00:00,127,269,9,16,590,465,125,7
10565,2023-03-17 05:00:00,143,253,14,10,629,535,94,13
10566,2023-03-17 06:00:00,146,284,7,11,679,597,82,12
10567,2023-03-17 07:00:00,135,285,11,10,677,598,79,7
10568,2023-03-17 08:00:00,127,270,8,15,605,457,148,6
10569,2023-03-17 09:00:00,137,263,10,18,789,552,237,6
10570,2023-03-17 10:00:00,135,277,8,16,797,562,235,6
10571,2023-03-17 11:00:00,143,275,10,12,719,570,149,11
10572,2023-03-17 12:00:00,140,293,10,12,579,503,76,5
10573,2023-03-17 13:00:00,121,289,8,11,624,454,170,7
10574,2023-03-17 14:00:00,123,293,6,13,580,464,116,13
10575,2023-03-17 15:00:00,137,280,14,15,637,540,97,8
10576,2023-03-17 16:00:00,143,297,5,14,778,550,228,5
10577,2023-03-17 17:00:00,139,264,5,12,773,678,95,12
10578,2023-03-17 18:00:00,138,291,5,13,509,416,93,10
10579,2023-03-17 19:00:00,132,262,14,17,770,648,122,12
10580,2023-03-17 20:00:00,131,271,9,15,686,534,152,8
10581,2023-03-17 21:00:00,145,285,13,10,538,448,90,5
10582,2023-03-17 22:00:00,135,251,10,17,587,495,92,9
10583,2023-03-17 23:00:00,140,293,8,10,707,523,184,6
10584,2023-03-18 00:00:00,144,285,11,19,602,531,71,13
10585,2023-03-18 01:00:00,130,257,8,15,602,441,161,13
10586,2023-03-18 02:00:00,141,291,5,18,667,570,97,7
10587,2023-03-18 03:00:00,143,281,10,16,784,637,147,11
10588,2023-03-18 04:00:00,125,256,9,18,739,523,216,5
10589,2023-03-18 05:00:00,142,268,7,16,790,676,114,11
10590,2023-03-18 06:00:00,128,260,14,18,507,401,106,14
10591,2023-03-18 07:00:00,139,279,9,17,633,549,84,14
10592,2023-03-18 08:00:00,137,292,11,19,512,435,77,13
10593,2023-03-18 09:00:00,143,279,5,18,529,374,155,12
10594,2023-03-18 10:00:00,149,265,8,19,591,428,163,7
10595,2023-03-18 11:00:00,135,255,8,14,575,445,130,9
10596,2023-03-18 12:00:00,139,264,9,17,777,638,139,11
10597,2023-03-18 13:00:00,129,289,5,10,793,560,233,14
10598,2023-03-18 14:00:00,140,252,6,18,555,408,147,7
10599,2023-03-18 15:00:00,124,274,13,16,570,490,80,8
10600,2023-03-18 16:00:00,140,280,13,10,729,610,119,8
10601,2023-03-18 17:00:00,127,292,12,10,756,654,102,7
10602,2023-03-18 18:00:00,124,268,5,16,647,545,102,6
10603,2023-03-18 19:00:00,124,252,14,15,645,549,96,10
10604,2023-03-18 20:00:00,149,258,14,11,580,429,151,13
10605,2023-03-18 21:00:00,127,262,14,19,605,431,174,12
10606,2023-03-18 22:00:00,129,272,10,14,541,455,86,14
10607,2023-03-18 23:00:00,142,284,5,17,741,610,131,8
10608,2023-03-19 00:00:00,126,265,11,14,554,480,74,14
10609,2023-03-19 01:00:00,133,290,13,13,569,475,94,13
10610,2023-03-19 02:00:00,122,270,13,18,735,603,132,7
10611,2023-03-19 03:00:00,132,273,8,12,732,593,139,8
10612,2023-03-19 04:00:00,121,271,10,18,606,445,161,10
10613,2023-03-19 05:00:00,147,259,13,14,754,623,131,5
10614,2023-03-19 06:00:00,127,261,10,19,775,663,112,6
10615,2023-03-19 07:00:00,139,268,9,12,732,599,133,11
10616,2023-03-19 08:00:00,129,257,14,10,753,640,113,10
10617,2023-03-19 09:00:00,146,297,8,18,797,676,121,8
10618,2023-03-19 10:00:00,128,296,10,15,794,611,183,8
10619,2023-03-19 11:00:00,123,298,13,17,760,601,159,9
10620,2023-03-19 12:00:00,133,287,8,12,578,409,169,9
10621,2023-03-19 13:00:00,129,260,8,17,665,588,77,6
10622,2023-03-19 14:00:00,143,276,13,12,798,601,197,9
10623,2023-03-19 15:00:00,124,254,7,15,751,654,97,11
10624,2023-03-19 16:00:00,139,259,9,15,794,593,201,14
10625,2023-03-19 17:00:00,129,278,11,16,534,375,159,11
10626,2023-03-19 18:00:00,145,291,14,19,644,456,188,8
10627,2023-03-19 19:00:00,135,264,9,15,522,423,99,5
10628,2023-03-19 20:00:00,144,267,12,16,700,619,81,12
10629,2023-03-19 21:00:00,142,261,6,15,757,626,131,12
10630,2023-03-19 22:00:00,127,293,14,14,560,439,121,7
10631,2023-03-19 23:00:00,142,263,14,17,696,621,75,5
10632,2023-03-20 00:00:00,139,258,10,19,756,634,122,5
10633,2023-03-20 01:00:00,138,271,11,13,596,470,126,5
10634,2023-03-20 02:00:00,133,261,9,14,500,411,89,11
10635,2023-03-20 03:00:00,131,263,11,13,786,656,130,8
10636,2023-03-20 04:00:00,135,257,9,11,522,423,99,12
10637,2023-03-20 05:00:00,140,256,8,16,625,546,79,12
10638,2023-03-20 06:00:00,144,257,7,11,677,584,93,8
10639,2023-03-20 07:00:00,124,289,13,17,570,504,66,14
10640,2023-03-20 08:00:00,138,259,5,10,667,529,138,13
10641,2023-03-20 09:00:00,134,279,5,13,517,390,127,11
10642,2023-03-20 10:00:00,122,291,10,16,644,485,159,5
10643,2023-03-20 11:00:00,139,265,5,10,739,659,80,14
10644,2023-03-20 12:00:00,140,291,7,10,517,437,80,5
10645,2023-03-20 13:00:00,126,295,12,14,730,644,86,8
10646,2023-03-20 14:00:00,122,295,7,11,743,600,143,13
10647,2023-03-20 15:00:00,125,299,7,17,685,526,159,10
10648,2023-03-20 16:00:00,144,265,7,12,697,509,188,11
10649,2023-03-20 17:00:00,137,256,13,13,504,445,59,10
10650,2023-03-20 18:00:00,148,261,8,17,747,650,97,6
10651,2023-03-20 19:00:00,149,288,8,14,634,505,129,13
10652,2023-03-20 20:00:00,142,276,11,13,691,535,156,13
10653,2023-03-20 21:00:00,131,279,8,16,685,590,95,8
10654,2023-03-20 22:00:00,127,263,13,11,762,549,213,14
10655,2023-03-20 23:00:00,143,271,12,11,742,590,152,13
10656,2023-03-21 00:00:00,140,277,5,10,560,502,58,10
10657,2023-03-21 01:00:00,146,273,7,17,524,451,73,5
10658,2023-03-21 02:00:00,127,283,10,10,731,587,144,12
10659,2023-03-21 03:00:00,121,277,13,15,716,550,166,11
10660,2023-03-21 04:00:00,147,284,13,13,656,498,158,14
10661,2023-03-21 05:00:00,122,251,12,18,682,530,152,10
10662,2023-03-21 06:00:00,124,282,9,17,674,562,112,8
10663,2023-03-21 07:00:00,143,273,14,12,798,634,164,10
10664,2023-03-21 08:00:00,148,259,10,17,597,470,127,7
10665,2023-03-21 09:00:00,135,266,14,19,697,610,87,11
10666,2023-03-21 10:00:00,143,269,5,16,591,460,131,10
10667,2023-03-21 11:00:00,132,261,6,13,651,486,165,13
10668,2023-03-21 12:00:00,142,282,6,14,771,604,167,11
10669,2023-03-21 13:00:00,146,291,8,12,771,690,81,9
10670,2023-03-21 14:00:00,128,265,10,14,660,543,117,7
10671,2023-03-21 15:00:00,123,296,14,10,575,484,91,9
10672,2023-03-21 16:00:00,125,296,13,13,567,493,74,8
10673,2023-03-21 17:00:00,137,282,8,10,540,379,161,11
10674,2023-03-21 18:00:00,129,298,14,15,757,678,79,11
10675,2023-03-21 19:00:00,125,278,10,11,511,445,66,7
10676,2023-03-21 20:00:00,147,256,6,11,772,619,153,10
10677,2023-03-21 21:00:00,129,293,7,17,783,692,91,14
10678,2023-03-21 22:00:00,147,294,9,18,754,614,140,11
10679,2023-03-21 23:00:00,127,255,9,16,621,496,125,5
10680,2023-03-22 00:00:00,126,286,14,14,516,403,113,6
10681,2023-03-22 01:00:00,125,258,13,11,592,438,154,10
10682,2023-03-22 02:00:00,136,287,9,19,758,629,129,12
10683,2023-03-22 03:00:00,147,292,9,11,673,477,196,8
10684,2023-03-22 04:00:00,145,275,9,13,551,405,146,9
10685,2023-03-22 05:00:00,127,283,12,11,798,666,132,13
10686,2023-03-22 06:00:00,124,299,8,16,680,555,125,6
10687,2023-03-22 07:00:00,142,255,9,12,637,493,144,10
10688,2023-03-22 08:00:00,147,251,13,11,575,421,154,9
10689,2023-03-22 09:00:00,126,291,5,18,749,554,195,11
10690,2023-03-22 10:00:00,144,281,8,12,541,464,77,5
10691,2023-03-22 11:00:00,120,265,7,10,680,539,141,5
10692,2023-03-22 12:00:00,121,266,6,17,592,492,100,9
10693,2023-03-22 13:00:00,123,275,14,10,682,588,94,6
10694,2023-03-22 14:00:00,127,271,14,12,583,484,99,8
10695,2023-03-22 15:00:00,120,283,6,19,706,570,136,10
10696,2023-03-22 16:00:00,144,298,10,16,633,465,168,6
10697,2023-03-22 17:00:00,125,254,9,18,634,544,90,5
10698,2023-03-22 18:00:00,137,283,8,18,741,650,91,10
10699,2023-03-22 19:00:00,135,255,11,17,641,568,73,13
10700,2023-03-22 20:00:00,148,296,11,19,616,554,62,12
10701,2023-03-22 21:00:00,138,260,9,16,613,505,108,5
10702,2023-03-22 22:00:00,147,254,11,19,712,593,119,11
10703,2023-03-22 23:00:00,148,258,14,10,771,556,215,12
10704,2023-03-23 00:00:00,133,294,10,12,639,542,97,6
10705,2023-03-23 01:00:00,132,276,10,14,534,444,90,9
10706,2023-03-23 02:00:00,134,269,6,16,792,636,156,11
10707,2023-03-23 03:00:00,128,276,11,14,711,521,190,5
10708,2023-03-23 04:00:00,145,262,9,16,539,465,74,8
10709,2023-03-23 05:00:00,131,265,6,11,706,525,181,5
10710,2023-03-23 06:00:00,124,294,12,13,622,543,79,13
10711,2023-03-23 07:00:00,124,257,6,19,612,500,112,12
10712,2023-03-23 08:00:00,144,283,10,11,701,597,104,5
10713,2023-03-23 09:00:00,130,297,7,16,652,585,67,7
10714,2023-03-23 10:00:00,145,253,7,14,716,527,189,7
10715,2023-03-23 11:00:00,127,283,6,14,658,571,87,7
10716,2023-03-23 12:00:00,124,275,13,18,744,540,204,8
10717,2023-03-23 13:00:00,124,269,6,11,782,549,233,12
10718,2023-03-23 14:00:00,131,251,10,12,746,553,193,8
10719,2023-03-23 15:00:00,134,286,5,16,654,490,164,13
10720,2023-03-23 16:00:00,139,277,5,15,638,546,92,13
10721,2023-03-23 17:00:00,133,262,9,12,581,420,161,12
10722,2023-03-23 18:00:00,127,295,9,12,777,681,96,8
10723,2023-03-23 19:00:00,128,252,12,17,639,539,100,11
10724,2023-03-23 20:00:00,142,282,8,15,788,687,101,8
10725,2023-03-23 21:00:00,133,280,12,12,739,641,98,13
10726,2023-03-23 22:00:00,125,292,9,17,700,576,124,6
10727,2023-03-23 23:00:00,138,272,11,10,742,582,160,10
10728,2023-03-24 00:00:00,133,259,12,12,753,595,158,10
10729,2023-03-24 01:00:00,143,252,10,11,609,498,111,8
10730,2023-03-24 02:00:00,123,276,7,19,781,652,129,9
10731,2023-03-24 03:00:00,142,288,13,13,674,485,189,14
10732,2023-03-24 04:00:00,126,287,11,17,750,666,84,14
10733,2023-03-24 05:00:00,121,278,12,12,697,613,84,11
10734,2023-03-24 06:00:00,132,274,11,10,609,545,64,11
10735,2023-03-24 07:00:00,122,251,13,10,596,482,114,9
10736,2023-03-24 08:00:00,139,282,14,16,568,430,138,10
10737,2023-03-24 09:00:00,145,269,10,13,727,623,104,5
10738,2023-03-24 10:00:00,136,288,14,16,587,451,136,10
10739,2023-03-24 11:00:00,144,264,11,17,563,434,129,10
10740,2023-03-24 12:00:00,149,275,11,18,516,366,150,8
10741,2023-03-24 13:00:00,133,289,13,16,710,620,90,13
10742,2023-03-24 14:00:00,144,272,11,19,685,575,110,8
10743,2023-03-24 15:00:00,138,294,11,13,659,581,78,12
10744,2023-03-24 16:00:00,137,260,11,19,766,561,205,6
10745,2023-03-24 17:00:00,122,268,9,17,642,468,174,6
10746,2023-03-24 18:00:00,144,297,6,15,525,435,90,12
10747,2023-03-24 19:00:00,141,255,10,19,507,367,140,6
10748,2023-03-24 20:00:00,122,271,14,18,594,468,126,7
10749,2023-03-24 21:00:00,129,264,10,13,653,507,146,11
10750,2023-03-24 22:00:00,129,276,10,18,613,549,64,10
10751,2023-03-24 23:00:00,137,294,6,16,707,528,179,12
10752,2023-03-25 00:00:00,134,275,8,16,799,717,82,12
10753,2023-03-25 01:00:00,123,264,5,19,615,482,133,8
10754,2023-03-25 02:00:00,146,280,6,11,647,573,74,9
10755,2023-03-25 03:00:00,120,285,13,17,705,617,88,5
10756,2023-03-25 04:00:00,128,251,5,17,670,589,81,14
10757,2023-03-25 05:00:00,134,255,5,17,712,604,108,12
10758,2023-03-25 06:00:00,136,252,12,10,516,428,88,5
10759,2023-03-25 07:00:00,143,273,11,11,573,491,82,6
10760,2023-03-25 08:00:00,131,278,11,15,510,386,124,12
10761,2023-03-25 09:00:00,122,258,12,19,780,563,217,8
10762,2023-03-25 10:00:00,131,291,12,16,763,597,166,11
10763,2023-03-25 11:00:00,133,286,5,14,576,436,140,5
10764,2023-03-25 12:00:00,124,285,9,12,651,457,194,10
10765,2023-03-25 13:00:00,138,278,11,19,678,506,172,8
10766,2023-03-25 14:00:00,144,293,14,16,768,632,136,13
10767,2023-03-25 15:00:00,144,260,6,18,657,515,142,8
10768,2023-03-25 16:00:00,143,296,7,12,557,437,120,6
10769,2023-03-25 17:00:00,135,283,11,12,647,520,127,6
10770,2023-03-25 18:00:00,148,278,8,19,718,515,203,7
10771,2023-03-25 19:00:00,143,297,7,15,566,402,164,14
10772,2023-03-25 20:00:00,129,289,14,10,643,557,86,13
10773,2023-03-25 21:00:00,147,259,10,11,730,567,163,10
10774,2023-03-25 22:00:00,133,277,8,12,611,508,103,5
10775,2023-03-25 23:00:00,133,281,13,13,582,477,105,6
10776,2023-03-26 00:00:00,133,296,11,18,597,427,170,8
10777,2023-03-26 01:00:00,121,288,9,17,757,629,128,11
10778,2023-03-26 02:00:00,135,251,6,15,631,442,189,8
10779,2023-03-26 03:00:00,143,294,12,15,672,574,98,5
10780,2023-03-26 04:00:00,123,294,13,17,643,498,145,12
10781,2023-03-26 05:00:00,144,291,5,15,741,591,150,9
10782,2023-03-26 06:00:00,146,289,10,10,646,481,165,13
10783,2023-03-26 07:00:00,133,252,10,12,670,529,141,12
10784,2023-03-26 08:00:00,134,263,6,16,675,530,145,9
10785,2023-03-26 09:00:00,124,263,13,16,625,492,133,6
10786,2023-03-26 10:00:00,137,287,9,15,671,507,164,10
10787,2023-03-26 11:00:00,132,283,12,15,600,488,112,5
10788,2023-03-26 12:00:00,142,271,8,14,700,530,170,13
10789,2023-03-26 13:00:00,147,291,11,18,703,594,109,13
10790,2023-03-26 14:00:00,144,281,10,18,688,484,204,7
10791,2023-03-26 15:00:00,133,251,6,13,756,667,89,12
10792,2023-03-26 16:00:00,139,269,14,15,536,382,154,8
10793,2023-03-26 17:00:00,135,273,11,13,549,481,68,5
10794,2023-03-26 18:00:00,139,269,10,10,574,506,68,5
10795,2023-03-26 19:00:00,147,257,8,15,744,637,107,14
10796,2023-03-26 20:00:00,138,277,9,12,756,543,213,9
10797,2023-03-26 21:00:00,148,296,12,19,614,498,116,12
10798,2023-03-26 22:00:00,120,257,6,18,670,555,115,6
10799,2023-03-26 23:00:00,128,265,13,18,671,600,71,5
10800,2023-03-27 00:00:00,127,273,6,13,676,497,179,12
10801,2023-03-27 01:00:00,123,270,7,11,573,514,59,5
10802,2023-03-27 02:00:00,130,253,5,19,608,537,71,8
10803,2023-03-27 03:00:00,149,297,14,10,699,587,112,7
10804,2023-03-27 04:00:00,133,254,14,12,576,448,128,7
10805,2023-03-27 05:00:00,148,290,12,15,657,553,104,11
10806,2023-03-27 06:00:00,124,274,6,17,750,542,208,9
10807,2023-03-27 07:00:00,145,294,7,17,769,603,166,13
10808,2023-03-27 08:00:00,124,283,9,12,728,596,132,11
10809,2023-03-27 09:00:00,136,263,5,19,788,647,141,11
10810,2023-03-27 10:00:00,122,254,12,17,666,488,178,7
10811,2023-03-27 11:00:00,135,282,9,14,767,682,85,14
10812,2023-03-27 12:00:00,129,271,8,17,630,498,132,12
10813,2023-03-27 13:00:00,139,259,11,12,665,593,72,10
10814,2023-03-27 14:00:00,141,260,8,10,613,513,100,7
10815,2023-03-27 15:00:00,148,266,5,18,654,587,67,5
10816,2023-03-27 16:00:00,133,260,9,19,500,442,58,6
10817,2023-03-27 17:00:00,143,292,7,17,720,567,153,8
10818,2023-03-27 18:00:00,124,256,14,13,689,498,191,13
10819,2023-03-27 19:00:00,146,275,7,10,706,546,160,5
10820,2023-03-27 20:00:00,122,261,8,17,700,492,208,12
10821,2023-03-27 21:00:00,132,278,6,14,506,396,110,10
10822,2023-03-27 22:00:00,132,269,5,16,613,510,103,12
10823,2023-03-27 23:00:00,149,299,11,12,614,529,85,8
10824,2023-03-28 00:00:00,140,271,9,19,685,584,101,12
10825,2023-03-28 01:00:00,137,252,8,13,549,402,147,8
10826,2023-03-28 02:00:00,143,296,6,13,706,569,137,9
10827,2023-03-28 03:00:00,133,277,6,19,543,442,101,11
10828,2023-03-28 04:00:00,136,292,14,14,746,670,76,10
10829,2023-03-28 05:00:00,136,262,7,17,522,379,143,8
10830,2023-03-28 06:00:00,124,285,14,12,699,521,178,12
10831,2023-03-28 07:00:00,139,268,10,10,550,389,161,13
10832,2023-03-28 08:00:00,123,281,10,11,734,550,184,12
10833,2023-03-28 09:00:00,144,287,12,16,614,549,65,11
10834,2023-03-28 10:00:00,132,273,11,14,700,585,115,13
10835,2023-03-28 11:00:00,133,264,5,11,626,463,163,12
10836,2023-03-28 12:00:00,139,280,10,12,564,458,106,8
10837,2023-03-28 13:00:00,137,277,6,11,684,525,159,11
10838,2023-03-28 14:00:00,131,282,9,19,748,637,111,10
10839,2023-03-28 15:00:00,147,263,6,13,708,514,194,10
10840,2023-03-28 16:00:00,133,276,10,14,546,384,162,11
10841,2023-03-28 17:00:00,144,271,6,19,546,386,160,9
10842,2023-03-28 18:00:00,135,294,9,16,729,525,204,11
10843,2023-03-28 19:00:00,124,257,9,17,761,648,113,8
10844,2023-03-28 20:00:00,144,272,8,12,668,545,123,12
10845,2023-03-28 21:00:00,149,271,12,16,533,386,147,6
10846,2023-03-28 22:00:00,128,265,14,15,668,559,109,6
10847,2023-03-28 23:00:00,134,266,6,12,708,532,176,14
10848,2023-03-29 00:00:00,133,284,7,14,746,616,130,12
10849,2023-03-29 01:00:00,149,256,8,12,713,512,201,8
10850,2023-03-29 02:00:00,125,279,5,16,563,494,69,13
10851,2023-03-29 03:00:00,130,282,7,19,659,462,197,12
10852,2023-03-29 04:00:00,137,265,13,15,709,573,136,11
10853,2023-03-29 05:00:00,124,297,9,14,757,623,134,9
10854,2023-03-29 06:00:00,126,252,12,19,743,638,105,8
10855,2023-03-29 07:00:00,143,258,6,13,741,647,94,9
10856,2023-03-29 08:00:00,137,284,5,16,682,543,139,13
10857,2023-03-29 09:00:00,133,282,6,11,577,446,131,6
10858,2023-03-29 10:00:00,142,292,8,13,634,465,169,11
10859,2023-03-29 11:00:00,147,282,11,17,610,461,149,12
10860,2023-03-29 12:00:00,130,267,12,13,794,646,148,11
10861,2023-03-29 13:00:00,135,295,11,16,599,526,73,7
10862,2023-03-29 14:00:00,140,282,7,15,628,530,98,6
10863,2023-03-29 15:00:00,143,289,14,18,511,449,62,11
10864,2023-03-29 16:00:00,121,280,13,12,576,477,99,12
10865,2023-03-29 17:00:00,133,297,10,14,730,576,154,11
10866,2023-03-29 18:00:00,123,279,10,12,655,568,87,5
10867,2023-03-29 19:00:00,130,279,9,11,531,403,128,9
10868,2023-03-29 20:00:00,141,295,10,17,596,518,78,12
10869,2023-03-29 21:00:00,146,278,11,16,527,416,111,13
10870,2023-03-29 22:00:00,149,278,10,12,513,367,146,7
10871,2023-03-29 23:00:00,127,291,11,11,559,436,123,13
10872,2023-03-30 00:00:00,146,277,11,17,570,400,170,13
10873,2023-03-30 01:00:00,129,271,14,14,748,629,119,5
10874,2023-03-30 02:00:00,126,256,6,13,742,626,116,10
10875,2023-03-30 03:00:00,128,283,12,19,520,403,117,7
10876,2023-03-30 04:00:00,122,275,14,18,711,582,129,11
10877,2023-03-30 05:00:00,137,298,7,14,736,646,90,14
10878,2023-03-30 06:00:00,148,271,12,11,696,539,157,9
10879,2023-03-30 07:00:00,122,256,5,18,668,495,173,14
10880,2023-03-30 08:00:00,127,274,6,13,708,580,128,10
10881,2023-03-30 09:00:00,138,282,9,18,501,431,70,9
10882,2023-03-30 10:00:00,144,259,10,10,766,654,112,7
10883,2023-03-30 11:00:00,149,282,5,11,584,425,159,5
10884,2023-03-30 12:00:00,123,263,11,12,658,462,196,7
10885,2023-03-30 13:00:00,148,278,12,19,771,682,89,14
10886,2023-03-30 14:00:00,138,255,12,13,559,482,77,7
10887,2023-03-30 15:00:00,139,264,8,18,761,596,165,12
10888,2023-03-30 16:00:00,121,279,6,14,583,508,75,10
10889,2023-03-30 17:00:00,130,284,12,16,548,400,148,8
10890,2023-03-30 18:00:00,126,290,11,17,736,538,198,5
10891,2023-03-30 19:00:00,140,294,8,10,502,450,52,5
10892,2023-03-30 20:00:00,120,283,13,17,633,494,139,5
10893,2023-03-30 21:00:00,128,269,11,17,666,520,146,5
10894,2023-03-30 22:00:00,133,286,6,11,634,538,96,6
10895,2023-03-30 23:00:00,138,274,13,13,780,620,160,10
10896,2023-03-31 00:00:00,141,298,14,10,637,523,114,10
10897,2023-03-31 01:00:00,137,251,13,15,719,575,144,14
10898,2023-03-31 02:00:00,131,256,8,16,603,540,63,14
10899,2023-03-31 03:00:00,148,293,6,16,625,528,97,14
10900,2023-03-31 04:00:00,137,252,14,11,546,395,151,6
10901,2023-03-31 05:00:00,123,270,14,14,686,548,138,8
10902,2023-03-31 06:00:00,133,268,11,17,702,605,97,10
10903,2023-03-31 07:00:00,140,275,10,15,508,413,95,7
10904,2023-03-31 08:00:00,127,289,13,19,571,463,108,6
10905,2023-03-31 09:00:00,133,254,9,17,727,583,144,7
10906,2023-03-31 10:00:00,140,294,10,14,662,534,128,6
10907,2023-03-31 11:00:00,136,264,9,16,680,557,123,11
10908,2023-03-31 12:00:00,132,276,14,12,667,491,176,8
10909,2023-03-31 13:00:00,121,261,12,19,627,494,133,14
10910,2023-03-31 14:00:00,142,274,13,13,610,468,142,10
10911,2023-03-31 15:00:00,121,285,13,12,515,435,80,5
10912,2023-03-31 16:00:00,149,280,9,17,516,428,88,9
10913,2023-03-31 17:00:00,121,285,10,18,698,540,158,12
10914,2023-03-31 18:00:00,139,250,6,17,594,459,135,5
10915,2023-03-31 19:00:00,125,258,8,13,624,544,80,14
10916,2023-03-31 20:00:00,126,255,6,19,621,441,180,6
10917,2023-03-31 21:00:00,141,269,13,13,647,496,151,11
10918,2023-03-31 22:00:00,126,257,12,17,783,551,232,10
10919,2023-03-31 23:00:00,136,263,9,11,682,588,94,8
10920,2023-04-01 00:00:00,129,282,13,13,737,624,113,7
10921,2023-04-01 01:00:00,133,292,9,13,615,457,158,5
10922,2023-04-01 02:00:00,145,275,11,11,518,384,134,9
10923,2023-04-01 03:00:00,143,287,14,10,726,523,203,11
10924,2023-04-01 04:00:00,131,286,6,11,629,481,148,14
10925,2023-04-01 05:00:00,141,258,14,19,660,509,151,10
10926,2023-04-01 06:00:00,148,299,10,17,550,414,136,14
10927,2023-04-01 07:00:00,143,269,5,17,790,686,104,6
10928,2023-04-01 08:00:00,145,289,9,14,746,632,114,12
10929,2023-04-01 09:00:00,122,278,7,18,785,642,143,14
10930,2023-04-01 10:00:00,149,281,12,13,745,635,110,13
10931,2023-04-01 11:00:00,126,281,7,10,586,501,85,14
10932,2023-04-01 12:00:00,143,255,11,14,568,494,74,10
10933,2023-04-01 13:00:00,141,264,13,14,660,510,150,11
10934,2023-04-01 14:00:00,135,297,14,18,780,695,85,13
10935,2023-04-01 15:00:00,121,261,12,18,559,445,114,6
10936,2023-04-01 16:00:00,144,274,11,14,571,480,91,12
10937,2023-04-01 17:00:00,133,281,6,11,749,654,95,5
10938,2023-04-01 18:00:00,146,298,6,18,614,436,178,9
10939,2023-04-01 19:00:00,126,281,6,19,578,472,106,10
10940,2023-04-01 20:00:00,132,255,7,15,743,614,129,10
10941,2023-04-01 21:00:00,139,272,9,15,668,502,166,13
10942,2023-04-01 22:00:00,120,260,9,11,646,481,165,6
10943,2023-04-01 23:00:00,120,290,7,19,745,579,166,7
10944,2023-04-02 00:00:00,122,290,9,17,503,360,143,9
10945,2023-04-02 01:00:00,143,270,13,14,686,579,107,5
10946,2023-04-02 02:00:00,122,264,9,16,585,413,172,10
10947,2023-04-02 03:00:00,142,265,12,13,560,454,106,5
10948,2023-04-02 04:00:00,120,276,7,11,708,562,146,11
10949,2023-04-02 05:00:00,139,254,11,11,583,482,101,14
10950,2023-04-02 06:00:00,122,268,12,16,778,581,197,5
10951,2023-04-02 07:00:00,124,261,11,17,723,586,137,12
10952,2023-04-02 08:00:00,125,281,14,15,571,423,148,6
10953,2023-04-02 09:00:00,123,270,12,18,508,397,111,10
10954,2023-04-02 10:00:00,131,261,12,11,750,647,103,14
10955,2023-04-02 11:00:00,131,288,7,15,769,623,146,7
10956,2023-04-02 12:00:00,131,283,8,10,735,585,150,8
10957,2023-04-02 13:00:00,131,268,5,17,614,533,81,10
10958,2023-04-02 14:00:00,133,287,5,18,716,540,176,8
10959,2023-04-02 15:00:00,139,258,11,12,587,414,173,8
10960,2023-04-02 16:00:00,145,298,8,19,642,548,94,12
10961,2023-04-02 17:00:00,131,281,8,17,642,505,137,14
10962,2023-04-02 18:00:00,137,266,5,11,753,595,158,5
10963,2023-04-02 19:00:00,146,254,14,16,572,440,132,8
10964,2023-04-02 20:00:00,138,270,13,15,558,408,150,10
10965,2023-04-02 21:00:00,144,299,13,11,754,640,114,14
10966,2023-04-02 22:00:00,141,294,13,19,716,618,98,5
10967,2023-04-02 23:00:00,135,262,10,16,534,466,68,9
10968,2023-04-03 00:00:00,141,266,8,12,593,442,151,9
10969,2023-04-03 01:00:00,143,252,11,15,711,555,156,8
10970,2023-04-03 02:00:00,142,286,5,19,798,591,207,14
10971,2023-04-03 03:00:00,120,260,14,13,704,523,181,5
10972,2023-04-03 04:00:00,125,257,10,13,782,644,138,11
10973,2023-04-03 05:00:00,131,267,5,12,701,547,154,9
10974,2023-04-03 06:00:00,146,256,6,14,508,451,57,6
10975,2023-04-03 07:00:00,137,258,11,19,734,633,101,11
10976,2023-04-03 08:00:00,148,251,12,16,743,539,204,10
10977,2023-04-03 09:00:00,128,254,5,10,680,540,140,6
10978,2023-04-03 10:00:00,149,267,7,10,785,567,218,6
10979,2023-04-03 11:00:00,136,250,6,16,642,518,124,9
10980,2023-04-03 12:00:00,143,264,11,10,724,606,118,8
10981,2023-04-03 13:00:00,142,278,5,15,736,617,119,14
10982,2023-04-03 14:00:00,124,279,5,13,657,468,189,13
10983,2023-04-03 15:00:00,140,292,7,13,578,415,163,11
10984,2023-04-03 16:00:00,129,254,14,19,554,448,106,6
10985,2023-04-03 17:00:00,122,252,14,10,765,675,90,7
10986,2023-04-03 18:00:00,134,280,8,17,716,582,134,12
10987,2023-04-03 19:00:00,133,277,7,18,674,599,75,12
10988,2023-04-03 20:00:00,123,279,14,13,703,534,169,10
10989,2023-04-03 21:00:00,136,288,5,18,708,560,148,9
10990,2023-04-03 22:00:00,128,288,7,14,501,432,69,10
10991,2023-04-03 23:00:00,148,258,8,14,606,485,121,9
10992,2023-04-04 00:00:00,135,270,13,17,638,518,120,10
10993,2023-04-04 01:00:00,125,258,11,19,577,445,132,12
10994,2023-04-04 02:00:00,135,268,12,19,578,487,91,6
10995,2023-04-04 03:00:00,146,269,6,11,516,439,77,13
10996,2023-04-04 04:00:00,135,271,13,13,552,448,104,8
10997,2023-04-04 05:00:00,141,284,10,14,788,706,82,14
10998,2023-04-04 06:00:00,126,289,14,15,759,592,167,5
10999,2023-04-04 07:00:00,148,268,10,14,534,469,65,12
11000,2023-04-04 08:00:00,130,257,12,16,769,590,179,7
11001,2023-04-04 09:00:00,129,290,6,16,716,557,159,13
11002,2023-04-04 10:00:00,124,270,11,14,666,569,97,13
11003,2023-04-04 11:00:00,147,295,14,14,699,609,90,7
11004,2023-04-04 12:00:00,124,250,11,16,585,413,172,14
11005,2023-04-04 13:00:00,138,293,14,10,604,479,125,13
11006,2023-04-04 14:00:00,143,284,11,10,571,486,85,7
11007,2023-04-04 15:00:00,149,261,8,14,529,428,101,11
11008,2023-04-04 16:00:00,136,268,5,19,549,415,134,7
11009,2023-04-04 17:00:00,137,289,7,16,548,401,147,11
11010,2023-04-04 18:00:00,129,294,9,19,788,648,140,14
11011,2023-04-04 19:00:00,124,273,12,10,578,517,61,14
11012,2023-04-04 20:00:00,145,277,6,10,562,408,154,13
11013,2023-04-04 21:00:00,139,251,11,18,792,693,99,12
11014,2023-04-04 22:00:00,124,288,13,11,664,467,197,11
11015,2023-04-04 23:00:00,145,294,10,12,635,530,105,7
11016,2023-04-05 00:00:00,135,263,9,13,751,637,114,6
11017,2023-04-05 01:00:00,136,297,5,18,617,503,114,13
11018,2023-04-05 02:00:00,143,277,7,17,568,475,93,14
11019,2023-04-05 03:00:00,120,296,9,18,626,530,96,14
11020,2023-04-05 04:00:00,136,260,13,11,628,540,88,6
11021,2023-04-05 05:00:00,136,254,9,13,766,620,146,13
11022,2023-04-05 06:00:00,123,266,9,14,638,464,174,12
11023,2023-04-05 07:00:00,144,287,6,12,556,407,149,5
11024,2023-04-05 08:00:00,147,276,10,12,628,467,161,13
11025,2023-04-05 09:00:00,133,283,12,16,600,430,170,9
11026,2023-04-05 10:00:00,142,254,6,17,771,623,148,12
11027,2023-04-05 11:00:00,136,280,6,16,780,652,128,13
11028,2023-04-05 12:00:00,123,288,6,11,725,617,108,13
11029,2023-04-05 13:00:00,137,285,10,17,681,492,189,9
11030,2023-04-05 14:00:00,128,267,8,13,501,411,90,7
11031,2023-04-05 15:00:00,140,267,12,10,682,591,91,13
11032,2023-04-05 16:00:00,127,286,12,19,686,556,130,14
11033,2023-04-05 17:00:00,130,290,13,11,588,432,156,13
11034,2023-04-05 18:00:00,149,289,7,13,687,575,112,9
11035,2023-04-05 19:00:00,136,251,9,19,617,459,158,13
11036,2023-04-05 20:00:00,148,279,7,12,522,455,67,6
11037,2023-04-05 21:00:00,126,295,6,16,567,434,133,7
11038,2023-04-05 22:00:00,121,253,10,13,565,443,122,10
11039,2023-04-05 23:00:00,149,251,8,11,686,521,165,9
11040,2023-04-06 00:00:00,136,254,6,19,796,648,148,7
11041,2023-04-06 01:00:00,138,296,12,13,739,663,76,10
11042,2023-04-06 02:00:00,127,272,6,15,754,572,182,10
11043,2023-04-06 03:00:00,130,255,11,13,589,507,82,8
11044,2023-04-06 04:00:00,138,299,10,18,577,511,66,8
11045,2023-04-06 05:00:00,149,296,14,16,558,481,77,11
11046,2023-04-06 06:00:00,129,254,13,14,682,552,130,14
11047,2023-04-06 07:00:00,131,274,10,15,775,680,95,11
11048,2023-04-06 08:00:00,128,288,12,15,772,598,174,10
11049,2023-04-06 09:00:00,120,283,10,10,576,422,154,10
11050,2023-04-06 10:00:00,135,271,14,16,761,574,187,13
11051,2023-04-06 11:00:00,129,274,13,13,650,501,149,11
11052,2023-04-06 12:00:00,140,278,9,15,765,678,87,14
11053,2023-04-06 13:00:00,123,281,14,13,718,578,140,13
11054,2023-04-06 14:00:00,132,284,11,10,775,685,90,10
11055,2023-04-06 15:00:00,132,277,6,15,764,582,182,6
11056,2023-04-06 16:00:00,132,250,11,12,784,643,141,12
11057,2023-04-06 17:00:00,127,265,10,12,641,492,149,6
11058,2023-04-06 18:00:00,121,287,12,10,785,615,170,9
11059,2023-04-06 19:00:00,139,281,11,17,560,401,159,13
11060,2023-04-06 20:00:00,148,291,8,11,638,535,103,5
11061,2023-04-06 21:00:00,137,273,10,19,708,545,163,9
11062,2023-04-06 22:00:00,135,286,7,16,751,667,84,13
11063,2023-04-06 23:00:00,131,261,11,19,691,588,103,10
11064,2023-04-07 00:00:00,137,265,9,16,737,603,134,7
11065,2023-04-07 01:00:00,140,253,8,11,505,442,63,12
11066,2023-04-07 02:00:00,139,262,7,18,756,606,150,13
11067,2023-04-07 03:00:00,130,281,5,17,599,474,125,8
11068,2023-04-07 04:00:00,128,284,12,19,754,628,126,9
11069,2023-04-07 05:00:00,136,273,8,11,501,417,84,8
11070,2023-04-07 06:00:00,137,253,9,19,558,483,75,5
11071,2023-04-07 07:00:00,121,254,13,10,555,425,130,14
11072,2023-04-07 08:00:00,139,291,13,11,741,534,207,14
11073,2023-04-07 09:00:00,129,274,7,16,707,616,91,13
11074,2023-04-07 10:00:00,122,262,14,12,656,571,85,10
11075,2023-04-07 11:00:00,146,252,13,18,592,496,96,13
11076,2023-04-07 12:00:00,124,280,12,15,608,497,111,10
11077,2023-04-07 13:00:00,141,274,12,13,766,597,169,10
11078,2023-04-07 14:00:00,131,263,9,18,538,438,100,6
11079,2023-04-07 15:00:00,123,269,9,18,761,668,93,8
11080,2023-04-07 16:00:00,136,274,8,18,629,536,93,11
11081,2023-04-07 17:00:00,147,276,11,10,595,462,133,13
11082,2023-04-07 18:00:00,145,271,7,10,519,431,88,5
11083,2023-04-07 19:00:00,133,289,14,10,520,458,62,13
11084,2023-04-07 20:00:00,127,286,10,15,530,470,60,12
11085,2023-04-07 21:00:00,145,260,7,13,706,514,192,14
11086,2023-04-07 22:00:00,139,297,12,11,591,508,83,14
11087,2023-04-07 23:00:00,146,267,8,14,511,422,89,10
11088,2023-04-08 00:00:00,128,266,9,18,574,473,101,10
11089,2023-04-08 01:00:00,145,267,14,12,698,545,153,8
11090,2023-04-08 02:00:00,132,256,11,14,621,542,79,12
11091,2023-04-08 03:00:00,126,278,10,19,663,509,154,9
11092,2023-04-08 04:00:00,130,253,5,17,782,694,88,12
11093,2023-04-08 05:00:00,128,286,11,19,724,515,209,10
11094,2023-04-08 06:00:00,132,251,14,15,789,561,228,8
11095,2023-04-08 07:00:00,137,292,6,14,695,507,188,9
11096,2023-04-08 08:00:00,133,254,13,17,649,583,66,14
11097,2023-04-08 09:00:00,140,250,5,14,676,575,101,13
11098,2023-04-08 10:00:00,134,288,14,11,542,468,74,9
11099,2023-04-08 11:00:00,144,272,8,15,790,579,211,10
11100,2023-04-08 12:00:00,132,276,8,17,611,497,114,6
11101,2023-04-08 13:00:00,124,252,7,17,587,441,146,14
11102,2023-04-08 14:00:00,127,297,12,16,760,535,225,6
11103,2023-04-08 15:00:00,125,294,7,13,643,486,157,14
11104,2023-04-08 16:00:00,144,280,11,13,646,512,134,11
11105,2023-04-08 17:00:00,123,281,6,11,570,494,76,13
11106,2023-04-08 18:00:00,137,291,13,13,743,568,175,5
11107,2023-04-08 19:00:00,135,281,11,15,755,570,185,11
11108,2023-04-08 20:00:00,136,266,14,12,674,575,99,6
11109,2023-04-08 21:00:00,146,255,8,17,709,620,89,13
11110,2023-04-08 22:00:00,129,290,14,14,647,550,97,11
11111,2023-04-08 23:00:00,132,289,8,18,522,441,81,12
11112,2023-04-09 00:00:00,121,295,5,14,743,586,157,11
11113,2023-04-09 01:00:00,147,289,10,11,559,413,146,13
11114,2023-04-09 02:00:00,146,263,11,16,503,402,101,12
11115,2023-04-09 03:00:00,122,262,13,18,743,614,129,14
11116,2023-04-09 04:00:00,126,299,11,16,528,376,152,10
11117,2023-04-09 05:00:00,125,291,13,14,744,625,119,9
11118,2023-04-09 06:00:00,127,299,12,13,650,576,74,13
11119,2023-04-09 07:00:00,138,279,14,12,676,564,112,6
11120,2023-04-09 08:00:00,121,298,9,10,702,573,129,10
11121,2023-04-09 09:00:00,143,261,5,12,716,580,136,12
11122,2023-04-09 10:00:00,130,268,11,16,668,530,138,8
11123,2023-04-09 11:00:00,122,265,9,16,517,455,62,11
11124,2023-04-09 12:00:00,137,261,10,10,557,430,127,11
11125,2023-04-09 13:00:00,145,258,11,11,747,559,188,10
11126,2023-04-09 14:00:00,135,250,8,17,785,558,227,9
11127,2023-04-09 15:00:00,128,257,14,16,715,574,141,11
11128,2023-04-09 16:00:00,134,275,11,12,641,513,128,8
11129,2023-04-09 17:00:00,139,291,6,19,504,418,86,11
11130,2023-04-09 18:00:00,121,275,10,10,565,429,136,6
11131,2023-04-09 19:00:00,145,296,7,19,758,668,90,13
11132,2023-04-09 20:00:00,127,252,11,16,702,545,157,12
11133,2023-04-09 21:00:00,127,299,12,17,772,635,137,7
11134,2023-04-09 22:00:00,128,269,11,13,532,464,68,12
11135,2023-04-09 23:00:00,148,279,12,10,766,686,80,8
11136,2023-04-10 00:00:00,145,275,10,17,772,680,92,7
11137,2023-04-10 01:00:00,143,271,9,17,775,631,144,12
11138,2023-04-10 02:00:00,140,268,8,13,591,521,70,12
11139,2023-04-10 03:00:00,127,298,9,16,540,405,135,7
11140,2023-04-10 04:00:00,138,292,11,17,688,560,128,9
11141,2023-04-10 05:00:00,121,269,6,13,785,688,97,9
11142,2023-04-10 06:00:00,139,293,14,14,729,646,83,8
11143,2023-04-10 07:00:00,121,278,9,10,781,554,227,5
11144,2023-04-10 08:00:00,121,284,14,18,507,399,108,5
11145,2023-04-10 09:00:00,131,295,7,14,681,610,71,5
11146,2023-04-10 10:00:00,136,263,9,19,544,431,113,8
11147,2023-04-10 11:00:00,149,281,5,17,536,471,65,8
11148,2023-04-10 12:00:00,123,263,9,12,544,386,158,14
11149,2023-04-10 13:00:00,133,270,13,17,557,485,72,12
11150,2023-04-10 14:00:00,134,253,8,17,786,598,188,9
11151,2023-04-10 15:00:00,129,289,14,14,707,599,108,11
11152,2023-04-10 16:00:00,132,294,12,11,510,372,138,13
11153,2023-04-10 17:00:00,147,272,8,11,730,564,166,11
11154,2023-04-10 18:00:00,131,265,5,19,635,489,146,8
11155,2023-04-10 19:00:00,125,291,7,17,738,625,113,11
11156,2023-04-10 20:00:00,129,294,8,17,646,495,151,5
11157,2023-04-10 21:00:00,126,296,11,18,702,513,189,13
11158,2023-04-10 22:00:00,129,299,10,15,738,561,177,11
11159,2023-04-10 23:00:00,145,251,11,16,663,528,135,6
11160,2023-04-11 00:00:00,133,250,9,19,529,390,139,5
11161,2023-04-11 01:00:00,146,298,12,11,660,494,166,5
11162,2023-04-11 02:00:00,123,272,8,11,787,572,215,9
11163,2023-04-11 03:00:00,141,275,14,13,624,533,91,14
11164,2023-04-11 04:00:00,148,291,6,17,746,653,93,9
11165,2023-04-11 05:00:00,136,282,12,14,746,541,205,10
11166,2023-04-11 06:00:00,130,259,9,10,706,506,200,13
11167,2023-04-11 07:00:00,139,287,13,11,764,604,160,13
11168,2023-04-11 08:00:00,127,290,6,10,613,468,145,10
11169,2023-04-11 09:00:00,134,287,10,14,728,577,151,8
11170,2023-04-11 10:00:00,121,272,13,14,546,407,139,14
11171,2023-04-11 11:00:00,145,267,5,13,720,568,152,6
11172,2023-04-11 12:00:00,121,296,5,16,669,487,182,11
11173,2023-04-11 13:00:00,127,283,7,12,716,573,143,13
11174,2023-04-11 14:00:00,148,299,11,11,513,443,70,12
11175,2023-04-11 15:00:00,131,295,6,14,648,491,157,12
11176,2023-04-11 16:00:00,131,275,7,17,764,656,108,11
11177,2023-04-11 17:00:00,128,282,13,17,721,581,140,6
11178,2023-04-11 18:00:00,127,275,6,15,799,666,133,8
11179,2023-04-11 19:00:00,132,280,7,16,798,597,201,7
11180,2023-04-11 20:00:00,145,266,5,12,700,539,161,11
11181,2023-04-11 21:00:00,129,288,12,18,758,619,139,6
11182,2023-04-11 22:00:00,133,286,7,12,589,412,177,8
11183,2023-04-11 23:00:00,146,264,10,15,519,390,129,14
11184,2023-04-12 00:00:00,125,270,9,13,505,429,76,5
11185,2023-04-12 01:00:00,127,260,14,17,696,535,161,6
11186,2023-04-12 02:00:00,123,277,7,17,731,615,116,12
11187,2023-04-12 03:00:00,149,253,11,19,796,714,82,5
11188,2023-04-12 04:00:00,121,286,9,10,623,519,104,14
11189,2023-04-12 05:00:00,149,252,9,13,752,539,213,13
11190,2023-04-12 06:00:00,146,298,14,10,702,508,194,8
11191,2023-04-12 07:00:00,121,276,8,16,612,444,168,11
11192,2023-04-12 08:00:00,146,252,14,11,634,462,172,5
11193,2023-04-12 09:00:00,147,272,8,19,755,576,179,5
11194,2023-04-12 10:00:00,137,287,7,10,763,542,221,12
11195,2023-04-12 11:00:00,139,284,7,15,654,467,187,11
11196,2023-04-12 12:00:00,136,268,13,13,726,598,128,12
11197,2023-04-12 13:00:00,141,297,5,14,788,571,217,13
11198,2023-04-12 14:00:00,120,292,5,11,563,401,162,9
11199,2023-04-12 15:00:00,123,281,14,19,646,527,119,14
11200,2023-04-12 16:00:00,136,262,6,14,550,417,133,10
11201,2023-04-12 17:00:00,126,256,12,19,782,578,204,14
11202,2023-04-12 18:00:00,138,268,14,19,737,567,170,9
11203,2023-04-12 19:00:00,121,284,9,11,700,500,200,12
11204,2023-04-12 20:00:00,140,256,13,10,756,604,152,6
11205,2023-04-12 21:00:00,124,268,12,16,545,396,149,12
11206,2023-04-12 22:00:00,148,285,14,16,616,534,82,12
11207,2023-04-12 23:00:00,128,266,7,16,709,551,158,10
11208,2023-04-13 00:00:00,149,266,13,12,625,448,177,9
11209,2023-04-13 01:00:00,145,285,9,15,733,532,201,10
11210,2023-04-13 02:00:00,134,287,14,13,796,658,138,12
11211,2023-04-13 03:00:00,139,272,8,13,544,473,71,7
11212,2023-04-13 04:00:00,147,299,13,15,731,557,174,10
11213,2023-04-13 05:00:00,147,250,13,10,727,648,79,6
11214,2023-04-13 06:00:00,127,270,13,16,708,628,80,14
11215,2023-04-13 07:00:00,120,256,5,11,614,502,112,13
11216,2023-04-13 08:00:00,140,282,7,18,763,590,173,12
11217,2023-04-13 09:00:00,123,278,5,17,645,519,126,12
11218,2023-04-13 10:00:00,136,290,5,12,610,470,140,6
11219,2023-04-13 11:00:00,125,257,14,18,760,633,127,7
11220,2023-04-13 12:00:00,145,286,12,10,588,518,70,10
11221,2023-04-13 13:00:00,132,267,11,19,593,457,136,14
11222,2023-04-13 14:00:00,134,285,5,15,755,541,214,12
11223,2023-04-13 15:00:00,146,293,12,15,633,485,148,11
11224,2023-04-13 16:00:00,149,259,9,18,760,659,101,12
11225,2023-04-13 17:00:00,137,278,5,15,664,491,173,7
11226,2023-04-13 18:00:00,133,257,11,14,541,423,118,6
11227,2023-04-13 19:00:00,140,257,12,13,653,473,180,14
11228,2023-04-13 20:00:00,122,269,10,17,523,464,59,13
11229,2023-04-13 21:00:00,135,287,10,15,784,692,92,8
11230,2023-04-13 22:00:00,128,298,12,13,588,430,158,6
11231,2023-04-13 23:00:00,130,296,11,10,760,598,162,11
11232,2023-04-14 00:00:00,136,250,9,14,774,627,147,6
11233,2023-04-14 01:00:00,138,265,9,12,744,641,103,14
11234,2023-04-14 02:00:00,125,286,11,17,747,645,102,5
11235,2023-04-14 03:00:00,142,292,6,16,513,396,117,7
11236,2023-04-14 04:00:00,146,264,8,15,754,592,162,9
11237,2023-04-14 05:00:00,130,296,13,11,784,550,234,13
11238,2023-04-14 06:00:00,127,284,12,10,578,496,82,10
11239,2023-04-14 07:00:00,139,281,12,16,724,622,102,5
11240,2023-04-14 08:00:00,138,265,6,10,756,634,122,7
11241,2023-04-14 09:00:00,132,295,13,11,511,366,145,10
11242,2023-04-14 10:00:00,130,296,6,16,641,568,73,10
11243,2023-04-14 11:00:00,141,255,7,14,667,476,191,10
11244,2023-04-14 12:00:00,133,269,6,12,783,685,98,9
11245,2023-04-14 13:00:00,129,267,5,14,736,646,90,10
11246,2023-04-14 14:00:00,123,289,5,18,504,402,102,11
11247,2023-04-14 15:00:00,147,262,5,18,796,568,228,12
11248,2023-04-14 16:00:00,142,255,13,15,537,458,79,5
11249,2023-04-14 17:00:00,127,288,8,19,737,588,149,6
11250,2023-04-14 18:00:00,136,273,7,11,793,639,154,11
11251,2023-04-14 19:00:00,126,256,7,16,553,405,148,13
11252,2023-04-14 20:00:00,138,264,8,18,588,440,148,9
11253,2023-04-14 21:00:00,148,278,6,13,506,376,130,8
11254,2023-04-14 22:00:00,148,275,8,10,670,508,162,10
11255,2023-04-14 23:00:00,128,292,7,17,514,426,88,12
11256,2023-04-15 00:00:00,127,281,13,19,746,544,202,6
11257,2023-04-15 01:00:00,123,252,13,12,686,494,192,6
11258,2023-04-15 02:00:00,136,250,7,10,615,531,84,6
11259,2023-04-15 03:00:00,130,266,12,13,529,379,150,11
11260,2023-04-15 04:00:00,136,259,9,10,591,479,112,7
11261,2023-04-15 05:00:00,126,260,10,15,575,462,113,9
11262,2023-04-15 06:00:00,132,286,13,10,726,627,99,5
11263,2023-04-15 07:00:00,149,297,10,15,605,425,180,14
11264,2023-04-15 08:00:00,139,294,5,18,546,398,148,8
11265,2023-04-15 09:00:00,135,270,13,15,701,606,95,11
11266,2023-04-15 10:00:00,135,291,11,12,715,567,148,14
11267,2023-04-15 11:00:00,147,264,7,13,515,379,136,8
11268,2023-04-15 12:00:00,143,275,12,12,524,430,94,6
11269,2023-04-15 13:00:00,129,258,10,12,730,615,115,14
11270,2023-04-15 14:00:00,124,272,5,13,512,457,55,7
11271,2023-04-15 15:00:00,122,254,13,15,696,624,72,7
11272,2023-04-15 16:00:00,126,276,9,13,634,549,85,6
11273,2023-04-15 17:00:00,138,257,11,18,606,483,123,12
11274,2023-04-15 18:00:00,144,290,12,14,651,549,102,7
11275,2023-04-15 19:00:00,125,293,14,13,522,371,151,10
11276,2023-04-15 20:00:00,132,287,11,13,556,394,162,8
11277,2023-04-15 21:00:00,125,271,11,16,586,465,121,8
11278,2023-04-15 22:00:00,123,286,10,17,666,466,200,8
11279,2023-04-15 23:00:00,144,290,14,17,787,665,122,14
11280,2023-04-16 00:00:00,147,274,9,16,799,627,172,9
11281,2023-04-16 01:00:00,121,293,8,18,693,531,162,14
11282,2023-04-16 02:00:00,139,272,13,19,592,494,98,11
11283,2023-04-16 03:00:00,124,280,9,19,630,489,141,5
11284,2023-04-16 04:00:00,125,287,5,14,538,424,114,5
11285,2023-04-16 05:00:00,128,299,7,11,552,430,122,5
11286,2023-04-16 06:00:00,128,274,5,16,529,454,75,5
11287,2023-04-16 07:00:00,142,294,12,10,696,514,182,6
11288,2023-04-16 08:00:00,125,280,11,15,670,538,132,9
11289,2023-04-16 09:00:00,131,277,12,15,693,608,85,8
11290,2023-04-16 10:00:00,132,255,13,15,707,537,170,5
11291,2023-04-16 11:00:00,133,283,7,19,656,477,179,5
11292,2023-04-16 12:00:00,147,289,8,19,621,528,93,7
11293,2023-04-16 13:00:00,148,268,7,12,796,634,162,7
11294,2023-04-16 14:00:00,140,296,7,18,664,593,71,6
11295,2023-04-16 15:00:00,125,277,13,16,504,418,86,8
11296,2023-04-16 16:00:00,147,275,13,13,770,634,136,13
11297,2023-04-16 17:00:00,132,265,14,11,633,467,166,11
11298,2023-04-16 18:00:00,133,251,8,10,784,636,148,8
11299,2023-04-16 19:00:00,124,296,12,12,746,593,153,10
11300,2023-04-16 20:00:00,149,283,5,11,761,615,146,14
11301,2023-04-16 21:00:00,144,255,11,15,739,637,102,10
11302,2023-04-16 22:00:00,133,252,13,14,506,377,129,8
11303,2023-04-16 23:00:00,138,250,13,15,693,531,162,10
11304,2023-04-17 00:00:00,143,281,12,10,714,521,193,11
11305,2023-04-17 01:00:00,135,274,13,16,744,565,179,10
11306,2023-04-17 02:00:00,131,251,9,19,628,531,97,6
11307,2023-04-17 03:00:00,142,296,7,19,589,430,159,7
11308,2023-04-17 04:00:00,144,263,11,12,658,508,150,14
11309,2023-04-17 05:00:00,130,266,9,11,723,608,115,6
11310,2023-04-17 06:00:00,129,261,7,19,561,412,149,11
11311,2023-04-17 07:00:00,124,292,6,15,687,507,180,13
11312,2023-04-17 08:00:00,145,281,7,13,743,572,171,11
11313,2023-04-17 09:00:00,129,262,12,11,654,520,134,9
11314,2023-04-17 10:00:00,128,263,8,14,672,526,146,9
11315,2023-04-17 11:00:00,145,274,13,11,676,556,120,14
11316,2023-04-17 12:00:00,137,281,14,16,713,503,210,11
11317,2023-04-17 13:00:00,131,281,5,17,672,530,142,9
11318,2023-04-17 14:00:00,122,257,11,17,569,485,84,9
11319,2023-04-17 15:00:00,135,277,11,13,582,417,165,10
11320,2023-04-17 16:00:00,144,269,11,18,796,564,232,8
11321,2023-04-17 17:00:00,148,271,14,15,623,521,102,10
11322,2023-04-17 18:00:00,125,279,6,13,709,545,164,13
11323,2023-04-17 19:00:00,139,269,12,11,569,461,108,14
11324,2023-04-17 20:00:00,147,277,11,12,706,551,155,13
11325,2023-04-17 21:00:00,147,293,10,14,708,635,73,7
11326,2023-04-17 22:00:00,142,275,10,17,751,550,201,14
11327,2023-04-17 23:00:00,142,291,5,19,526,463,63,6
11328,2023-04-18 00:00:00,140,289,13,17,706,501,205,10
11329,2023-04-18 01:00:00,145,256,11,18,519,364,155,12
11330,2023-04-18 02:00:00,147,282,7,18,665,495,170,10
11331,2023-04-18 03:00:00,126,282,13,12,520,367,153,13
11332,2023-04-18 04:00:00,149,287,11,12,513,440,73,14
11333,2023-04-18 05:00:00,141,271,13,18,521,367,154,13
11334,2023-04-18 06:00:00,146,294,6,10,556,465,91,13
11335,2023-04-18 07:00:00,132,261,8,16,677,520,157,7
11336,2023-04-18 08:00:00,125,297,14,17,761,657,104,5
11337,2023-04-18 09:00:00,124,297,12,19,514,441,73,13
11338,2023-04-18 10:00:00,121,263,11,13,557,484,73,5
11339,2023-04-18 11:00:00,130,256,14,16,575,443,132,6
11340,2023-04-18 12:00:00,129,261,10,19,634,526,108,7
11341,2023-04-18 13:00:00,145,288,10,15,638,494,144,14
11342,2023-04-18 14:00:00,134,261,12,19,790,589,201,11
11343,2023-04-18 15:00:00,149,293,13,12,612,471,141,9
11344,2023-04-18 16:00:00,136,271,5,10,574,405,169,5
11345,2023-04-18 17:00:00,148,259,7,15,545,415,130,10
11346,2023-04-18 18:00:00,121,290,10,14,594,532,62,11
11347,2023-04-18 19:00:00,124,261,8,19,742,642,100,10
11348,2023-04-18 20:00:00,144,273,8,10,666,506,160,9
11349,2023-04-18 21:00:00,135,299,14,11,730,633,97,10
11350,2023-04-18 22:00:00,141,287,10,17,725,586,139,12
11351,2023-04-18 23:00:00,147,275,6,16,604,512,92,5
11352,2023-04-19 00:00:00,140,252,6,14,547,490,57,9
11353,2023-04-19 01:00:00,148,281,8,19,736,595,141,6
11354,2023-04-19 02:00:00,137,259,6,17,663,520,143,12
11355,2023-04-19 03:00:00,131,296,13,10,620,549,71,13
11356,2023-04-19 04:00:00,132,275,7,12,575,432,143,13
11357,2023-04-19 05:00:00,138,289,10,11,770,666,104,9
11358,2023-04-19 06:00:00,127,277,6,11,514,445,69,5
11359,2023-04-19 07:00:00,129,284,14,16,538,480,58,9
11360,2023-04-19 08:00:00,147,274,12,11,758,565,193,11
11361,2023-04-19 09:00:00,147,282,8,19,556,409,147,10
11362,2023-04-19 10:00:00,141,263,6,10,510,392,118,6
11363,2023-04-19 11:00:00,141,269,7,11,603,493,110,10
11364,2023-04-19 12:00:00,128,274,6,17,595,444,151,6
11365,2023-04-19 13:00:00,130,292,5,13,678,529,149,12
11366,2023-04-19 14:00:00,131,282,5,15,757,628,129,7
11367,2023-04-19 15:00:00,130,257,10,14,690,490,200,11
11368,2023-04-19 16:00:00,136,263,12,18,542,486,56,14
11369,2023-04-19 17:00:00,128,289,5,13,771,642,129,11
11370,2023-04-19 18:00:00,146,299,9,15,780,584,196,6
11371,2023-04-19 19:00:00,131,286,10,10,527,447,80,6
11372,2023-04-19 20:00:00,138,274,9,11,503,378,125,9
11373,2023-04-19 21:00:00,139,255,13,13,731,528,203,7
11374,2023-04-19 22:00:00,139,251,11,13,782,658,124,6
11375,2023-04-19 23:00:00,122,274,9,16,678,603,75,13
11376,2023-04-20 00:00:00,123,285,13,13,571,494,77,12
11377,2023-04-20 01:00:00,147,296,14,15,571,512,59,10
11378,2023-04-20 02:00:00,145,299,10,19,640,531,109,14
11379,2023-04-20 03:00:00,147,266,5,10,735,654,81,11
11380,2023-04-20 04:00:00,127,267,11,14,784,564,220,14
11381,2023-04-20 05:00:00,146,279,5,18,585,454,131,6
11382,2023-04-20 06:00:00,128,258,10,19,568,442,126,5
11383,2023-04-20 07:00:00,127,276,10,12,660,591,69,7
11384,2023-04-20 08:00:00,128,266,11,12,682,562,120,10
11385,2023-04-20 09:00:00,134,282,13,15,702,532,170,11
11386,2023-04-20 10:00:00,126,268,12,11,758,671,87,13
11387,2023-04-20 11:00:00,122,254,6,14,629,533,96,13
11388,2023-04-20 12:00:00,139,293,14,16,643,462,181,13
11389,2023-04-20 13:00:00,131,260,6,10,602,473,129,10
11390,2023-04-20 14:00:00,131,278,7,19,618,539,79,8
11391,2023-04-20 15:00:00,126,282,6,19,519,372,147,10
11392,2023-04-20 16:00:00,142,289,5,13,515,386,129,12
11393,2023-04-20 17:00:00,147,268,10,18,597,458,139,6
11394,2023-04-20 18:00:00,121,293,5,10,706,566,140,14
11395,2023-04-20 19:00:00,148,297,6,13,636,475,161,12
11396,2023-04-20 20:00:00,143,261,11,11,774,601,173,14
11397,2023-04-20 21:00:00,120,270,12,18,517,378,139,6
11398,2023-04-20 22:00:00,132,297,12,13,545,416,129,7
11399,2023-04-20 23:00:00,139,281,10,14,733,607,126,10
11400,2023-04-21 00:00:00,138,269,14,11,760,659,101,5
11401,2023-04-21 01:00:00,136,256,9,13,544,415,129,14
11402,2023-04-21 02:00:00,144,277,12,14,718,634,84,14
11403,2023-04-21 03:00:00,130,290,10,10,685,498,187,6
11404,2023-04-21 04:00:00,128,270,13,13,597,478,119,7
11405,2023-04-21 05:00:00,141,281,12,12,539,471,68,10
11406,2023-04-21 06:00:00,140,268,9,15,741,544,197,9
11407,2023-04-21 07:00:00,133,286,10,12,769,676,93,12
11408,2023-04-21 08:00:00,127,283,10,17,780,570,210,9
11409,2023-04-21 09:00:00,126,275,6,13,790,625,165,12
11410,2023-04-21 10:00:00,130,278,8,12,583,465,118,11
11411,2023-04-21 11:00:00,132,278,14,13,696,588,108,13
11412,2023-04-21 12:00:00,127,292,12,15,711,518,193,14
11413,2023-04-21 13:00:00,129,279,8,10,601,432,169,13
11414,2023-04-21 14:00:00,141,287,9,17,788,700,88,6
11415,2023-04-21 15:00:00,135,266,14,13,746,571,175,13
11416,2023-04-21 16:00:00,141,289,13,13,761,586,175,5
11417,2023-04-21 17:00:00,133,269,5,11,672,527,145,9
11418,2023-04-21 18:00:00,137,263,6,11,594,508,86,8
11419,2023-04-21 19:00:00,129,261,10,17,579,489,90,11
11420,2023-04-21 20:00:00,129,264,5,10,640,486,154,13
11421,2023-04-21 21:00:00,145,269,6,13,504,427,77,13
11422,2023-04-21 22:00:00,131,267,8,12,621,520,101,7
11423,2023-04-21 23:00:00,143,277,13,15,709,576,133,9
11424,2023-04-22 00:00:00,124,284,6,13,735,600,135,6
11425,2023-04-22 01:00:00,121,263,8,12,539,424,115,7
11426,2023-04-22 02:00:00,137,261,8,19,551,487,64,6
11427,2023-04-22 03:00:00,132,292,11,14,748,557,191,9
11428,2023-04-22 04:00:00,132,282,5,14,682,607,75,13
11429,2023-04-22 05:00:00,131,294,5,19,714,538,176,11
11430,2023-04-22 06:00:00,138,252,14,13,553,474,79,5
11431,2023-04-22 07:00:00,127,297,6,13,676,498,178,9
11432,2023-04-22 08:00:00,137,274,12,17,776,601,175,8
11433,2023-04-22 09:00:00,128,288,7,10,786,695,91,14
11434,2023-04-22 10:00:00,135,270,6,17,687,488,199,14
11435,2023-04-22 11:00:00,128,297,8,11,651,526,125,13
11436,2023-04-22 12:00:00,130,254,8,17,668,569,99,12
11437,2023-04-22 13:00:00,122,257,10,17,541,394,147,11
11438,2023-04-22 14:00:00,138,286,5,11,661,587,74,8
11439,2023-04-22 15:00:00,148,289,10,11,709,516,193,14
11440,2023-04-22 16:00:00,146,290,5,18,734,513,221,9
11441,2023-04-22 17:00:00,120,295,13,10,722,614,108,11
11442,2023-04-22 18:00:00,149,272,13,12,631,446,185,13
11443,2023-04-22 19:00:00,136,256,7,19,702,623,79,7
11444,2023-04-22 20:00:00,125,263,6,17,771,553,218,11
11445,2023-04-22 21:00:00,142,278,7,15,743,558,185,5
11446,2023-04-22 22:00:00,144,267,6,19,778,623,155,8
11447,2023-04-22 23:00:00,148,286,5,19,559,454,105,8
11448,2023-04-23 00:00:00,147,289,7,12,634,496,138,8
11449,2023-04-23 01:00:00,142,281,14,16,575,490,85,8
11450,2023-04-23 02:00:00,141,259,13,12,789,620,169,10
11451,2023-04-23 03:00:00,129,260,9,14,710,551,159,14
11452,2023-04-23 04:00:00,147,256,7,19,567,497,70,12
11453,2023-04-23 05:00:00,120,280,13,12,760,633,127,8
11454,2023-04-23 06:00:00,146,265,9,12,520,427,93,11
11455,2023-04-23 07:00:00,129,266,14,13,671,553,118,5
11456,2023-04-23 08:00:00,131,266,7,13,714,566,148,8
11457,2023-04-23 09:00:00,143,255,5,10,557,445,112,9
11458,2023-04-23 10:00:00,124,295,12,12,519,459,60,12
11459,2023-04-23 11:00:00,125,282,6,12,797,657,140,14
11460,2023-04-23 12:00:00,136,254,11,17,749,623,126,10
11461,2023-04-23 13:00:00,120,297,5,11,729,565,164,10
11462,2023-04-23 14:00:00,142,299,6,16,517,420,97,13
11463,2023-04-23 15:00:00,149,273,11,12,722,646,76,8
11464,2023-04-23 16:00:00,121,255,10,13,631,468,163,9
11465,2023-04-23 17:00:00,135,273,10,18,682,537,145,6
11466,2023-04-23 18:00:00,138,276,12,11,586,485,101,6
11467,2023-04-23 19:00:00,121,254,5,12,659,527,132,8
11468,2023-04-23 20:00:00,126,261,12,13,766,634,132,12
11469,2023-04-23 21:00:00,144,266,5,17,532,422,110,6
11470,2023-04-23 22:00:00,132,272,9,17,712,585,127,8
11471,2023-04-23 23:00:00,124,270,8,12,553,497,56,12
11472,2023-04-24 00:00:00,126,255,6,18,539,411,128,9
11473,2023-04-24 01:00:00,142,269,7,19,635,509,126,12
11474,2023-04-24 02:00:00,127,287,13,19,799,585,214,8
11475,2023-04-24 03:00:00,139,268,7,19,648,511,137,8
11476,2023-04-24 04:00:00,137,289,10,16,659,569,90,11
11477,2023-04-24 05:00:00,121,254,9,12,737,598,139,7
11478,2023-04-24 06:00:00,135,286,9,15,618,434,184,13
11479,2023-04-24 07:00:00,143,276,10,10,732,513,219,9
11480,2023-04-24 08:00:00,149,269,10,12,691,492,199,9
11481,2023-04-24 09:00:00,130,274,5,18,673,502,171,9
11482,2023-04-24 10:00:00,135,266,11,12,799,635,164,7
11483,2023-04-24 11:00:00,125,285,13,14,710,532,178,5
11484,2023-04-24 12:00:00,148,270,5,16,637,496,141,14
11485,2023-04-24 13:00:00,142,257,12,16,724,597,127,8
11486,2023-04-24 14:00:00,133,289,8,17,592,500,92,8
11487,2023-04-24 15:00:00,122,281,8,10,716,537,179,5
11488,2023-04-24 16:00:00,141,271,13,12,634,445,189,9
11489,2023-04-24 17:00:00,131,279,8,15,651,510,141,9
11490,2023-04-24 18:00:00,138,265,6,19,570,433,137,13
11491,2023-04-24 19:00:00,134,264,12,12,643,540,103,10
11492,2023-04-24 20:00:00,128,296,11,11,645,485,160,9
11493,2023-04-24 21:00:00,141,268,8,19,547,448,99,5
11494,2023-04-24 22:00:00,141,260,10,16,594,516,78,7
11495,2023-04-24 23:00:00,120,278,13,12,777,656,121,14
11496,2023-04-25 00:00:00,131,294,9,18,716,503,213,7
11497,2023-04-25 01:00:00,138,293,10,19,528,467,61,6
11498,2023-04-25 02:00:00,120,281,13,15,536,428,108,14
11499,2023-04-25 03:00:00,121,259,11,11,575,502,73,8
11500,2023-04-25 04:00:00,127,295,12,18,725,606,119,5
11501,2023-04-25 05:00:00,128,275,5,10,722,630,92,13
11502,2023-04-25 06:00:00,124,278,8,11,569,473,96,11
11503,2023-04-25 07:00:00,120,259,13,18,515,408,107,6
11504,2023-04-25 08:00:00,142,281,11,13,716,576,140,12
11505,2023-04-25 09:00:00,134,286,14,10,613,495,118,14
11506,2023-04-25 10:00:00,122,292,11,10,699,573,126,12
11507,2023-04-25 11:00:00,135,256,5,19,523,431,92,7
11508,2023-04-25 12:00:00,130,256,6,18,764,592,172,6
11509,2023-04-25 13:00:00,141,292,14,17,606,533,73,6
11510,2023-04-25 14:00:00,133,293,8,16,740,661,79,8
11511,2023-04-25 15:00:00,145,260,6,15,510,385,125,6
11512,2023-04-25 16:00:00,140,290,11,17,691,513,178,11
11513,2023-04-25 17:00:00,136,297,11,11,634,502,132,9
11514,2023-04-25 18:00:00,127,265,8,18,562,400,162,14
11515,2023-04-25 19:00:00,129,295,12,10,545,393,152,13
11516,2023-04-25 20:00:00,125,255,10,15,720,507,213,8
11517,2023-04-25 21:00:00,121,266,9,10,717,542,175,6
11518,2023-04-25 22:00:00,146,254,11,12,596,476,120,8
11519,2023-04-25 23:00:00,135,282,5,17,747,632,115,14
11520,2023-04-26 00:00:00,135,255,10,17,574,445,129,10
11521,2023-04-26 01:00:00,142,255,9,17,583,498,85,10
11522,2023-04-26 02:00:00,120,287,14,13,636,507,129,8
11523,2023-04-26 03:00:00,131,256,13,18,605,480,125,10
11524,2023-04-26 04:00:00,140,291,5,13,646,471,175,10
11525,2023-04-26 05:00:00,143,267,5,10,714,512,202,10
11526,2023-04-26 06:00:00,133,255,14,15,643,476,167,10
11527,2023-04-26 07:00:00,126,280,10,15,522,446,76,14
11528,2023-04-26 08:00:00,139,279,11,19,666,583,83,13
11529,2023-04-26 09:00:00,127,279,8,11,566,437,129,11
11530,2023-04-26 10:00:00,139,256,14,14,764,647,117,11
11531,2023-04-26 11:00:00,142,254,14,19,729,610,119,11
11532,2023-04-26 12:00:00,132,282,9,12,684,579,105,7
11533,2023-04-26 13:00:00,127,265,5,15,771,689,82,11
11534,2023-04-26 14:00:00,133,276,12,19,521,427,94,13
11535,2023-04-26 15:00:00,131,261,13,15,555,424,131,9
11536,2023-04-26 16:00:00,129,254,11,14,607,447,160,13
11537,2023-04-26 17:00:00,123,273,9,13,617,466,151,12
11538,2023-04-26 18:00:00,149,261,12,11,684,567,117,12
11539,2023-04-26 19:00:00,120,294,12,18,599,434,165,6
11540,2023-04-26 20:00:00,148,265,5,14,668,469,199,12
11541,2023-04-26 21:00:00,137,282,10,13,630,474,156,13
11542,2023-04-26 22:00:00,130,250,6,16,610,537,73,12
11543,2023-04-26 23:00:00,146,271,14,19,572,482,90,8
11544,2023-04-27 00:00:00,144,297,5,11,602,465,137,7
11545,2023-04-27 01:00:00,122,254,13,18,650,562,88,8
11546,2023-04-27 02:00:00,126,272,9,16,541,458,83,14
11547,2023-04-27 03:00:00,123,280,7,19,542,408,134,14
11548,2023-04-27 04:00:00,137,273,7,17,763,648,115,6
11549,2023-04-27 05:00:00,138,291,13,12,749,628,121,7
11550,2023-04-27 06:00:00,147,288,6,18,674,499,175,6
11551,2023-04-27 07:00:00,136,271,11,16,744,575,169,12
11552,2023-04-27 08:00:00,142,253,12,13,648,486,162,7
11553,2023-04-27 09:00:00,136,275,7,14,686,501,185,12
11554,2023-04-27 10:00:00,137,274,11,10,501,364,137,12
11555,2023-04-27 11:00:00,125,285,14,10,543,441,102,11
11556,2023-04-27 12:00:00,131,281,9,11,707,597,110,5
11557,2023-04-27 13:00:00,149,270,10,14,670,497,173,9
11558,2023-04-27 14:00:00,136,288,6,16,684,615,69,9
11559,2023-04-27 15:00:00,124,273,13,18,654,484,170,8
11560,2023-04-27 16:00:00,122,283,7,10,766,674,92,8
11561,2023-04-27 17:00:00,126,298,7,17,768,671,97,9
11562,2023-04-27 18:00:00,126,295,8,14,745,626,119,12
11563,2023-04-27 19:00:00,139,261,11,12,714,634,80,11
11564,2023-04-27 20:00:00,131,274,5,11,689,515,174,7
11565,2023-04-27 21:00:00,128,293,11,16,593,462,131,10
11566,2023-04-27 22:00:00,148,293,11,19,730,550,180,12
11567,2023-04-27 23:00:00,139,254,5,16,517,450,67,11
11568,2023-04-28 00:00:00,128,286,12,13,575,428,147,8
11569,2023-04-28 01:00:00,143,289,5,12,772,558,214,5
11570,2023-04-28 02:00:00,134,292,10,12,548,489,59,6
11571,2023-04-28 03:00:00,123,265,10,14,506,424,82,12
11572,2023-04-28 04:00:00,137,296,6,19,723,649,74,11
11573,2023-04-28 05:00:00,130,259,11,17,623,511,112,5
11574,2023-04-28 06:00:00,126,259,6,17,569,474,95,14
11575,2023-04-28 07:00:00,122,254,9,16,553,488,65,12
11576,2023-04-28 08:00:00,134,285,7,12,676,574,102,14
11577,2023-04-28 09:00:00,124,294,10,13,513,407,106,12
11578,2023-04-28 10:00:00,138,272,6,15,795,637,158,11
11579,2023-04-28 11:00:00,128,272,6,11,632,551,81,5
11580,2023-04-28 12:00:00,127,286,10,14,578,437,141,9
11581,2023-04-28 13:00:00,125,295,11,13,669,600,69,11
11582,2023-04-28 14:00:00,130,254,13,18,500,421,79,6
11583,2023-04-28 15:00:00,145,296,10,11,612,441,171,13
11584,2023-04-28 16:00:00,136,256,13,19,560,396,164,9
11585,2023-04-28 17:00:00,149,258,10,13,530,462,68,6
11586,2023-04-28 18:00:00,124,265,10,11,561,409,152,6
11587,2023-04-28 19:00:00,139,297,5,11,756,579,177,10
11588,2023-04-28 20:00:00,127,285,14,14,587,503,84,13
11589,2023-04-28 21:00:00,144,267,13,14,551,445,106,11
11590,2023-04-28 22:00:00,141,264,11,10,540,448,92,10
11591,2023-04-28 23:00:00,141,270,7,14,780,676,104,14
11592,2023-04-29 00:00:00,133,257,12,15,634,448,186,5
11593,2023-04-29 01:00:00,138,252,12,16,664,495,169,13
11594,2023-04-29 02:00:00,120,261,13,16,759,674,85,14
11595,2023-04-29 03:00:00,124,251,6,15,743,645,98,9
11596,2023-04-29 04:00:00,139,275,10,12,586,427,159,14
11597,2023-04-29 05:00:00,134,279,6,10,680,529,151,14
11598,2023-04-29 06:00:00,134,266,13,12,759,533,226,6
11599,2023-04-29 07:00:00,147,295,6,15,729,646,83,10
11600,2023-04-29 08:00:00,120,284,11,14,762,684,78,12
11601,2023-04-29 09:00:00,143,271,12,16,798,638,160,5
11602,2023-04-29 10:00:00,136,287,11,11,534,403,131,10
11603,2023-04-29 11:00:00,130,253,6,13,554,389,165,5
11604,2023-04-29 12:00:00,142,294,13,18,530,473,57,8
11605,2023-04-29 13:00:00,138,270,7,15,747,555,192,11
11606,2023-04-29 14:00:00,133,250,7,13,537,396,141,6
11607,2023-04-29 15:00:00,138,293,5,14,543,458,85,12
11608,2023-04-29 16:00:00,128,252,6,14,620,522,98,6
11609,2023-04-29 17:00:00,145,250,12,13,650,490,160,13
11610,2023-04-29 18:00:00,126,271,9,13,649,538,111,9
11611,2023-04-29 19:00:00,138,289,7,16,654,521,133,14
11612,2023-04-29 20:00:00,137,256,11,18,603,507,96,9
11613,2023-04-29 21:00:00,125,297,11,19,653,498,155,12
11614,2023-04-29 22:00:00,139,259,8,16,576,474,102,7
11615,2023-04-29 23:00:00,132,271,8,16,637,549,88,11
11616,2023-04-30 00:00:00,127,266,9,14,624,462,162,9
11617,2023-04-30 01:00:00,145,275,13,17,563,439,124,12
11618,2023-04-30 02:00:00,145,291,7,19,528,426,102,10
11619,2023-04-30 03:00:00,143,266,9,12,748,614,134,6
11620,2023-04-30 04:00:00,140,295,10,17,593,524,69,13
11621,2023-04-30 05:00:00,148,266,5,10,643,505,138,13
11622,2023-04-30 06:00:00,132,279,12,15,523,391,132,5
11623,2023-04-30 07:00:00,147,291,12,12,638,477,161,5
11624,2023-04-30 08:00:00,124,289,8,10,654,489,165,7
11625,2023-04-30 09:00:00,136,280,6,11,708,577,131,10
11626,2023-04-30 10:00:00,132,285,11,10,519,420,99,9
11627,2023-04-30 11:00:00,134,259,12,17,781,609,172,5
11628,2023-04-30 12:00:00,123,260,6,18,513,389,124,10
11629,2023-04-30 13:00:00,133,285,14,13,707,505,202,14
11630,2023-04-30 14:00:00,126,281,5,19,790,672,118,5
11631,2023-04-30 15:00:00,136,282,10,10,592,517,75,5
11632,2023-04-30 16:00:00,141,291,14,17,760,567,193,7
11633,2023-04-30 17:00:00,144,285,5,19,717,610,107,8
11634,2023-04-30 18:00:00,128,253,5,13,767,617,150,5
11635,2023-04-30 19:00:00,130,264,11,12,503,362,141,9
11636,2023-04-30 20:00:00,124,280,8,16,573,455,118,12
11637,2023-04-30 21:00:00,143,270,7,14,550,490,60,8
11638,2023-04-30 22:00:00,142,297,11,18,730,530,200,5
11639,2023-04-30 23:00:00,136,259,5,17,678,509,169,6
11640,2023-05-01 00:00:00,129,285,8,16,538,412,126,6
11641,2023-05-01 01:00:00,149,284,11,13,692,612,80,5
11642,2023-05-01 02:00:00,135,254,12,13,644,473,171,14
11643,2023-05-01 03:00:00,128,282,12,16,666,569,97,12
11644,2023-05-01 04:00:00,121,267,11,12,679,603,76,10
11645,2023-05-01 05:00:00,136,299,12,11,580,443,137,14
11646,2023-05-01 06:00:00,126,254,11,18,512,377,135,13
11647,2023-05-01 07:00:00,149,273,9,12,720,614,106,8
11648,2023-05-01 08:00:00,135,260,8,16,614,521,93,13
11649,2023-05-01 09:00:00,143,287,10,12,670,594,76,5
11650,2023-05-01 10:00:00,120,254,14,14,791,647,144,6
11651,2023-05-01 11:00:00,123,278,5,10,564,435,129,13
11652,2023-05-01 12:00:00,132,276,6,12,560,473,87,10
11653,2023-05-01 13:00:00,128,286,7,13,708,584,124,12
11654,2023-05-01 14:00:00,141,298,7,19,553,440,113,10
11655,2023-05-01 15:00:00,139,297,5,10,647,576,71,8
11656,2023-05-01 16:00:00,132,273,7,16,734,617,117,8
11657,2023-05-01 17:00:00,141,296,11,14,542,471,71,6
11658,2023-05-01 18:00:00,133,257,12,14,664,562,102,9
11659,2023-05-01 19:00:00,122,293,5,15,649,497,152,14
11660,2023-05-01 20:00:00,126,264,11,17,541,437,104,9
11661,2023-05-01 21:00:00,140,279,5,16,511,399,112,7
11662,2023-05-01 22:00:00,136,273,13,11,730,583,147,8
11663,2023-05-01 23:00:00,148,291,9,17,540,438,102,9
11664,2023-05-02 00:00:00,144,278,14,17,721,633,88,7
11665,2023-05-02 01:00:00,137,260,12,14,516,459,57,8
11666,2023-05-02 02:00:00,149,288,6,17,776,602,174,12
11667,2023-05-02 03:00:00,148,290,11,12,529,437,92,7
11668,2023-05-02 04:00:00,146,295,5,12,575,408,167,12
11669,2023-05-02 05:00:00,149,266,10,16,726,512,214,13
11670,2023-05-02 06:00:00,134,277,12,18,624,556,68,7
11671,2023-05-02 07:00:00,138,290,7,16,663,567,96,14
11672,2023-05-02 08:00:00,125,286,5,12,511,421,90,6
11673,2023-05-02 09:00:00,131,250,14,17,787,570,217,5
11674,2023-05-02 10:00:00,120,297,5,10,663,595,68,11
11675,2023-05-02 11:00:00,122,285,8,13,784,679,105,7
11676,2023-05-02 12:00:00,128,274,8,15,713,593,120,7
11677,2023-05-02 13:00:00,132,266,12,16,651,513,138,14
11678,2023-05-02 14:00:00,140,270,5,19,683,563,120,6
11679,2023-05-02 15:00:00,143,253,7,19,618,532,86,13
11680,2023-05-02 16:00:00,141,261,6,15,730,558,172,7
11681,2023-05-02 17:00:00,124,260,13,18,562,417,145,12
11682,2023-05-02 18:00:00,133,267,8,18,762,597,165,6
11683,2023-05-02 19:00:00,123,297,8,17,666,564,102,7
11684,2023-05-02 20:00:00,145,297,5,10,598,429,169,8
11685,2023-05-02 21:00:00,138,278,8,12,604,514,90,5
11686,2023-05-02 22:00:00,120,295,7,14,774,681,93,9
11687,2023-05-02 23:00:00,146,264,8,12,627,559,68,9
11688,2023-05-03 00:00:00,141,277,14,19,735,642,93,8
11689,2023-05-03 01:00:00,148,266,10,15,769,555,214,10
11690,2023-05-03 02:00:00,122,282,14,18,659,546,113,8
11691,2023-05-03 03:00:00,129,296,14,15,575,409,166,11
11692,2023-05-03 04:00:00,129,265,8,13,501,440,61,12
11693,2023-05-03 05:00:00,127,254,7,16,696,583,113,8
11694,2023-05-03 06:00:00,122,264,11,18,771,608,163,8
11695,2023-05-03 07:00:00,129,278,14,14,552,496,56,8
11696,2023-05-03 08:00:00,123,274,8,13,708,594,114,11
11697,2023-05-03 09:00:00,124,272,7,11,578,487,91,6
11698,2023-05-03 10:00:00,126,280,9,10,503,387,116,7
11699,2023-05-03 11:00:00,127,268,13,15,524,459,65,8
11700,2023-05-03 12:00:00,147,255,6,18,777,545,232,8
11701,2023-05-03 13:00:00,146,270,13,13,754,611,143,12
11702,2023-05-03 14:00:00,122,282,13,19,743,645,98,8
11703,2023-05-03 15:00:00,135,275,6,14,694,549,145,7
11704,2023-05-03 16:00:00,130,291,14,11,787,631,156,13
11705,2023-05-03 17:00:00,140,293,12,16,717,626,91,11
11706,2023-05-03 18:00:00,121,255,8,13,614,527,87,9
11707,2023-05-03 19:00:00,131,251,12,16,562,468,94,9
11708,2023-05-03 20:00:00,141,287,11,19,674,516,158,7
11709,2023-05-03 21:00:00,124,253,11,18,517,414,103,14
11710,2023-05-03 22:00:00,149,297,10,15,579,425,154,7
11711,2023-05-03 23:00:00,149,260,5,18,691,511,180,13
11712,2023-05-04 00:00:00,126,290,12,15,625,445,180,14
11713,2023-05-04 01:00:00,136,258,8,11,751,611,140,10
11714,2023-05-04 02:00:00,146,272,14,11,501,362,139,6
11715,2023-05-04 03:00:00,137,254,7,19,513,419,94,5
11716,2023-05-04 04:00:00,124,298,6,12,568,508,60,11
11717,2023-05-04 05:00:00,148,277,12,12,799,654,145,10
11718,2023-05-04 06:00:00,127,297,7,10,508,358,150,12
11719,2023-05-04 07:00:00,142,253,10,11,633,535,98,14
11720,2023-05-04 08:00:00,137,277,5,11,764,646,118,5
11721,2023-05-04 09:00:00,121,284,14,18,656,530,126,11
11722,2023-05-04 10:00:00,146,295,13,15,644,523,121,13
11723,2023-05-04 11:00:00,147,299,14,14,637,517,120,7
11724,2023-05-04 12:00:00,125,278,11,15,737,613,124,11
11725,2023-05-04 13:00:00,130,266,7,14,754,603,151,5
11726,2023-05-04 14:00:00,145,296,13,15,684,548,136,12
11727,2023-05-04 15:00:00,141,292,13,19,743,624,119,14
11728,2023-05-04 16:00:00,133,290,6,13,645,508,137,14
11729,2023-05-04 17:00:00,149,262,14,14,705,527,178,9
11730,2023-05-04 18:00:00,120,265,10,10,736,551,185,8
11731,2023-05-04 19:00:00,137,260,12,19,622,543,79,9
11732,2023-05-04 20:00:00,122,279,8,15,561,493,68,14
11733,2023-05-04 21:00:00,122,298,8,13,781,577,204,9
11734,2023-05-04 22:00:00,125,254,14,11,684,507,177,12
11735,2023-05-04 23:00:00,124,258,14,19,710,572,138,7
11736,2023-05-05 00:00:00,131,261,10,13,586,525,61,7
11737,2023-05-05 01:00:00,129,296,9,14,776,634,142,8
11738,2023-05-05 02:00:00,121,251,11,19,518,384,134,11
11739,2023-05-05 03:00:00,128,276,5,13,644,499,145,11
11740,2023-05-05 04:00:00,149,275,5,17,615,526,89,14
11741,2023-05-05 05:00:00,129,281,7,10,627,464,163,7
11742,2023-05-05 06:00:00,137,290,10,17,567,422,145,6
11743,2023-05-05 07:00:00,128,279,8,18,694,599,95,7
11744,2023-05-05 08:00:00,142,254,12,16,647,545,102,14
11745,2023-05-05 09:00:00,137,262,6,17,584,413,171,12
11746,2023-05-05 10:00:00,140,262,11,18,640,498,142,9
11747,2023-05-05 11:00:00,134,274,10,15,747,606,141,11
11748,2023-05-05 12:00:00,128,281,9,19,650,487,163,6
11749,2023-05-05 13:00:00,134,285,7,16,613,509,104,7
11750,2023-05-05 14:00:00,140,293,5,12,516,375,141,6
11751,2023-05-05 15:00:00,131,274,13,15,712,588,124,10
11752,2023-05-05 16:00:00,123,293,10,19,614,493,121,13
11753,2023-05-05 17:00:00,132,293,9,10,674,564,110,6
11754,2023-05-05 18:00:00,136,252,10,13,623,451,172,5
11755,2023-05-05 19:00:00,135,264,8,14,698,588,110,5
11756,2023-05-05 20:00:00,149,286,14,16,595,425,170,9
11757,2023-05-05 21:00:00,124,256,11,16,640,453,187,13
11758,2023-05-05 22:00:00,124,293,5,14,651,562,89,12
11759,2023-05-05 23:00:00,136,272,8,17,558,462,96,14
11760,2023-05-06 00:00:00,141,260,14,11,718,562,156,9
11761,2023-05-06 01:00:00,141,276,11,14,560,485,75,10
11762,2023-05-06 02:00:00,134,266,14,14,633,566,67,10
11763,2023-05-06 03:00:00,135,276,5,17,500,394,106,13
11764,2023-05-06 04:00:00,144,250,7,11,748,568,180,12
11765,2023-05-06 05:00:00,143,269,9,14,599,499,100,7
11766,2023-05-06 06:00:00,141,284,6,15,620,497,123,6
11767,2023-05-06 07:00:00,144,295,14,12,798,617,181,7
11768,2023-05-06 08:00:00,132,255,10,15,660,475,185,9
11769,2023-05-06 09:00:00,120,259,12,16,697,533,164,5
11770,2023-05-06 10:00:00,123,297,8,10,790,699,91,13
11771,2023-05-06 11:00:00,125,298,11,18,742,642,100,8
11772,2023-05-06 12:00:00,125,279,8,11,554,431,123,12
11773,2023-05-06 13:00:00,139,297,5,10,544,396,148,8
11774,2023-05-06 14:00:00,121,286,5,15,787,662,125,14
11775,2023-05-06 15:00:00,131,297,9,19,798,698,100,13
11776,2023-05-06 16:00:00,145,286,6,12,605,469,136,5
11777,2023-05-06 17:00:00,137,278,7,17,592,473,119,5
11778,2023-05-06 18:00:00,123,254,14,17,703,632,71,9
11779,2023-05-06 19:00:00,148,288,7,13,550,456,94,5
11780,2023-05-06 20:00:00,128,273,8,11,760,575,185,9
11781,2023-05-06 21:00:00,131,263,8,18,624,459,165,6
11782,2023-05-06 22:00:00,136,258,6,15,773,574,199,6
11783,2023-05-06 23:00:00,129,259,9,12,733,651,82,11
11784,2023-05-07 00:00:00,126,259,6,12,723,619,104,11
11785,2023-05-07 01:00:00,148,296,14,17,591,449,142,10
11786,2023-05-07 02:00:00,148,264,12,11,590,448,142,7
11787,2023-05-07 03:00:00,134,256,8,12,562,458,104,12
11788,2023-05-07 04:00:00,134,285,9,11,749,644,105,9
11789,2023-05-07 05:00:00,144,253,7,11,778,623,155,14
11790,2023-05-07 06:00:00,127,273,11,13,548,467,81,6
11791,2023-05-07 07:00:00,144,274,8,10,576,431,145,7
11792,2023-05-07 08:00:00,127,266,10,17,620,445,175,14
11793,2023-05-07 09:00:00,132,262,14,14,795,651,144,7
11794,2023-05-07 10:00:00,124,277,13,11,635,528,107,9
11795,2023-05-07 11:00:00,134,297,13,11,556,401,155,14
11796,2023-05-07 12:00:00,145,288,8,10,536,400,136,8
11797,2023-05-07 13:00:00,129,257,12,18,764,603,161,10
11798,2023-05-07 14:00:00,122,268,8,14,710,614,96,8
11799,2023-05-07 15:00:00,143,274,12,12,732,604,128,6
11800,2023-05-07 16:00:00,135,255,13,17,501,448,53,8
11801,2023-05-07 17:00:00,148,288,12,16,554,404,150,10
11802,2023-05-07 18:00:00,120,276,10,11,511,406,105,9
11803,2023-05-07 19:00:00,136,256,9,15,676,605,71,7
11804,2023-05-07 20:00:00,130,277,5,11,780,585,195,12
11805,2023-05-07 21:00:00,136,259,8,17,750,554,196,6
11806,2023-05-07 22:00:00,130,271,7,19,708,552,156,10
11807,2023-05-07 23:00:00,149,264,7,11,542,394,148,11
11808,2023-05-08 00:00:00,139,295,11,11,788,554,234,8
11809,2023-05-08 01:00:00,144,257,13,12,544,452,92,13
11810,2023-05-08 02:00:00,139,274,10,19,722,628,94,13
11811,2023-05-08 03:00:00,140,292,14,17,692,552,140,12
11812,2023-05-08 04:00:00,135,255,13,19,504,429,75,5
11813,2023-05-08 05:00:00,131,275,5,15,538,463,75,7
11814,2023-05-08 06:00:00,138,279,9,13,768,643,125,12
11815,2023-05-08 07:00:00,145,283,9,15,681,612,69,5
11816,2023-05-08 08:00:00,140,274,8,17,535,478,57,7
11817,2023-05-08 09:00:00,140,256,13,13,723,529,194,9
11818,2023-05-08 10:00:00,122,299,10,15,594,500,94,12
11819,2023-05-08 11:00:00,146,269,7,13,627,542,85,7
11820,2023-05-08 12:00:00,140,267,13,15,540,386,154,11
11821,2023-05-08 13:00:00,143,271,11,18,726,522,204,10
11822,2023-05-08 14:00:00,149,270,14,13,706,552,154,13
11823,2023-05-08 15:00:00,140,285,14,11,789,647,142,7
11824,2023-05-08 16:00:00,137,270,12,12,701,545,156,14
11825,2023-05-08 17:00:00,134,255,11,16,675,560,115,7
11826,2023-05-08 18:00:00,139,290,12,10,652,562,90,12
11827,2023-05-08 19:00:00,149,292,10,13,786,641,145,10
11828,2023-05-08 20:00:00,121,253,13,13,515,432,83,7
11829,2023-05-08 21:00:00,141,273,14,10,536,479,57,11
11830,2023-05-08 22:00:00,134,261,13,12,690,607,83,8
11831,2023-05-08 23:00:00,145,257,5,19,510,447,63,10
11832,2023-05-09 00:00:00,134,274,11,11,648,457,191,9
11833,2023-05-09 01:00:00,126,297,8,17,515,447,68,5
11834,2023-05-09 02:00:00,122,269,13,13,617,473,144,5
11835,2023-05-09 03:00:00,135,283,10,10,792,690,102,7
11836,2023-05-09 04:00:00,137,273,12,13,765,676,89,7
11837,2023-05-09 05:00:00,140,287,11,11,562,497,65,14
11838,2023-05-09 06:00:00,126,277,7,16,548,454,94,7
11839,2023-05-09 07:00:00,136,270,9,15,590,489,101,9
11840,2023-05-09 08:00:00,138,284,5,12,683,505,178,9
11841,2023-05-09 09:00:00,132,293,12,17,575,473,102,5
11842,2023-05-09 10:00:00,129,256,7,11,565,433,132,12
11843,2023-05-09 11:00:00,147,287,12,19,722,537,185,14
11844,2023-05-09 12:00:00,141,287,7,15,553,410,143,12
11845,2023-05-09 13:00:00,136,267,5,11,775,607,168,8
11846,2023-05-09 14:00:00,133,275,14,19,769,580,189,9
11847,2023-05-09 15:00:00,138,272,14,13,537,381,156,13
11848,2023-05-09 16:00:00,148,254,10,18,630,514,116,14
11849,2023-05-09 17:00:00,131,281,8,13,641,538,103,10
11850,2023-05-09 18:00:00,149,251,11,17,634,487,147,11
11851,2023-05-09 19:00:00,128,299,9,12,776,580,196,13
11852,2023-05-09 20:00:00,124,265,11,16,653,472,181,11
11853,2023-05-09 21:00:00,140,253,11,17,653,479,174,5
11854,2023-05-09 22:00:00,137,295,9,11,569,489,80,9
11855,2023-05-09 23:00:00,120,278,5,18,595,487,108,9
11856,2023-05-10 00:00:00,143,292,12,15,747,584,163,5
11857,2023-05-10 01:00:00,146,286,13,13,680,517,163,7
11858,2023-05-10 02:00:00,146,273,11,16,772,607,165,12
11859,2023-05-10 03:00:00,133,256,6,16,735,578,157,14
11860,2023-05-10 04:00:00,124,288,8,19,789,552,237,9
11861,2023-05-10 05:00:00,120,264,8,16,538,431,107,14
11862,2023-05-10 06:00:00,122,251,13,15,706,616,90,7
11863,2023-05-10 07:00:00,148,286,12,13,500,418,82,10
11864,2023-05-10 08:00:00,146,289,13,18,620,478,142,12
11865,2023-05-10 09:00:00,125,297,7,18,675,545,130,9
11866,2023-05-10 10:00:00,144,263,9,18,762,644,118,14
11867,2023-05-10 11:00:00,138,278,8,18,667,467,200,5
11868,2023-05-10 12:00:00,126,282,12,13,593,495,98,5
11869,2023-05-10 13:00:00,149,279,10,16,778,560,218,12
11870,2023-05-10 14:00:00,123,292,11,17,600,484,116,14
11871,2023-05-10 15:00:00,141,267,11,19,551,431,120,5
11872,2023-05-10 16:00:00,146,253,6,16,505,429,76,11
11873,2023-05-10 17:00:00,142,291,7,14,530,387,143,11
11874,2023-05-10 18:00:00,144,287,11,19,776,668,108,5
11875,2023-05-10 19:00:00,134,278,10,16,503,410,93,8
11876,2023-05-10 20:00:00,147,287,10,13,662,569,93,8
11877,2023-05-10 21:00:00,120,284,13,10,564,415,149,6
11878,2023-05-10 22:00:00,127,275,5,11,755,641,114,13
11879,2023-05-10 23:00:00,149,262,14,16,745,655,90,11
11880,2023-05-11 00:00:00,131,276,9,15,665,557,108,10
11881,2023-05-11 01:00:00,146,278,7,19,520,394,126,5
11882,2023-05-11 02:00:00,125,273,12,14,515,373,142,11
11883,2023-05-11 03:00:00,120,292,10,11,524,447,77,6
11884,2023-05-11 04:00:00,141,251,14,18,673,598,75,6
11885,2023-05-11 05:00:00,130,266,7,11,694,613,81,7
11886,2023-05-11 06:00:00,141,263,6,13,782,691,91,6
11887,2023-05-11 07:00:00,148,271,11,18,648,490,158,6
11888,2023-05-11 08:00:00,136,287,6,18,619,478,141,14
11889,2023-05-11 09:00:00,140,257,9,10,590,425,165,5
11890,2023-05-11 10:00:00,129,258,11,14,585,409,176,10
11891,2023-05-11 11:00:00,128,253,9,14,705,530,175,7
11892,2023-05-11 12:00:00,125,286,10,12,659,491,168,8
11893,2023-05-11 13:00:00,149,268,7,16,713,567,146,9
11894,2023-05-11 14:00:00,140,266,14,13,699,557,142,5
11895,2023-05-11 15:00:00,143,296,13,17,670,545,125,7
11896,2023-05-11 16:00:00,123,270,8,13,703,632,71,7
11897,2023-05-11 17:00:00,125,272,8,10,680,598,82,14
11898,2023-05-11 18:00:00,133,258,14,10,675,536,139,5
11899,2023-05-11 19:00:00,125,271,5,18,597,484,113,6
11900,2023-05-11 20:00:00,135,284,9,14,664,592,72,10
11901,2023-05-11 21:00:00,143,292,13,19,797,602,195,8
11902,2023-05-11 22:00:00,122,274,7,13,546,436,110,6
11903,2023-05-11 23:00:00,145,255,5,15,616,484,132,9
11904,2023-05-12 00:00:00,137,282,14,16,659,585,74,13
11905,2023-05-12 01:00:00,139,272,12,14,608,477,131,10
11906,2023-05-12 02:00:00,123,266,6,16,539,456,83,14
11907,2023-05-12 03:00:00,148,289,12,19,622,469,153,13
11908,2023-05-12 04:00:00,145,260,6,19,709,584,125,6
11909,2023-05-12 05:00:00,144,284,13,14,594,428,166,9
11910,2023-05-12 06:00:00,124,290,12,13,735,622,113,12
11911,2023-05-12 07:00:00,133,263,6,19,686,601,85,5
11912,2023-05-12 08:00:00,149,285,12,12,684,611,73,6
11913,2023-05-12 09:00:00,134,271,5,19,651,538,113,8
11914,2023-05-12 10:00:00,129,293,9,18,600,498,102,11
11915,2023-05-12 11:00:00,120,286,14,10,707,538,169,7
11916,2023-05-12 12:00:00,134,287,9,11,652,535,117,9
11917,2023-05-12 13:00:00,135,257,12,17,700,521,179,6
11918,2023-05-12 14:00:00,130,269,12,18,772,631,141,14
11919,2023-05-12 15:00:00,135,250,6,17,579,465,114,9
11920,2023-05-12 16:00:00,127,292,10,18,607,475,132,14
11921,2023-05-12 17:00:00,141,257,8,16,720,582,138,7
11922,2023-05-12 18:00:00,138,251,13,14,538,455,83,5
11923,2023-05-12 19:00:00,124,281,7,13,559,460,99,12
11924,2023-05-12 20:00:00,147,271,5,17,527,440,87,8
11925,2023-05-12 21:00:00,123,253,10,13,710,579,131,14
11926,2023-05-12 22:00:00,126,275,7,14,516,422,94,13
11927,2023-05-12 23:00:00,128,283,13,15,732,639,93,7
11928,2023-05-13 00:00:00,126,251,11,12,649,577,72,7
11929,2023-05-13 01:00:00,135,255,12,10,653,500,153,12
11930,2023-05-13 02:00:00,124,264,9,11,519,439,80,5
11931,2023-05-13 03:00:00,135,262,9,14,560,471,89,8
11932,2023-05-13 04:00:00,130,294,6,16,733,542,191,13
11933,2023-05-13 05:00:00,143,264,14,10,641,485,156,12
11934,2023-05-13 06:00:00,122,258,6,11,635,555,80,9
11935,2023-05-13 07:00:00,144,284,13,19,750,653,97,12
11936,2023-05-13 08:00:00,120,292,12,12,570,485,85,8
11937,2023-05-13 09:00:00,129,261,8,12,758,544,214,10
11938,2023-05-13 10:00:00,140,268,10,10,628,448,180,13
11939,2023-05-13 11:00:00,128,262,9,16,501,385,116,10
11940,2023-05-13 12:00:00,127,262,6,17,668,521,147,10
11941,2023-05-13 13:00:00,141,262,14,16,647,515,132,5
11942,2023-05-13 14:00:00,131,250,13,10,604,516,88,10
11943,2023-05-13 15:00:00,130,266,9,16,649,501,148,8
11944,2023-05-13 16:00:00,126,250,9,16,748,608,140,14
11945,2023-05-13 17:00:00,133,295,8,10,561,498,63,13
11946,2023-05-13 18:00:00,122,273,8,10,770,646,124,14
11947,2023-05-13 19:00:00,126,258,10,16,704,576,128,5
11948,2023-05-13 20:00:00,126,294,13,15,675,598,77,11
11949,2023-05-13 21:00:00,137,289,11,10,555,474,81,6
11950,2023-05-13 22:00:00,142,278,6,10,628,467,161,5
11951,2023-05-13 23:00:00,148,287,14,15,655,572,83,6
11952,2023-05-14 00:00:00,123,294,11,14,534,385,149,7
11953,2023-05-14 01:00:00,133,265,12,18,794,609,185,5
11954,2023-05-14 02:00:00,133,296,7,11,696,511,185,10
11955,2023-05-14 03:00:00,135,294,12,10,630,517,113,8
11956,2023-05-14 04:00:00,141,266,10,13,675,509,166,5
11957,2023-05-14 05:00:00,143,269,14,16,750,558,192,14
11958,2023-05-14 06:00:00,140,281,12,16,739,572,167,13
11959,2023-05-14 07:00:00,139,258,11,14,635,486,149,9
11960,2023-05-14 08:00:00,138,257,14,15,569,445,124,14
11961,2023-05-14 09:00:00,135,266,10,11,544,406,138,13
11962,2023-05-14 10:00:00,147,290,12,19,688,511,177,11
11963,2023-05-14 11:00:00,146,299,6,18,634,467,167,14
11964,2023-05-14 12:00:00,147,285,11,11,530,471,59,11
11965,2023-05-14 13:00:00,136,296,8,18,652,572,80,8
11966,2023-05-14 14:00:00,123,265,11,15,783,555,228,12
11967,2023-05-14 15:00:00,139,285,12,19,689,538,151,6
11968,2023-05-14 16:00:00,134,262,9,16,738,638,100,10
11969,2023-05-14 17:00:00,149,297,12,13,509,358,151,9
11970,2023-05-14 18:00:00,126,286,14,14,507,423,84,12
11971,2023-05-14 19:00:00,144,271,12,13,670,579,91,6
11972,2023-05-14 20:00:00,125,295,11,13,730,559,171,11
11973,2023-05-14 21:00:00,132,293,11,19,749,650,99,8
11974,2023-05-14 22:00:00,128,275,10,10,552,389,163,7
11975,2023-05-14 23:00:00,132,291,7,13,684,520,164,7
11976,2023-05-15 00:00:00,133,295,13,16,599,454,145,12
11977,2023-05-15 01:00:00,137,257,13,13,679,602,77,8
11978,2023-05-15 02:00:00,147,251,5,11,648,543,105,14
11979,2023-05-15 03:00:00,125,291,11,10,789,679,110,10
11980,2023-05-15 04:00:00,123,289,12,16,620,449,171,12
11981,2023-05-15 05:00:00,135,265,14,12,577,453,124,14
11982,2023-05-15 06:00:00,132,296,9,15,596,508,88,11
11983,2023-05-15 07:00:00,144,272,5,14,653,493,160,14
11984,2023-05-15 08:00:00,132,298,5,14,793,616,177,6
11985,2023-05-15 09:00:00,131,253,9,14,588,476,112,7
11986,2023-05-15 10:00:00,143,262,8,19,761,574,187,13
11987,2023-05-15 11:00:00,148,297,6,13,571,508,63,12
11988,2023-05-15 12:00:00,127,266,14,14,790,584,206,13
11989,2023-05-15 13:00:00,149,298,8,18,618,533,85,11
11990,2023-05-15 14:00:00,138,292,11,11,502,410,92,5
11991,2023-05-15 15:00:00,147,284,12,13,685,611,74,10
11992,2023-05-15 16:00:00,130,263,8,14,740,659,81,7
11993,2023-05-15 17:00:00,127,287,5,17,628,464,164,5
11994,2023-05-15 18:00:00,130,295,9,14,654,579,75,13
11995,2023-05-15 19:00:00,145,267,14,17,655,523,132,11
11996,2023-05-15 20:00:00,125,289,9,16,512,452,60,12
11997,2023-05-15 21:00:00,132,285,5,11,594,446,148,11
11998,2023-05-15 22:00:00,145,285,7,16,755,580,175,7
11999,2023-05-15 23:00:00,121,289,8,19,661,467,194,14
12000,2023-05-16 00:00:00,132,274,14,18,709,612,97,9
12001,2023-05-16 01:00:00,146,276,5,18,529,470,59,9
12002,2023-05-16 02:00:00,128,283,6,16,796,715,81,14
12003,2023-05-16 03:00:00,146,266,13,16,576,414,162,5
12004,2023-05-16 04:00:00,124,250,6,15,522,395,127,13
12005,2023-05-16 05:00:00,129,251,8,19,549,454,95,14
12006,2023-05-16 06:00:00,138,273,7,11,727,620,107,10
12007,2023-05-16 07:00:00,147,256,13,15,524,368,156,6
12008,2023-05-16 08:00:00,148,276,7,11,672,573,99,10
12009,2023-05-16 09:00:00,139,250,9,18,788,620,168,12
12010,2023-05-16 10:00:00,133,263,9,13,680,504,176,8
12011,2023-05-16 11:00:00,149,280,7,18,583,507,76,13
12012,2023-05-16 12:00:00,123,251,7,17,551,439,112,5
12013,2023-05-16 13:00:00,148,256,12,19,703,607,96,14
12014,2023-05-16 14:00:00,143,256,11,14,695,531,164,7
12015,2023-05-16 15:00:00,130,298,7,14,707,590,117,13
12016,2023-05-16 16:00:00,149,270,13,17,726,524,202,9
12017,2023-05-16 17:00:00,138,287,5,18,655,573,82,7
12018,2023-05-16 18:00:00,133,270,11,12,523,412,111,10
12019,2023-05-16 19:00:00,122,268,11,15,704,517,187,9
12020,2023-05-16 20:00:00,129,251,10,13,610,469,141,12
12021,2023-05-16 21:00:00,123,271,11,18,707,625,82,6
12022,2023-05-16 22:00:00,126,299,13,11,589,447,142,6
12023,2023-05-16 23:00:00,144,255,8,12,606,516,90,9
12024,2023-05-17 00:00:00,146,274,9,10,546,474,72,9
12025,2023-05-17 01:00:00,136,298,8,13,669,509,160,12
12026,2023-05-17 02:00:00,137,289,14,17,689,612,77,7
12027,2023-05-17 03:00:00,143,292,11,10,535,381,154,5
12028,2023-05-17 04:00:00,136,275,6,14,535,402,133,5
12029,2023-05-17 05:00:00,131,257,8,13,515,431,84,13
12030,2023-05-17 06:00:00,129,280,6,17,632,460,172,13
12031,2023-05-17 07:00:00,149,287,8,14,628,537,91,11
12032,2023-05-17 08:00:00,124,285,7,10,535,423,112,11
12033,2023-05-17 09:00:00,131,250,5,11,788,605,183,10
12034,2023-05-17 10:00:00,145,255,12,12,570,453,117,8
12035,2023-05-17 11:00:00,123,271,6,16,707,606,101,5
12036,2023-05-17 12:00:00,131,289,7,14,751,578,173,8
12037,2023-05-17 13:00:00,140,273,10,12,576,403,173,7
12038,2023-05-17 14:00:00,124,281,5,11,647,517,130,8
12039,2023-05-17 15:00:00,123,272,11,13,677,535,142,7
12040,2023-05-17 16:00:00,143,298,11,13,534,436,98,13
12041,2023-05-17 17:00:00,133,287,9,11,753,675,78,8
12042,2023-05-17 18:00:00,127,279,7,16,522,446,76,10
12043,2023-05-17 19:00:00,131,275,7,15,548,410,138,9
12044,2023-05-17 20:00:00,144,278,10,17,535,446,89,9
12045,2023-05-17 21:00:00,123,283,8,10,548,423,125,9
12046,2023-05-17 22:00:00,138,281,7,18,794,616,178,5
12047,2023-05-17 23:00:00,128,282,14,10,748,582,166,7
12048,2023-05-18 00:00:00,146,293,10,18,558,472,86,12
12049,2023-05-18 01:00:00,133,287,8,16,506,437,69,14
12050,2023-05-18 02:00:00,147,263,13,19,708,631,77,10
12051,2023-05-18 03:00:00,138,255,8,15,608,511,97,11
12052,2023-05-18 04:00:00,137,284,10,12,740,526,214,11
12053,2023-05-18 05:00:00,133,275,11,18,515,378,137,10
12054,2023-05-18 06:00:00,128,270,12,12,539,442,97,11
12055,2023-05-18 07:00:00,140,293,13,18,652,537,115,11
12056,2023-05-18 08:00:00,146,270,6,10,537,389,148,14
12057,2023-05-18 09:00:00,128,264,9,18,552,398,154,11
12058,2023-05-18 10:00:00,127,274,10,15,682,493,189,10
12059,2023-05-18 11:00:00,126,278,13,12,787,683,104,7
12060,2023-05-18 12:00:00,130,262,9,14,649,529,120,12
12061,2023-05-18 13:00:00,132,292,9,11,688,608,80,12
12062,2023-05-18 14:00:00,146,285,12,14,710,622,88,14
12063,2023-05-18 15:00:00,124,279,13,12,707,597,110,8
12064,2023-05-18 16:00:00,133,293,8,12,561,414,147,9
12065,2023-05-18 17:00:00,149,253,11,19,757,582,175,6
12066,2023-05-18 18:00:00,121,256,10,14,667,507,160,11
12067,2023-05-18 19:00:00,126,287,14,15,510,436,74,11
12068,2023-05-18 20:00:00,123,255,11,12,690,613,77,6
12069,2023-05-18 21:00:00,130,260,11,17,525,391,134,13
12070,2023-05-18 22:00:00,125,298,6,10,692,602,90,10
12071,2023-05-18 23:00:00,139,284,12,13,558,406,152,9
12072,2023-05-19 00:00:00,121,265,12,15,778,640,138,10
12073,2023-05-19 01:00:00,130,258,9,11,795,605,190,12
12074,2023-05-19 02:00:00,147,264,11,18,625,501,124,5
12075,2023-05-19 03:00:00,121,286,13,15,681,608,73,7
12076,2023-05-19 04:00:00,136,260,13,15,777,678,99,10
12077,2023-05-19 05:00:00,135,251,7,15,761,671,90,5
12078,2023-05-19 06:00:00,128,299,14,12,753,672,81,11
12079,2023-05-19 07:00:00,120,283,14,10,606,526,80,5
12080,2023-05-19 08:00:00,121,286,9,19,526,416,110,8
12081,2023-05-19 09:00:00,142,255,5,18,515,379,136,14
12082,2023-05-19 10:00:00,134,291,13,10,705,552,153,9
12083,2023-05-19 11:00:00,126,279,7,19,785,635,150,10
12084,2023-05-19 12:00:00,128,255,14,10,576,409,167,7
12085,2023-05-19 13:00:00,125,298,5,12,753,597,156,14
12086,2023-05-19 14:00:00,130,281,14,13,576,473,103,13
12087,2023-05-19 15:00:00,130,295,10,15,686,579,107,7
12088,2023-05-19 16:00:00,146,293,7,14,677,488,189,5
12089,2023-05-19 17:00:00,147,298,11,12,789,634,155,11
12090,2023-05-19 18:00:00,141,294,13,17,751,631,120,14
12091,2023-05-19 19:00:00,122,252,6,19,503,358,145,14
12092,2023-05-19 20:00:00,131,283,13,16,584,520,64,14
12093,2023-05-19 21:00:00,129,277,11,18,692,578,114,11
12094,2023-05-19 22:00:00,137,272,13,17,533,390,143,13
12095,2023-05-19 23:00:00,126,264,14,10,527,445,82,6
12096,2023-05-20 00:00:00,120,269,9,18,588,473,115,12
12097,2023-05-20 01:00:00,125,250,13,16,743,554,189,13
12098,2023-05-20 02:00:00,139,296,9,13,792,568,224,12
12099,2023-05-20 03:00:00,143,254,9,16,754,573,181,5
12100,2023-05-20 04:00:00,122,266,13,16,675,532,143,13
12101,2023-05-20 05:00:00,145,292,8,13,627,456,171,9
12102,2023-05-20 06:00:00,131,260,11,11,644,488,156,12
12103,2023-05-20 07:00:00,128,283,9,13,680,481,199,5
12104,2023-05-20 08:00:00,148,266,7,13,739,603,136,6
12105,2023-05-20 09:00:00,121,276,10,14,796,630,166,10
12106,2023-05-20 10:00:00,126,288,10,17,514,427,87,7
12107,2023-05-20 11:00:00,131,257,10,19,520,394,126,14
12108,2023-05-20 12:00:00,145,269,13,15,556,427,129,9
12109,2023-05-20 13:00:00,135,263,6,19,554,452,102,9
12110,2023-05-20 14:00:00,145,258,9,19,783,592,191,8
12111,2023-05-20 15:00:00,136,267,13,12,671,555,116,7
12112,2023-05-20 16:00:00,145,276,11,12,502,435,67,11
12113,2023-05-20 17:00:00,145,287,5,18,542,385,157,11
12114,2023-05-20 18:00:00,133,296,8,11,799,673,126,11
12115,2023-05-20 19:00:00,120,266,12,11,672,545,127,12
12116,2023-05-20 20:00:00,134,272,13,14,529,407,122,6
12117,2023-05-20 21:00:00,121,283,6,19,615,517,98,13
12118,2023-05-20 22:00:00,135,270,6,12,775,621,154,5
12119,2023-05-20 23:00:00,120,263,12,16,510,375,135,14
12120,2023-05-21 00:00:00,145,263,5,12,795,687,108,14
12121,2023-05-21 01:00:00,141,264,5,17,605,525,80,6
12122,2023-05-21 02:00:00,120,265,10,18,656,484,172,8
12123,2023-05-21 03:00:00,132,280,5,18,506,358,148,9
12124,2023-05-21 04:00:00,140,257,8,19,749,601,148,8
12125,2023-05-21 05:00:00,132,288,10,16,561,411,150,12
12126,2023-05-21 06:00:00,134,260,9,10,533,418,115,7
12127,2023-05-21 07:00:00,138,294,11,18,622,550,72,14
12128,2023-05-21 08:00:00,135,298,10,10,609,473,136,13
12129,2023-05-21 09:00:00,136,262,9,15,628,474,154,5
12130,2023-05-21 10:00:00,143,289,14,13,529,377,152,10
12131,2023-05-21 11:00:00,130,264,5,11,781,652,129,5
12132,2023-05-21 12:00:00,122,298,9,11,561,397,164,10
12133,2023-05-21 13:00:00,143,262,5,13,676,570,106,12
12134,2023-05-21 14:00:00,131,253,8,12,778,633,145,11
12135,2023-05-21 15:00:00,140,298,13,15,532,396,136,12
12136,2023-05-21 16:00:00,134,267,8,15,574,428,146,12
12137,2023-05-21 17:00:00,138,295,8,17,738,619,119,14
12138,2023-05-21 18:00:00,136,260,13,17,667,524,143,13
12139,2023-05-21 19:00:00,129,282,12,15,780,569,211,12
12140,2023-05-21 20:00:00,146,278,6,16,602,474,128,14
12141,2023-05-21 21:00:00,137,250,12,11,591,480,111,12
12142,2023-05-21 22:00:00,123,291,5,16,615,533,82,9
12143,2023-05-21 23:00:00,128,263,6,19,718,588,130,13
12144,2023-05-22 00:00:00,134,273,5,16,647,529,118,13
12145,2023-05-22 01:00:00,141,280,12,16,726,643,83,12
12146,2023-05-22 02:00:00,148,272,12,11,675,533,142,6
12147,2023-05-22 03:00:00,148,257,11,10,715,518,197,6
12148,2023-05-22 04:00:00,130,262,14,13,756,555,201,6
12149,2023-05-22 05:00:00,140,292,9,16,567,492,75,10
12150,2023-05-22 06:00:00,139,291,12,16,742,638,104,13
12151,2023-05-22 07:00:00,145,289,13,12,574,419,155,14
12152,2023-05-22 08:00:00,146,256,12,15,547,440,107,8
12153,2023-05-22 09:00:00,132,251,13,16,798,682,116,11
12154,2023-05-22 10:00:00,134,292,8,10,615,435,180,13
12155,2023-05-22 11:00:00,121,264,5,15,532,464,68,7
12156,2023-05-22 12:00:00,136,292,6,10,671,475,196,12
12157,2023-05-22 13:00:00,124,280,6,13,743,578,165,8
12158,2023-05-22 14:00:00,121,291,9,14,799,601,198,6
12159,2023-05-22 15:00:00,148,276,12,15,544,390,154,5
12160,2023-05-22 16:00:00,121,293,12,13,735,625,110,12
12161,2023-05-22 17:00:00,148,259,12,18,647,557,90,6
12162,2023-05-22 18:00:00,120,274,11,18,605,497,108,6
12163,2023-05-22 19:00:00,127,262,6,13,591,490,101,11
12164,2023-05-22 20:00:00,138,281,8,10,693,523,170,8
12165,2023-05-22 21:00:00,129,295,7,15,796,626,170,14
12166,2023-05-22 22:00:00,122,268,8,18,649,543,106,8
12167,2023-05-22 23:00:00,148,292,7,13,792,578,214,9
12168,2023-05-23 00:00:00,137,295,6,10,609,446,163,10
12169,2023-05-23 01:00:00,139,287,11,16,586,423,163,14
12170,2023-05-23 02:00:00,120,269,11,19,573,420,153,10
12171,2023-05-23 03:00:00,122,253,9,16,518,385,133,9
12172,2023-05-23 04:00:00,144,256,7,13,609,426,183,6
12173,2023-05-23 05:00:00,140,275,13,13,665,532,133,13
12174,2023-05-23 06:00:00,124,266,5,17,720,625,95,5
12175,2023-05-23 07:00:00,146,259,9,15,627,464,163,9
12176,2023-05-23 08:00:00,130,296,12,10,710,581,129,6
12177,2023-05-23 09:00:00,122,298,6,12,644,509,135,8
12178,2023-05-23 10:00:00,126,291,13,16,542,465,77,8
12179,2023-05-23 11:00:00,124,256,12,11,543,453,90,5
12180,2023-05-23 12:00:00,121,289,11,11,630,559,71,8
12181,2023-05-23 13:00:00,134,261,11,12,681,542,139,13
12182,2023-05-23 14:00:00,131,253,13,18,697,614,83,6
12183,2023-05-23 15:00:00,149,264,11,13,797,708,89,8
12184,2023-05-23 16:00:00,122,291,11,12,678,587,91,11
12185,2023-05-23 17:00:00,121,270,11,19,661,532,129,7
12186,2023-05-23 18:00:00,146,289,13,18,616,475,141,13
12187,2023-05-23 19:00:00,144,293,5,15,786,562,224,6
12188,2023-05-23 20:00:00,127,273,11,10,513,408,105,5
12189,2023-05-23 21:00:00,126,267,10,16,779,699,80,6
12190,2023-05-23 22:00:00,123,261,14,19,650,542,108,12
12191,2023-05-23 23:00:00,122,260,8,10,772,668,104,6
12192,2023-05-24 00:00:00,149,262,14,16,582,465,117,10
12193,2023-05-24 01:00:00,127,264,8,12,623,478,145,12
12194,2023-05-24 02:00:00,149,282,9,12,551,423,128,8
12195,2023-05-24 03:00:00,143,286,12,16,564,491,73,12
12196,2023-05-24 04:00:00,148,271,7,15,750,606,144,14
12197,2023-05-24 05:00:00,132,285,7,15,516,441,75,11
12198,2023-05-24 06:00:00,139,281,6,15,737,548,189,6
12199,2023-05-24 07:00:00,142,271,11,10,528,475,53,10
12200,2023-05-24 08:00:00,138,250,12,18,726,515,211,6
12201,2023-05-24 09:00:00,129,259,13,14,518,423,95,6
12202,2023-05-24 10:00:00,149,271,13,11,525,450,75,5
12203,2023-05-24 11:00:00,122,269,8,11,674,502,172,11
12204,2023-05-24 12:00:00,137,279,5,12,670,474,196,14
12205,2023-05-24 13:00:00,147,260,9,11,514,388,126,14
12206,2023-05-24 14:00:00,126,261,11,13,759,546,213,14
12207,2023-05-24 15:00:00,130,277,11,11,671,493,178,8
12208,2023-05-24 16:00:00,137,259,6,19,516,400,116,10
12209,2023-05-24 17:00:00,133,287,7,11,748,546,202,7
12210,2023-05-24 18:00:00,136,274,5,18,663,515,148,10
12211,2023-05-24 19:00:00,149,256,8,16,719,631,88,10
12212,2023-05-24 20:00:00,143,263,10,13,599,470,129,13
12213,2023-05-24 21:00:00,139,278,5,16,796,582,214,9
12214,2023-05-24 22:00:00,134,288,5,12,594,448,146,13
12215,2023-05-24 23:00:00,132,290,7,10,570,505,65,10
12216,2023-05-25 00:00:00,122,278,10,19,593,425,168,9
12217,2023-05-25 01:00:00,140,250,7,13,717,574,143,8
12218,2023-05-25 02:00:00,135,283,8,18,673,518,155,7
12219,2023-05-25 03:00:00,134,269,12,14,653,531,122,13
12220,2023-05-25 04:00:00,125,290,10,19,694,568,126,12
12221,2023-05-25 05:00:00,133,267,13,10,739,596,143,5
12222,2023-05-25 06:00:00,123,253,14,11,763,585,178,9
12223,2023-05-25 07:00:00,145,288,7,19,524,367,157,12
12224,2023-05-25 08:00:00,139,290,7,19,633,532,101,12
12225,2023-05-25 09:00:00,143,261,11,18,669,515,154,10
12226,2023-05-25 10:00:00,140,294,5,14,686,494,192,14
12227,2023-05-25 11:00:00,126,261,13,10,622,493,129,9
12228,2023-05-25 12:00:00,140,280,7,19,611,536,75,11
12229,2023-05-25 13:00:00,142,284,6,15,529,380,149,11
12230,2023-05-25 14:00:00,135,257,9,13,621,521,100,10
12231,2023-05-25 15:00:00,144,274,12,16,636,465,171,12
12232,2023-05-25 16:00:00,132,274,6,14,582,409,173,8
12233,2023-05-25 17:00:00,136,254,11,15,703,575,128,14
12234,2023-05-25 18:00:00,123,284,14,14,501,438,63,12
12235,2023-05-25 19:00:00,126,276,11,11,503,385,118,14
12236,2023-05-25 20:00:00,144,266,11,18,758,598,160,11
12237,2023-05-25 21:00:00,147,292,13,16,541,423,118,7
12238,2023-05-25 22:00:00,136,262,6,18,693,529,164,6
12239,2023-05-25 23:00:00,145,294,6,14,543,431,112,7
12240,2023-05-26 00:00:00,126,285,12,11,628,564,64,7
12241,2023-05-26 01:00:00,135,272,13,11,665,571,94,7
12242,2023-05-26 02:00:00,124,295,8,18,516,461,55,5
12243,2023-05-26 03:00:00,146,256,7,16,623,488,135,10
12244,2023-05-26 04:00:00,121,277,10,19,651,545,106,8
12245,2023-05-26 05:00:00,143,280,11,18,610,511,99,13
12246,2023-05-26 06:00:00,125,287,9,17,775,577,198,9
12247,2023-05-26 07:00:00,124,272,14,19,630,511,119,13
12248,2023-05-26 08:00:00,136,278,5,14,595,460,135,9
12249,2023-05-26 09:00:00,120,267,10,13,511,377,134,9
12250,2023-05-26 10:00:00,138,293,6,12,561,423,138,5
12251,2023-05-26 11:00:00,149,288,13,18,755,664,91,6
12252,2023-05-26 12:00:00,145,286,12,14,526,433,93,6
12253,2023-05-26 13:00:00,149,284,11,17,689,610,79,11
12254,2023-05-26 14:00:00,143,250,11,12,775,590,185,9
12255,2023-05-26 15:00:00,132,272,8,11,704,512,192,7
12256,2023-05-26 16:00:00,136,269,6,16,615,497,118,14
12257,2023-05-26 17:00:00,143,251,10,12,651,582,69,10
12258,2023-05-26 18:00:00,130,285,9,17,622,552,70,10
12259,2023-05-26 19:00:00,133,294,7,16,766,682,84,12
12260,2023-05-26 20:00:00,138,273,10,15,594,440,154,9
12261,2023-05-26 21:00:00,130,289,8,16,741,592,149,14
12262,2023-05-26 22:00:00,138,297,10,10,651,579,72,11
12263,2023-05-26 23:00:00,143,260,8,18,737,589,148,9
12264,2023-05-27 00:00:00,141,255,12,17,635,481,154,6
12265,2023-05-27 01:00:00,129,281,14,15,657,479,178,12
12266,2023-05-27 02:00:00,130,261,8,16,640,498,142,11
12267,2023-05-27 03:00:00,120,268,14,12,749,628,121,12
12268,2023-05-27 04:00:00,126,259,14,14,663,537,126,5
12269,2023-05-27 05:00:00,148,278,5,13,553,410,143,5
12270,2023-05-27 06:00:00,146,267,9,17,688,492,196,14
12271,2023-05-27 07:00:00,139,298,12,11,689,522,167,12
12272,2023-05-27 08:00:00,125,255,10,15,685,481,204,10
12273,2023-05-27 09:00:00,140,267,10,17,771,676,95,14
12274,2023-05-27 10:00:00,137,259,13,18,744,587,157,6
12275,2023-05-27 11:00:00,137,295,12,11,656,476,180,10
12276,2023-05-27 12:00:00,146,271,8,13,669,484,185,12
12277,2023-05-27 13:00:00,136,293,13,14,675,510,165,5
12278,2023-05-27 14:00:00,124,297,7,14,666,571,95,7
12279,2023-05-27 15:00:00,143,278,11,14,625,500,125,14
12280,2023-05-27 16:00:00,130,287,10,12,600,503,97,14
12281,2023-05-27 17:00:00,125,258,7,12,603,536,67,9
12282,2023-05-27 18:00:00,125,287,5,18,605,434,171,9
12283,2023-05-27 19:00:00,147,287,11,12,614,461,153,12
12284,2023-05-27 20:00:00,145,270,5,19,743,552,191,8
12285,2023-05-27 21:00:00,145,283,9,13,778,684,94,14
12286,2023-05-27 22:00:00,128,267,6,13,567,451,116,7
12287,2023-05-27 23:00:00,122,284,8,14,598,523,75,8
12288,2023-05-28 00:00:00,140,293,12,18,516,445,71,12
12289,2023-05-28 01:00:00,121,254,8,14,528,438,90,13
12290,2023-05-28 02:00:00,148,290,7,16,504,450,54,10
12291,2023-05-28 03:00:00,139,294,9,13,655,545,110,14
12292,2023-05-28 04:00:00,145,271,6,14,684,485,199,13
12293,2023-05-28 05:00:00,147,287,7,12,692,527,165,13
12294,2023-05-28 06:00:00,142,265,12,12,704,519,185,5
12295,2023-05-28 07:00:00,128,262,6,13,730,517,213,8
12296,2023-05-28 08:00:00,125,252,11,12,719,643,76,12
12297,2023-05-28 09:00:00,122,262,11,14,543,424,119,7
12298,2023-05-28 10:00:00,123,278,11,17,620,462,158,6
12299,2023-05-28 11:00:00,140,267,13,12,542,478,64,6
12300,2023-05-28 12:00:00,130,294,12,19,678,555,123,8
12301,2023-05-28 13:00:00,130,291,7,12,797,577,220,12
12302,2023-05-28 14:00:00,146,280,12,12,554,473,81,7
12303,2023-05-28 15:00:00,122,267,10,16,606,428,178,6
12304,2023-05-28 16:00:00,137,250,11,10,692,566,126,5
12305,2023-05-28 17:00:00,149,260,11,12,515,415,100,12
12306,2023-05-28 18:00:00,134,281,5,18,638,491,147,9
12307,2023-05-28 19:00:00,143,286,13,15,662,566,96,12
12308,2023-05-28 20:00:00,148,264,10,10,581,466,115,13
12309,2023-05-28 21:00:00,139,278,12,10,507,397,110,14
12310,2023-05-28 22:00:00,120,276,8,19,583,430,153,11
12311,2023-05-28 23:00:00,144,250,10,19,697,520,177,10
12312,2023-05-29 00:00:00,128,253,9,18,663,570,93,8
12313,2023-05-29 01:00:00,121,272,14,14,721,608,113,14
12314,2023-05-29 02:00:00,124,264,5,13,699,516,183,6
12315,2023-05-29 03:00:00,120,285,9,18,565,498,67,9
12316,2023-05-29 04:00:00,127,260,11,16,538,391,147,13
12317,2023-05-29 05:00:00,147,257,13,17,500,449,51,8
12318,2023-05-29 06:00:00,145,266,12,13,529,377,152,10
12319,2023-05-29 07:00:00,140,292,9,13,777,645,132,10
12320,2023-05-29 08:00:00,148,262,12,12,662,517,145,8
12321,2023-05-29 09:00:00,136,287,12,16,730,541,189,7
12322,2023-05-29 10:00:00,120,288,6,11,723,528,195,5
12323,2023-05-29 11:00:00,130,257,6,13,766,580,186,8
12324,2023-05-29 12:00:00,128,265,6,12,534,457,77,6
12325,2023-05-29 13:00:00,133,271,12,16,567,398,169,14
12326,2023-05-29 14:00:00,123,250,7,13,566,492,74,9
12327,2023-05-29 15:00:00,134,255,8,12,679,488,191,9
12328,2023-05-29 16:00:00,128,291,13,18,500,441,59,13
12329,2023-05-29 17:00:00,139,274,9,11,509,415,94,8
12330,2023-05-29 18:00:00,124,269,11,12,685,570,115,13
12331,2023-05-29 19:00:00,125,290,12,10,690,563,127,8
12332,2023-05-29 20:00:00,131,268,8,12,603,468,135,7
12333,2023-05-29 21:00:00,124,267,7,10,615,551,64,6
12334,2023-05-29 22:00:00,127,281,10,13,588,446,142,11
12335,2023-05-29 23:00:00,123,281,11,14,706,511,195,11
12336,2023-05-30 00:00:00,145,278,11,16,540,458,82,7
12337,2023-05-30 01:00:00,126,258,7,19,544,470,74,11
12338,2023-05-30 02:00:00,138,286,9,15,686,561,125,8
12339,2023-05-30 03:00:00,138,253,9,11,788,678,110,14
12340,2023-05-30 04:00:00,133,263,11,18,788,586,202,14
12341,2023-05-30 05:00:00,133,270,14,15,548,418,130,14
12342,2023-05-30 06:00:00,141,298,9,11,601,494,107,6
12343,2023-05-30 07:00:00,130,279,13,11,575,498,77,12
12344,2023-05-30 08:00:00,125,275,9,11,585,425,160,5
12345,2023-05-30 09:00:00,132,278,14,12,701,585,116,13
12346,2023-05-30 10:00:00,148,292,11,13,505,440,65,7
12347,2023-05-30 11:00:00,145,252,12,10,525,398,127,13
12348,2023-05-30 12:00:00,146,295,14,18,638,573,65,7
12349,2023-05-30 13:00:00,125,275,8,16,523,466,57,11
12350,2023-05-30 14:00:00,130,295,9,15,594,491,103,12
12351,2023-05-30 15:00:00,124,296,8,12,538,383,155,10
12352,2023-05-30 16:00:00,137,296,9,14,514,458,56,14
12353,2023-05-30 17:00:00,125,258,6,17,751,608,143,14
12354,2023-05-30 18:00:00,122,280,12,16,742,525,217,14
12355,2023-05-30 19:00:00,126,261,12,18,735,639,96,13
12356,2023-05-30 20:00:00,140,284,5,14,739,535,204,8
12357,2023-05-30 21:00:00,143,261,9,17,506,441,65,6
12358,2023-05-30 22:00:00,136,299,5,18,551,423,128,12
12359,2023-05-30 23:00:00,139,258,14,13,725,507,218,8
12360,2023-05-31 00:00:00,127,260,11,17,702,563,139,11
12361,2023-05-31 01:00:00,149,263,6,18,714,589,125,9
12362,2023-05-31 02:00:00,132,266,5,17,582,488,94,5
12363,2023-05-31 03:00:00,147,267,13,18,557,430,127,13
12364,2023-05-31 04:00:00,123,269,9,19,502,436,66,14
12365,2023-05-31 05:00:00,144,295,14,11,660,585,75,14
12366,2023-05-31 06:00:00,137,255,13,12,532,387,145,14
12367,2023-05-31 07:00:00,132,284,12,13,629,440,189,6
12368,2023-05-31 08:00:00,122,257,13,18,724,611,113,9
12369,2023-05-31 09:00:00,137,250,13,16,673,542,131,6
12370,2023-05-31 10:00:00,143,262,11,10,658,587,71,7
12371,2023-05-31 11:00:00,143,262,8,18,514,409,105,6
12372,2023-05-31 12:00:00,141,255,7,11,515,380,135,8
12373,2023-05-31 13:00:00,124,281,14,10,774,657,117,6
12374,2023-05-31 14:00:00,144,264,6,19,520,457,63,5
12375,2023-05-31 15:00:00,128,261,9,16,520,458,62,12
12376,2023-05-31 16:00:00,121,295,10,15,590,470,120,6
12377,2023-05-31 17:00:00,142,250,10,18,512,458,54,7
12378,2023-05-31 18:00:00,147,284,13,17,638,483,155,14
12379,2023-05-31 19:00:00,125,276,8,11,555,476,79,8
12380,2023-05-31 20:00:00,146,267,10,15,743,595,148,13
12381,2023-05-31 21:00:00,146,259,9,13,698,509,189,14
12382,2023-05-31 22:00:00,131,251,8,15,536,377,159,13
12383,2023-05-31 23:00:00,146,251,13,17,652,535,117,12
12384,2023-06-01 00:00:00,135,283,5,18,744,550,194,13
12385,2023-06-01 01:00:00,121,269,14,13,732,644,88,5
12386,2023-06-01 02:00:00,126,279,5,10,654,544,110,5
12387,2023-06-01 03:00:00,138,285,8,19,657,576,81,10
12388,2023-06-01 04:00:00,135,273,12,10,608,437,171,13
12389,2023-06-01 05:00:00,126,252,7,16,632,559,73,10
12390,2023-06-01 06:00:00,122,261,11,11,563,415,148,7
12391,2023-06-01 07:00:00,140,294,7,14,731,601,130,6
12392,2023-06-01 08:00:00,149,290,9,15,574,489,85,9
12393,2023-06-01 09:00:00,133,276,8,13,777,613,164,10
12394,2023-06-01 10:00:00,126,292,6,12,721,561,160,7
12395,2023-06-01 11:00:00,148,293,9,15,585,442,143,10
12396,2023-06-01 12:00:00,148,262,12,18,541,458,83,14
12397,2023-06-01 13:00:00,127,265,7,14,566,397,169,6
12398,2023-06-01 14:00:00,126,296,14,19,575,417,158,13
12399,2023-06-01 15:00:00,125,250,5,19,673,562,111,5
12400,2023-06-01 16:00:00,135,261,14,18,657,542,115,14
12401,2023-06-01 17:00:00,142,298,13,10,731,588,143,6
12402,2023-06-01 18:00:00,136,275,9,17,786,607,179,14
12403,2023-06-01 19:00:00,136,285,11,16,538,432,106,9
12404,2023-06-01 20:00:00,143,254,8,16,715,579,136,5
12405,2023-06-01 21:00:00,123,265,5,10,599,431,168,6
12406,2023-06-01 22:00:00,131,258,5,12,632,443,189,5
12407,2023-06-01 23:00:00,120,260,14,18,725,569,156,10
12408,2023-06-02 00:00:00,142,294,9,14,772,682,90,6
12409,2023-06-02 01:00:00,149,279,13,10,726,589,137,11
12410,2023-06-02 02:00:00,144,298,10,13,781,679,102,8
12411,2023-06-02 03:00:00,135,271,14,15,572,412,160,8
12412,2023-06-02 04:00:00,131,292,12,11,552,481,71,12
12413,2023-06-02 05:00:00,126,275,12,16,594,486,108,6
12414,2023-06-02 06:00:00,135,270,11,13,765,666,99,13
12415,2023-06-02 07:00:00,128,251,9,12,726,531,195,6
12416,2023-06-02 08:00:00,141,258,5,16,642,558,84,8
12417,2023-06-02 09:00:00,138,277,6,13,789,640,149,6
12418,2023-06-02 10:00:00,125,274,8,17,760,577,183,5
12419,2023-06-02 11:00:00,142,272,10,16,729,613,116,14
12420,2023-06-02 12:00:00,132,262,10,12,655,478,177,14
12421,2023-06-02 13:00:00,146,290,9,14,568,480,88,10
12422,2023-06-02 14:00:00,121,273,5,10,629,441,188,8
12423,2023-06-02 15:00:00,147,270,6,14,739,598,141,8
12424,2023-06-02 16:00:00,124,289,5,15,508,442,66,8
12425,2023-06-02 17:00:00,120,293,12,14,766,661,105,14
12426,2023-06-02 18:00:00,147,290,14,10,745,631,114,6
12427,2023-06-02 19:00:00,135,289,14,10,690,488,202,11
12428,2023-06-02 20:00:00,126,293,10,17,540,409,131,6
12429,2023-06-02 21:00:00,137,258,7,14,758,642,116,6
12430,2023-06-02 22:00:00,130,272,10,15,664,523,141,13
12431,2023-06-02 23:00:00,136,271,10,13,502,418,84,7
12432,2023-06-03 00:00:00,128,297,14,17,608,488,120,12
12433,2023-06-03 01:00:00,138,265,7,11,531,379,152,12
12434,2023-06-03 02:00:00,142,257,7,19,660,562,98,12
12435,2023-06-03 03:00:00,135,265,8,15,579,497,82,8
12436,2023-06-03 04:00:00,139,288,12,14,583,424,159,5
12437,2023-06-03 05:00:00,132,292,8,12,707,533,174,13
12438,2023-06-03 06:00:00,126,279,5,19,625,447,178,8
12439,2023-06-03 07:00:00,134,283,12,12,514,369,145,11
12440,2023-06-03 08:00:00,129,254,11,17,715,523,192,8
12441,2023-06-03 09:00:00,137,265,14,13,505,378,127,13
12442,2023-06-03 10:00:00,142,271,10,11,779,698,81,14
12443,2023-06-03 11:00:00,127,260,11,12,708,590,118,7
12444,2023-06-03 12:00:00,137,299,12,10,753,532,221,6
12445,2023-06-03 13:00:00,128,254,9,10,769,639,130,11
12446,2023-06-03 14:00:00,122,279,6,17,643,531,112,14
12447,2023-06-03 15:00:00,149,250,10,10,775,645,130,8
12448,2023-06-03 16:00:00,120,296,13,19,668,509,159,12
12449,2023-06-03 17:00:00,127,262,14,11,752,572,180,5
12450,2023-06-03 18:00:00,127,262,9,19,782,598,184,6
12451,2023-06-03 19:00:00,148,289,12,15,703,575,128,5
12452,2023-06-03 20:00:00,129,289,11,12,507,372,135,7
12453,2023-06-03 21:00:00,145,272,8,19,530,396,134,10
12454,2023-06-03 22:00:00,139,290,6,17,749,629,120,13
12455,2023-06-03 23:00:00,122,280,9,16,701,524,177,9
12456,2023-06-04 00:00:00,131,291,6,18,542,429,113,14
12457,2023-06-04 01:00:00,147,275,11,18,609,508,101,13
12458,2023-06-04 02:00:00,138,258,11,16,532,372,160,9
12459,2023-06-04 03:00:00,121,269,7,10,689,558,131,8
12460,2023-06-04 04:00:00,141,299,12,15,719,599,120,11
12461,2023-06-04 05:00:00,134,288,14,11,584,416,168,6
12462,2023-06-04 06:00:00,129,250,12,13,677,526,151,10
12463,2023-06-04 07:00:00,143,296,12,12,532,419,113,7
12464,2023-06-04 08:00:00,125,267,11,17,538,408,130,10
12465,2023-06-04 09:00:00,124,266,7,18,606,441,165,5
12466,2023-06-04 10:00:00,142,279,8,12,735,659,76,9
12467,2023-06-04 11:00:00,121,292,11,16,674,520,154,11
12468,2023-06-04 12:00:00,132,289,7,17,665,468,197,6
12469,2023-06-04 13:00:00,130,283,9,11,551,428,123,7
12470,2023-06-04 14:00:00,139,276,6,10,711,630,81,13
12471,2023-06-04 15:00:00,147,299,10,17,608,541,67,6
12472,2023-06-04 16:00:00,146,280,11,13,503,436,67,13
12473,2023-06-04 17:00:00,142,299,8,16,545,489,56,13
12474,2023-06-04 18:00:00,129,252,11,11,604,473,131,14
12475,2023-06-04 19:00:00,120,275,8,18,755,562,193,11
12476,2023-06-04 20:00:00,133,273,12,11,533,470,63,8
12477,2023-06-04 21:00:00,137,273,8,18,794,686,108,11
12478,2023-06-04 22:00:00,125,281,10,10,589,518,71,9
12479,2023-06-04 23:00:00,141,252,5,13,541,409,132,10
12480,2023-06-05 00:00:00,130,258,9,18,548,464,84,14
12481,2023-06-05 01:00:00,124,260,6,10,607,444,163,13
12482,2023-06-05 02:00:00,133,297,11,14,736,600,136,10
12483,2023-06-05 03:00:00,138,264,14,10,632,452,180,9
12484,2023-06-05 04:00:00,125,280,9,18,544,401,143,5
12485,2023-06-05 05:00:00,130,270,6,13,735,629,106,9
12486,2023-06-05 06:00:00,130,268,5,12,561,499,62,7
12487,2023-06-05 07:00:00,131,264,13,13,680,581,99,11
12488,2023-06-05 08:00:00,120,266,11,18,578,473,105,6
12489,2023-06-05 09:00:00,134,266,6,13,600,532,68,14
12490,2023-06-05 10:00:00,148,251,11,14,513,448,65,11
12491,2023-06-05 11:00:00,132,288,11,19,674,577,97,12
12492,2023-06-05 12:00:00,145,264,6,15,745,561,184,12
12493,2023-06-05 13:00:00,143,275,14,12,602,458,144,6
12494,2023-06-05 14:00:00,135,294,6,17,530,386,144,7
12495,2023-06-05 15:00:00,134,264,13,13,740,566,174,5
12496,2023-06-05 16:00:00,136,263,13,14,514,441,73,13
12497,2023-06-05 17:00:00,125,292,12,18,705,516,189,9
12498,2023-06-05 18:00:00,121,262,10,19,758,648,110,12
12499,2023-06-05 19:00:00,135,288,9,12,506,420,86,12
12500,2023-06-05 20:00:00,123,273,6,19,593,434,159,7
12501,2023-06-05 21:00:00,120,269,5,14,585,481,104,7
12502,2023-06-05 22:00:00,137,292,6,17,522,371,151,13
12503,2023-06-05 23:00:00,138,263,8,19,758,621,137,5
12504,2023-06-06 00:00:00,149,293,7,11,746,558,188,5
12505,2023-06-06 01:00:00,129,269,9,14,711,550,161,11
12506,2023-06-06 02:00:00,143,284,12,10,685,546,139,13
12507,2023-06-06 03:00:00,138,285,14,13,636,562,74,9
12508,2023-06-06 04:00:00,145,258,12,16,643,505,138,10
12509,2023-06-06 05:00:00,123,281,5,16,732,629,103,8
12510,2023-06-06 06:00:00,125,251,6,15,775,587,188,5
12511,2023-06-06 07:00:00,144,283,11,15,748,538,210,14
12512,2023-06-06 08:00:00,144,297,8,13,738,647,91,14
12513,2023-06-06 09:00:00,125,295,7,15,506,454,52,8
12514,2023-06-06 10:00:00,126,281,8,15,784,625,159,11
12515,2023-06-06 11:00:00,141,296,12,19,535,445,90,11
12516,2023-06-06 12:00:00,124,250,6,19,609,450,159,11
12517,2023-06-06 13:00:00,143,261,13,17,744,553,191,10
12518,2023-06-06 14:00:00,126,259,7,19,532,462,70,6
12519,2023-06-06 15:00:00,128,260,10,15,636,517,119,11
12520,2023-06-06 16:00:00,121,299,13,11,552,425,127,13
12521,2023-06-06 17:00:00,120,281,10,10,550,451,99,7
12522,2023-06-06 18:00:00,148,260,12,15,582,510,72,6
12523,2023-06-06 19:00:00,147,286,5,14,615,460,155,11
12524,2023-06-06 20:00:00,135,282,8,19,743,586,157,9
12525,2023-06-06 21:00:00,138,292,7,14,715,553,162,6
12526,2023-06-06 22:00:00,125,267,7,17,619,453,166,14
12527,2023-06-06 23:00:00,120,287,13,17,713,514,199,6
12528,2023-06-07 00:00:00,148,263,8,16,632,458,174,14
12529,2023-06-07 01:00:00,126,257,6,10,763,686,77,13
12530,2023-06-07 02:00:00,136,294,14,15,527,400,127,5
12531,2023-06-07 03:00:00,134,272,7,15,730,594,136,5
12532,2023-06-07 04:00:00,148,290,6,12,728,531,197,9
12533,2023-06-07 05:00:00,140,270,12,15,561,427,134,5
12534,2023-06-07 06:00:00,128,295,10,13,780,649,131,9
12535,2023-06-07 07:00:00,126,265,12,19,768,669,99,14
12536,2023-06-07 08:00:00,128,265,8,19,748,658,90,5
12537,2023-06-07 09:00:00,136,282,10,19,525,383,142,14
12538,2023-06-07 10:00:00,132,252,7,18,606,471,135,8
12539,2023-06-07 11:00:00,120,287,13,18,741,659,82,11
12540,2023-06-07 12:00:00,121,270,7,12,730,511,219,12
12541,2023-06-07 13:00:00,121,255,10,16,519,441,78,13
12542,2023-06-07 14:00:00,135,257,13,16,606,430,176,6
12543,2023-06-07 15:00:00,133,280,8,15,500,362,138,14
12544,2023-06-07 16:00:00,129,281,11,14,586,450,136,14
12545,2023-06-07 17:00:00,126,272,12,14,742,649,93,5
12546,2023-06-07 18:00:00,137,299,13,15,575,435,140,10
12547,2023-06-07 19:00:00,148,256,8,15,501,431,70,12
12548,2023-06-07 20:00:00,131,277,7,14,636,504,132,7
12549,2023-06-07 21:00:00,136,280,7,13,574,498,76,14
12550,2023-06-07 22:00:00,133,277,7,18,623,481,142,8
12551,2023-06-07 23:00:00,125,297,12,10,767,618,149,12
12552,2023-06-08 00:00:00,125,258,11,16,504,369,135,10
12553,2023-06-08 01:00:00,134,299,8,16,537,413,124,14
12554,2023-06-08 02:00:00,120,262,10,11,689,607,82,5
12555,2023-06-08 03:00:00,135,253,7,11,581,484,97,7
12556,2023-06-08 04:00:00,125,299,11,19,758,564,194,7
12557,2023-06-08 05:00:00,129,254,5,15,694,514,180,6
12558,2023-06-08 06:00:00,136,255,12,14,553,408,145,10
12559,2023-06-08 07:00:00,128,283,8,18,788,601,187,8
12560,2023-06-08 08:00:00,133,285,8,10,755,639,116,7
12561,2023-06-08 09:00:00,125,255,10,15,530,469,61,5
12562,2023-06-08 10:00:00,140,266,13,13,664,515,149,13
12563,2023-06-08 11:00:00,141,291,7,13,528,391,137,14
12564,2023-06-08 12:00:00,135,289,14,11,526,457,69,13
12565,2023-06-08 13:00:00,134,260,7,11,561,461,100,13
12566,2023-06-08 14:00:00,143,289,5,15,593,496,97,12
12567,2023-06-08 15:00:00,134,275,7,19,689,588,101,12
12568,2023-06-08 16:00:00,124,259,11,18,715,633,82,7
12569,2023-06-08 17:00:00,126,285,5,19,638,464,174,14
12570,2023-06-08 18:00:00,139,266,11,15,707,587,120,7
12571,2023-06-08 19:00:00,128,273,7,11,606,465,141,9
12572,2023-06-08 20:00:00,144,275,6,19,744,539,205,8
12573,2023-06-08 21:00:00,122,297,9,15,550,429,121,13
12574,2023-06-08 22:00:00,137,273,11,16,659,481,178,11
12575,2023-06-08 23:00:00,140,250,6,19,655,583,72,5
12576,2023-06-09 00:00:00,126,251,9,13,703,632,71,5
12577,2023-06-09 01:00:00,131,266,11,17,687,526,161,5
12578,2023-06-09 02:00:00,145,278,13,12,711,633,78,8
12579,2023-06-09 03:00:00,135,257,11,19,551,455,96,8
12580,2023-06-09 04:00:00,134,273,6,15,591,422,169,5
12581,2023-06-09 05:00:00,128,299,12,18,731,629,102,9
12582,2023-06-09 06:00:00,136,285,8,17,669,472,197,8
12583,2023-06-09 07:00:00,149,265,12,16,772,595,177,5
12584,2023-06-09 08:00:00,149,290,12,17,565,481,84,5
12585,2023-06-09 09:00:00,121,275,5,18,733,610,123,5
12586,2023-06-09 10:00:00,143,256,13,10,772,546,226,7
12587,2023-06-09 11:00:00,140,262,14,15,560,485,75,12
12588,2023-06-09 12:00:00,149,291,13,16,711,570,141,14
12589,2023-06-09 13:00:00,139,297,13,18,791,652,139,11
12590,2023-06-09 14:00:00,123,292,8,10,579,428,151,9
12591,2023-06-09 15:00:00,128,298,8,16,663,482,181,7
12592,2023-06-09 16:00:00,146,283,12,18,765,588,177,10
12593,2023-06-09 17:00:00,124,293,7,12,795,699,96,5
12594,2023-06-09 18:00:00,145,289,12,11,691,495,196,12
12595,2023-06-09 19:00:00,131,284,7,17,706,525,181,12
12596,2023-06-09 20:00:00,127,270,6,13,609,445,164,10
12597,2023-06-09 21:00:00,122,254,5,16,745,599,146,5
12598,2023-06-09 22:00:00,126,299,5,10,747,652,95,14
12599,2023-06-09 23:00:00,134,281,10,19,558,472,86,6
12600,2023-06-10 00:00:00,139,256,11,18,576,467,109,5
12601,2023-06-10 01:00:00,122,271,8,17,595,515,80,10
12602,2023-06-10 02:00:00,149,284,10,19,530,407,123,7
12603,2023-06-10 03:00:00,137,277,14,15,787,649,138,9
12604,2023-06-10 04:00:00,131,255,5,14,624,485,139,7
12605,2023-06-10 05:00:00,122,297,10,14,581,473,108,11
12606,2023-06-10 06:00:00,142,271,11,10,594,478,116,12
12607,2023-06-10 07:00:00,128,255,10,11,769,659,110,11
12608,2023-06-10 08:00:00,141,260,9,13,614,468,146,7
12609,2023-06-10 09:00:00,143,277,11,10,520,462,58,7
12610,2023-06-10 10:00:00,127,283,6,13,785,687,98,7
12611,2023-06-10 11:00:00,130,288,13,17,650,577,73,12
12612,2023-06-10 12:00:00,130,292,14,10,508,399,109,8
12613,2023-06-10 13:00:00,130,294,13,14,562,495,67,6
12614,2023-06-10 14:00:00,123,260,8,13,725,514,211,5
12615,2023-06-10 15:00:00,139,288,8,12,570,446,124,14
12616,2023-06-10 16:00:00,120,293,8,16,500,378,122,12
12617,2023-06-10 17:00:00,128,286,5,15,626,483,143,5
12618,2023-06-10 18:00:00,120,278,14,10,565,488,77,8
12619,2023-06-10 19:00:00,136,288,9,13,649,478,171,7
12620,2023-06-10 20:00:00,126,260,7,12,692,514,178,6
12621,2023-06-10 21:00:00,125,284,5,12,557,409,148,11
12622,2023-06-10 22:00:00,142,298,14,13,676,591,85,9
12623,2023-06-10 23:00:00,146,275,5,10,683,549,134,7
12624,2023-06-11 00:00:00,142,284,7,11,558,441,117,6
12625,2023-06-11 01:00:00,146,265,13,17,500,399,101,14
12626,2023-06-11 02:00:00,120,277,7,13,561,425,136,10
12627,2023-06-11 03:00:00,134,250,6,14,762,664,98,9
12628,2023-06-11 04:00:00,131,279,9,16,719,628,91,9
12629,2023-06-11 05:00:00,128,299,7,10,638,530,108,7
12630,2023-06-11 06:00:00,121,263,7,13,703,517,186,7
12631,2023-06-11 07:00:00,137,291,11,18,529,441,88,14
12632,2023-06-11 08:00:00,147,257,7,10,705,530,175,7
12633,2023-06-11 09:00:00,147,257,7,10,568,467,101,5
12634,2023-06-11 10:00:00,123,299,11,12,500,373,127,9
12635,2023-06-11 11:00:00,141,254,6,12,684,492,192,7
12636,2023-06-11 12:00:00,124,260,10,14,530,474,56,6
12637,2023-06-11 13:00:00,126,279,13,10,528,430,98,11
12638,2023-06-11 14:00:00,143,285,11,15,624,525,99,10
12639,2023-06-11 15:00:00,129,257,5,17,545,402,143,14
12640,2023-06-11 16:00:00,125,258,9,14,680,512,168,14
12641,2023-06-11 17:00:00,121,278,13,10,764,553,211,12
12642,2023-06-11 18:00:00,124,276,8,17,510,405,105,7
12643,2023-06-11 19:00:00,144,295,7,12,563,398,165,14
12644,2023-06-11 20:00:00,143,284,7,11,545,422,123,7
12645,2023-06-11 21:00:00,136,256,7,14,652,572,80,12
12646,2023-06-11 22:00:00,128,279,13,18,729,511,218,8
12647,2023-06-11 23:00:00,140,264,6,10,546,479,67,10
12648,2023-06-12 00:00:00,127,258,6,14,502,408,94,6
12649,2023-06-12 01:00:00,130,290,7,18,513,376,137,5
12650,2023-06-12 02:00:00,143,263,6,14,723,599,124,12
12651,2023-06-12 03:00:00,123,260,11,13,681,483,198,14
12652,2023-06-12 04:00:00,149,286,8,10,671,493,178,13
12653,2023-06-12 05:00:00,142,272,13,16,664,522,142,7
12654,2023-06-12 06:00:00,144,281,14,11,750,563,187,11
12655,2023-06-12 07:00:00,123,251,11,18,760,599,161,11
12656,2023-06-12 08:00:00,133,257,7,19,540,480,60,6
12657,2023-06-12 09:00:00,131,258,6,13,557,447,110,13
12658,2023-06-12 10:00:00,125,259,12,15,718,547,171,6
12659,2023-06-12 11:00:00,124,273,10,12,609,501,108,5
12660,2023-06-12 12:00:00,147,257,11,10,701,597,104,8
12661,2023-06-12 13:00:00,149,263,10,18,573,420,153,12
12662,2023-06-12 14:00:00,132,279,11,11,602,442,160,11
12663,2023-06-12 15:00:00,138,291,12,13,602,482,120,8
12664,2023-06-12 16:00:00,133,287,13,18,508,443,65,12
12665,2023-06-12 17:00:00,144,263,14,15,785,635,150,13
12666,2023-06-12 18:00:00,125,256,7,18,587,494,93,5
12667,2023-06-12 19:00:00,144,285,9,10,504,394,110,8
12668,2023-06-12 20:00:00,127,278,7,14,632,502,130,7
12669,2023-06-12 21:00:00,126,265,10,19,547,401,146,11
12670,2023-06-12 22:00:00,126,258,6,15,708,515,193,13
12671,2023-06-12 23:00:00,142,260,6,12,534,435,99,13
12672,2023-06-13 00:00:00,132,255,13,17,764,602,162,10
12673,2023-06-13 01:00:00,130,260,12,14,640,520,120,9
12674,2023-06-13 02:00:00,147,296,12,12,653,574,79,7
12675,2023-06-13 03:00:00,133,250,7,12,503,360,143,8
12676,2023-06-13 04:00:00,145,284,11,13,795,628,167,7
12677,2023-06-13 05:00:00,129,255,6,12,531,476,55,14
12678,2023-06-13 06:00:00,137,287,11,14,629,513,116,11
12679,2023-06-13 07:00:00,122,271,11,18,733,638,95,14
12680,2023-06-13 08:00:00,144,284,9,18,783,688,95,5
12681,2023-06-13 09:00:00,135,251,14,13,651,486,165,7
12682,2023-06-13 10:00:00,121,274,11,11,681,482,199,9
12683,2023-06-13 11:00:00,130,262,13,10,520,375,145,10
12684,2023-06-13 12:00:00,147,288,7,11,694,532,162,8
12685,2023-06-13 13:00:00,130,286,9,19,522,446,76,11
12686,2023-06-13 14:00:00,143,269,14,10,662,474,188,12
12687,2023-06-13 15:00:00,125,263,13,11,797,703,94,11
12688,2023-06-13 16:00:00,145,292,11,11,595,477,118,8
12689,2023-06-13 17:00:00,139,282,12,13,606,503,103,5
12690,2023-06-13 18:00:00,137,275,9,10,570,460,110,12
12691,2023-06-13 19:00:00,126,255,12,15,519,382,137,11
12692,2023-06-13 20:00:00,144,258,12,13,747,650,97,14
12693,2023-06-13 21:00:00,134,281,5,11,592,491,101,9
12694,2023-06-13 22:00:00,135,287,13,11,546,440,106,7
12695,2023-06-13 23:00:00,138,252,13,14,555,441,114,8
12696,2023-06-14 00:00:00,144,291,14,11,561,445,116,13
12697,2023-06-14 01:00:00,126,295,10,15,669,518,151,5
12698,2023-06-14 02:00:00,149,295,10,16,581,477,104,10
12699,2023-06-14 03:00:00,124,253,8,19,673,598,75,8
12700,2023-06-14 04:00:00,129,281,10,12,526,374,152,5
12701,2023-06-14 05:00:00,120,272,10,19,612,480,132,8
12702,2023-06-14 06:00:00,144,263,12,14,627,539,88,13
12703,2023-06-14 07:00:00,133,261,11,13,764,621,143,10
12704,2023-06-14 08:00:00,138,292,12,19,793,588,205,14
12705,2023-06-14 09:00:00,127,251,14,13,589,469,120,13
12706,2023-06-14 10:00:00,136,261,7,11,724,520,204,11
12707,2023-06-14 11:00:00,147,253,7,17,654,479,175,9
12708,2023-06-14 12:00:00,132,281,6,19,591,520,71,9
12709,2023-06-14 13:00:00,134,269,7,10,783,578,205,12
12710,2023-06-14 14:00:00,141,273,9,17,712,526,186,12
12711,2023-06-14 15:00:00,138,280,10,14,657,529,128,8
12712,2023-06-14 16:00:00,131,269,7,18,512,448,64,9
12713,2023-06-14 17:00:00,125,273,11,15,527,460,67,6
12714,2023-06-14 18:00:00,120,292,5,10,506,377,129,10
12715,2023-06-14 19:00:00,123,277,11,12,743,540,203,13
12716,2023-06-14 20:00:00,123,256,7,19,648,523,125,8
12717,2023-06-14 21:00:00,140,297,5,15,647,454,193,8
12718,2023-06-14 22:00:00,136,261,11,17,701,599,102,7
12719,2023-06-14 23:00:00,144,268,14,18,503,411,92,10
12720,2023-06-15 00:00:00,139,297,13,10,548,461,87,9
12721,2023-06-15 01:00:00,147,266,9,19,562,486,76,13
12722,2023-06-15 02:00:00,146,297,6,10,767,615,152,7
12723,2023-06-15 03:00:00,145,293,14,15,503,380,123,7
12724,2023-06-15 04:00:00,136,267,12,15,750,609,141,5
12725,2023-06-15 05:00:00,148,261,14,16,672,499,173,14
12726,2023-06-15 06:00:00,138,260,6,16,796,564,232,14
12727,2023-06-15 07:00:00,132,270,11,14,693,505,188,8
12728,2023-06-15 08:00:00,138,272,10,18,524,374,150,13
12729,2023-06-15 09:00:00,123,284,9,18,627,556,71,13
12730,2023-06-15 10:00:00,124,299,9,15,719,617,102,11
12731,2023-06-15 11:00:00,131,260,7,15,582,433,149,8
12732,2023-06-15 12:00:00,126,270,6,18,584,463,121,6
12733,2023-06-15 13:00:00,141,258,8,12,548,454,94,5
12734,2023-06-15 14:00:00,121,299,10,19,615,528,87,12
12735,2023-06-15 15:00:00,143,254,11,12,610,527,83,8
12736,2023-06-15 16:00:00,124,277,12,13,699,493,206,11
12737,2023-06-15 17:00:00,137,258,6,15,678,599,79,13
12738,2023-06-15 18:00:00,148,286,10,15,610,488,122,6
12739,2023-06-15 19:00:00,140,280,8,13,643,473,170,7
12740,2023-06-15 20:00:00,144,276,11,16,634,482,152,7
12741,2023-06-15 21:00:00,147,283,5,12,606,431,175,11
12742,2023-06-15 22:00:00,144,252,8,14,776,590,186,12
12743,2023-06-15 23:00:00,147,271,10,13,782,644,138,10
12744,2023-06-16 00:00:00,122,256,6,16,648,574,74,9
12745,2023-06-16 01:00:00,136,285,6,15,628,460,168,5
12746,2023-06-16 02:00:00,149,277,10,10,543,433,110,14
12747,2023-06-16 03:00:00,137,297,14,14,775,614,161,12
12748,2023-06-16 04:00:00,139,264,10,10,727,598,129,6
12749,2023-06-16 05:00:00,143,270,12,16,733,520,213,6
12750,2023-06-16 06:00:00,145,270,8,10,786,702,84,11
12751,2023-06-16 07:00:00,128,299,6,12,530,386,144,13
12752,2023-06-16 08:00:00,132,283,5,15,609,530,79,12
12753,2023-06-16 09:00:00,131,263,10,18,624,488,136,12
12754,2023-06-16 10:00:00,126,266,14,10,502,390,112,12
12755,2023-06-16 11:00:00,124,262,6,16,542,462,80,11
12756,2023-06-16 12:00:00,133,272,10,16,552,473,79,12
12757,2023-06-16 13:00:00,132,264,11,13,738,574,164,13
12758,2023-06-16 14:00:00,129,271,12,13,716,501,215,5
12759,2023-06-16 15:00:00,131,294,11,13,527,452,75,6
12760,2023-06-16 16:00:00,136,259,12,16,651,545,106,13
12761,2023-06-16 17:00:00,141,265,8,11,764,594,170,11
12762,2023-06-16 18:00:00,129,277,9,16,772,656,116,6
12763,2023-06-16 19:00:00,130,287,7,18,684,544,140,12
12764,2023-06-16 20:00:00,145,291,11,11,503,388,115,12
12765,2023-06-16 21:00:00,126,257,9,19,673,589,84,14
12766,2023-06-16 22:00:00,123,295,5,17,793,563,230,11
12767,2023-06-16 23:00:00,138,293,13,12,657,560,97,14
12768,2023-06-17 00:00:00,149,254,10,18,652,581,71,7
12769,2023-06-17 01:00:00,143,297,12,10,563,412,151,14
12770,2023-06-17 02:00:00,126,289,7,10,694,515,179,14
12771,2023-06-17 03:00:00,148,262,14,18,549,416,133,12
12772,2023-06-17 04:00:00,130,290,9,19,743,616,127,11
12773,2023-06-17 05:00:00,138,270,5,12,629,517,112,7
12774,2023-06-17 06:00:00,142,250,12,18,510,381,129,7
12775,2023-06-17 07:00:00,147,259,10,19,561,401,160,5
12776,2023-06-17 08:00:00,130,283,9,14,602,449,153,9
12777,2023-06-17 09:00:00,148,277,12,16,683,591,92,10
12778,2023-06-17 10:00:00,129,288,9,11,748,670,78,6
12779,2023-06-17 11:00:00,142,268,10,11,713,548,165,8
12780,2023-06-17 12:00:00,139,270,13,16,789,642,147,5
12781,2023-06-17 13:00:00,142,284,12,17,641,473,168,7
12782,2023-06-17 14:00:00,149,296,7,17,511,414,97,12
12783,2023-06-17 15:00:00,126,286,9,14,680,576,104,14
12784,2023-06-17 16:00:00,135,271,13,11,679,554,125,6
12785,2023-06-17 17:00:00,137,263,12,16,734,633,101,6
12786,2023-06-17 18:00:00,133,284,8,15,754,556,198,5
12787,2023-06-17 19:00:00,126,288,5,18,510,362,148,5
12788,2023-06-17 20:00:00,124,292,8,12,718,524,194,9
12789,2023-06-17 21:00:00,140,286,14,13,641,518,123,8
12790,2023-06-17 22:00:00,134,273,14,11,734,552,182,11
12791,2023-06-17 23:00:00,136,263,9,13,715,643,72,10
12792,2023-06-18 00:00:00,135,278,13,17,511,394,117,9
12793,2023-06-18 01:00:00,141,263,7,10,616,471,145,9
12794,2023-06-18 02:00:00,132,260,12,15,669,491,178,6
12795,2023-06-18 03:00:00,136,279,13,18,693,551,142,6
12796,2023-06-18 04:00:00,124,266,7,18,619,528,91,9
12797,2023-06-18 05:00:00,127,274,11,18,522,422,100,11
12798,2023-06-18 06:00:00,134,285,9,19,567,442,125,10
12799,2023-06-18 07:00:00,145,259,11,16,641,551,90,7
12800,2023-06-18 08:00:00,142,269,11,11,794,711,83,11
12801,2023-06-18 09:00:00,145,296,7,12,616,479,137,12
12802,2023-06-18 10:00:00,127,282,7,11,772,666,106,11
12803,2023-06-18 11:00:00,138,274,6,14,675,521,154,12
12804,2023-06-18 12:00:00,126,288,13,18,604,450,154,5
12805,2023-06-18 13:00:00,148,288,9,19,794,708,86,11
12806,2023-06-18 14:00:00,126,281,6,17,645,515,130,11
12807,2023-06-18 15:00:00,149,278,13,12,664,559,105,8
12808,2023-06-18 16:00:00,133,267,11,14,516,428,88,12
12809,2023-06-18 17:00:00,122,298,12,17,574,492,82,8
12810,2023-06-18 18:00:00,121,259,13,12,585,500,85,9
12811,2023-06-18 19:00:00,143,282,9,13,555,450,105,8
12812,2023-06-18 20:00:00,140,276,12,13,789,601,188,7
12813,2023-06-18 21:00:00,140,289,13,13,549,415,134,9
12814,2023-06-18 22:00:00,146,298,6,10,690,511,179,9
12815,2023-06-18 23:00:00,133,297,7,14,644,528,116,10
12816,2023-06-19 00:00:00,143,260,8,10,734,608,126,12
12817,2023-06-19 01:00:00,142,282,10,17,710,619,91,14
12818,2023-06-19 02:00:00,145,280,12,16,648,503,145,7
12819,2023-06-19 03:00:00,128,251,8,11,684,522,162,8
12820,2023-06-19 04:00:00,145,250,11,14,542,442,100,10
12821,2023-06-19 05:00:00,123,261,11,18,798,660,138,13
12822,2023-06-19 06:00:00,147,268,9,14,725,618,107,7
12823,2023-06-19 07:00:00,142,259,7,16,775,549,226,14
12824,2023-06-19 08:00:00,130,286,6,14,604,493,111,14
12825,2023-06-19 09:00:00,147,253,10,17,586,424,162,10
12826,2023-06-19 10:00:00,139,287,5,14,611,536,75,6
12827,2023-06-19 11:00:00,146,278,7,11,510,393,117,5
12828,2023-06-19 12:00:00,122,298,13,15,584,452,132,5
12829,2023-06-19 13:00:00,139,290,14,19,533,407,126,11
12830,2023-06-19 14:00:00,139,268,10,13,561,433,128,8
12831,2023-06-19 15:00:00,124,286,7,10,756,543,213,10
12832,2023-06-19 16:00:00,124,268,11,13,796,705,91,7
12833,2023-06-19 17:00:00,124,279,13,18,799,646,153,9
12834,2023-06-19 18:00:00,132,276,12,16,704,533,171,12
12835,2023-06-19 19:00:00,144,268,10,15,748,526,222,12
12836,2023-06-19 20:00:00,120,252,6,19,502,440,62,9
12837,2023-06-19 21:00:00,145,250,7,17,633,453,180,8
12838,2023-06-19 22:00:00,134,275,7,12,687,573,114,5
12839,2023-06-19 23:00:00,122,272,8,12,656,488,168,14
12840,2023-06-20 00:00:00,125,265,9,11,551,407,144,13
12841,2023-06-20 01:00:00,148,299,12,19,750,527,223,7
12842,2023-06-20 02:00:00,122,266,6,15,728,575,153,8
12843,2023-06-20 03:00:00,126,281,11,15,748,666,82,7
12844,2023-06-20 04:00:00,122,261,5,12,533,406,127,6
12845,2023-06-20 05:00:00,139,287,6,13,756,575,181,12
12846,2023-06-20 06:00:00,121,270,14,10,744,605,139,12
12847,2023-06-20 07:00:00,139,261,6,11,717,517,200,14
12848,2023-06-20 08:00:00,121,288,11,14,697,564,133,10
12849,2023-06-20 09:00:00,147,278,8,12,751,591,160,5
12850,2023-06-20 10:00:00,139,291,6,17,621,499,122,13
12851,2023-06-20 11:00:00,139,281,11,19,758,643,115,6
12852,2023-06-20 12:00:00,145,287,6,14,733,592,141,5
12853,2023-06-20 13:00:00,121,289,7,11,650,531,119,5
12854,2023-06-20 14:00:00,131,282,14,16,793,683,110,5
12855,2023-06-20 15:00:00,120,279,6,16,657,513,144,13
12856,2023-06-20 16:00:00,148,269,14,13,545,384,161,14
12857,2023-06-20 17:00:00,143,276,8,16,707,573,134,7
12858,2023-06-20 18:00:00,140,284,9,13,510,400,110,7
12859,2023-06-20 19:00:00,149,255,13,10,668,582,86,5
12860,2023-06-20 20:00:00,139,257,9,10,541,441,100,10
12861,2023-06-20 21:00:00,141,273,7,14,686,542,144,6
12862,2023-06-20 22:00:00,134,298,8,10,537,382,155,14
12863,2023-06-20 23:00:00,133,267,12,13,777,603,174,8
12864,2023-06-21 00:00:00,141,261,9,16,612,440,172,7
12865,2023-06-21 01:00:00,132,267,13,19,704,611,93,12
12866,2023-06-21 02:00:00,131,252,9,16,525,392,133,12
12867,2023-06-21 03:00:00,146,290,10,19,649,511,138,6
12868,2023-06-21 04:00:00,120,279,9,18,713,576,137,14
12869,2023-06-21 05:00:00,125,284,6,19,671,597,74,10
12870,2023-06-21 06:00:00,127,269,13,11,784,573,211,5
12871,2023-06-21 07:00:00,133,295,6,10,777,694,83,10
12872,2023-06-21 08:00:00,148,294,11,19,707,496,211,13
12873,2023-06-21 09:00:00,124,290,9,10,580,429,151,12
12874,2023-06-21 10:00:00,134,293,12,12,529,439,90,12
12875,2023-06-21 11:00:00,148,298,11,14,749,563,186,6
12876,2023-06-21 12:00:00,123,263,7,11,680,586,94,6
12877,2023-06-21 13:00:00,120,287,10,13,553,435,118,12
12878,2023-06-21 14:00:00,140,280,6,18,726,604,122,5
12879,2023-06-21 15:00:00,138,287,14,17,576,490,86,8
12880,2023-06-21 16:00:00,143,259,8,18,560,430,130,14
12881,2023-06-21 17:00:00,133,271,10,18,660,490,170,11
12882,2023-06-21 18:00:00,125,284,7,14,593,422,171,8
12883,2023-06-21 19:00:00,146,275,8,12,508,359,149,11
12884,2023-06-21 20:00:00,127,253,10,16,530,439,91,12
12885,2023-06-21 21:00:00,126,276,5,17,573,404,169,5
12886,2023-06-21 22:00:00,136,284,7,15,664,566,98,12
12887,2023-06-21 23:00:00,125,299,12,15,573,473,100,12
12888,2023-06-22 00:00:00,128,274,14,11,748,633,115,10
12889,2023-06-22 01:00:00,133,272,9,18,716,541,175,13
12890,2023-06-22 02:00:00,140,262,12,17,780,549,231,13
12891,2023-06-22 03:00:00,127,257,12,17,540,482,58,8
12892,2023-06-22 04:00:00,136,254,6,11,549,418,131,6
12893,2023-06-22 05:00:00,145,271,5,18,725,652,73,12
12894,2023-06-22 06:00:00,133,284,8,13,765,668,97,12
12895,2023-06-22 07:00:00,139,260,11,16,575,444,131,10
12896,2023-06-22 08:00:00,131,278,9,16,575,433,142,5
12897,2023-06-22 09:00:00,141,286,12,14,513,394,119,9
12898,2023-06-22 10:00:00,142,284,8,10,581,504,77,6
12899,2023-06-22 11:00:00,130,281,5,12,635,554,81,12
12900,2023-06-22 12:00:00,148,288,11,18,711,586,125,14
12901,2023-06-22 13:00:00,138,287,7,14,669,548,121,6
12902,2023-06-22 14:00:00,144,277,10,11,727,515,212,8
12903,2023-06-22 15:00:00,137,252,9,15,760,634,126,14
12904,2023-06-22 16:00:00,142,262,14,11,756,610,146,7
12905,2023-06-22 17:00:00,135,299,8,19,766,592,174,8
12906,2023-06-22 18:00:00,124,271,6,14,756,640,116,6
12907,2023-06-22 19:00:00,136,283,8,18,510,358,152,7
12908,2023-06-22 20:00:00,148,288,11,18,672,587,85,7
12909,2023-06-22 21:00:00,144,291,9,12,686,489,197,6
12910,2023-06-22 22:00:00,144,291,13,13,737,572,165,5
12911,2023-06-22 23:00:00,129,275,5,10,668,548,120,14
12912,2023-06-23 00:00:00,135,274,9,19,766,580,186,10
12913,2023-06-23 01:00:00,127,250,7,15,689,495,194,8
12914,2023-06-23 02:00:00,122,258,10,19,769,542,227,14
12915,2023-06-23 03:00:00,146,285,5,19,699,623,76,13
12916,2023-06-23 04:00:00,121,299,13,15,607,506,101,9
12917,2023-06-23 05:00:00,131,259,13,19,566,461,105,14
12918,2023-06-23 06:00:00,148,251,7,13,626,532,94,8
12919,2023-06-23 07:00:00,142,254,10,17,575,505,70,6
12920,2023-06-23 08:00:00,135,258,11,19,680,506,174,6
12921,2023-06-23 09:00:00,131,252,6,17,575,451,124,9
12922,2023-06-23 10:00:00,139,279,9,13,552,490,62,5
12923,2023-06-23 11:00:00,122,255,8,19,667,471,196,9
12924,2023-06-23 12:00:00,134,289,9,10,609,517,92,9
12925,2023-06-23 13:00:00,143,267,12,16,730,526,204,9
12926,2023-06-23 14:00:00,147,299,7,11,575,459,116,12
12927,2023-06-23 15:00:00,120,275,11,13,524,464,60,6
12928,2023-06-23 16:00:00,148,252,6,14,794,643,151,6
12929,2023-06-23 17:00:00,133,288,10,14,510,446,64,10
12930,2023-06-23 18:00:00,145,294,11,16,566,476,90,11
12931,2023-06-23 19:00:00,146,274,5,12,543,437,106,6
12932,2023-06-23 20:00:00,137,264,7,10,527,457,70,7
12933,2023-06-23 21:00:00,126,251,10,11,737,653,84,8
12934,2023-06-23 22:00:00,126,251,12,15,638,531,107,6
12935,2023-06-23 23:00:00,137,268,7,11,551,427,124,14
12936,2023-06-24 00:00:00,146,280,12,11,736,549,187,6
12937,2023-06-24 01:00:00,124,287,8,13,593,477,116,11
12938,2023-06-24 02:00:00,124,253,10,16,657,564,93,12
12939,2023-06-24 03:00:00,139,282,9,13,754,666,88,10
12940,2023-06-24 04:00:00,124,255,8,12,796,563,233,12
12941,2023-06-24 05:00:00,138,270,9,15,540,428,112,12
12942,2023-06-24 06:00:00,125,264,14,10,681,497,184,14
12943,2023-06-24 07:00:00,140,286,10,12,503,354,149,7
12944,2023-06-24 08:00:00,126,263,14,10,752,533,219,7
12945,2023-06-24 09:00:00,142,295,11,19,790,657,133,7
12946,2023-06-24 10:00:00,147,290,11,19,739,567,172,7
12947,2023-06-24 11:00:00,144,298,6,18,537,433,104,7
12948,2023-06-24 12:00:00,141,251,10,13,513,457,56,12
12949,2023-06-24 13:00:00,145,291,13,17,599,512,87,10
12950,2023-06-24 14:00:00,136,258,11,15,676,551,125,9
12951,2023-06-24 15:00:00,129,291,13,18,634,497,137,9
12952,2023-06-24 16:00:00,149,267,8,18,519,423,96,5
12953,2023-06-24 17:00:00,137,268,7,19,655,548,107,5
12954,2023-06-24 18:00:00,137,291,5,19,745,655,90,11
12955,2023-06-24 19:00:00,135,267,7,19,658,463,195,10
12956,2023-06-24 20:00:00,144,260,12,14,638,524,114,8
12957,2023-06-24 21:00:00,123,264,12,15,649,543,106,11
12958,2023-06-24 22:00:00,132,257,9,13,625,487,138,8
12959,2023-06-24 23:00:00,134,266,7,18,686,545,141,9
12960,2023-06-25 00:00:00,138,261,6,13,544,435,109,8
12961,2023-06-25 01:00:00,128,263,9,10,641,516,125,10
12962,2023-06-25 02:00:00,144,298,7,12,780,687,93,9
12963,2023-06-25 03:00:00,138,261,7,11,730,611,119,7
12964,2023-06-25 04:00:00,120,261,8,14,799,705,94,13
12965,2023-06-25 05:00:00,139,282,12,18,714,607,107,9
12966,2023-06-25 06:00:00,139,285,13,11,768,673,95,11
12967,2023-06-25 07:00:00,129,255,14,16,574,460,114,8
12968,2023-06-25 08:00:00,129,290,6,15,535,455,80,5
12969,2023-06-25 09:00:00,136,289,5,16,644,455,189,9
12970,2023-06-25 10:00:00,138,272,9,10,655,531,124,9
12971,2023-06-25 11:00:00,130,284,12,12,584,506,78,7
12972,2023-06-25 12:00:00,148,288,12,11,524,396,128,10
12973,2023-06-25 13:00:00,134,269,12,17,785,606,179,6
12974,2023-06-25 14:00:00,126,292,13,11,767,687,80,13
12975,2023-06-25 15:00:00,139,285,6,10,663,465,198,12
12976,2023-06-25 16:00:00,135,264,13,14,740,583,157,10
12977,2023-06-25 17:00:00,144,283,8,18,523,441,82,14
12978,2023-06-25 18:00:00,136,278,14,12,695,608,87,10
12979,2023-06-25 19:00:00,121,261,8,15,767,612,155,13
12980,2023-06-25 20:00:00,130,272,14,14,779,654,125,9
12981,2023-06-25 21:00:00,125,255,5,19,715,510,205,9
12982,2023-06-25 22:00:00,124,263,13,14,694,507,187,10
12983,2023-06-25 23:00:00,143,291,14,11,599,432,167,7
12984,2023-06-26 00:00:00,134,299,7,10,714,507,207,8
12985,2023-06-26 01:00:00,148,277,8,12,709,603,106,7
12986,2023-06-26 02:00:00,125,254,12,10,718,521,197,10
12987,2023-06-26 03:00:00,123,294,7,19,707,619,88,13
12988,2023-06-26 04:00:00,145,280,8,10,793,653,140,14
12989,2023-06-26 05:00:00,126,262,8,16,575,471,104,8
12990,2023-06-26 06:00:00,137,293,6,14,696,550,146,8
12991,2023-06-26 07:00:00,138,297,6,10,516,404,112,14
12992,2023-06-26 08:00:00,142,285,6,10,570,444,126,13
12993,2023-06-26 09:00:00,144,285,14,16,729,625,104,10
12994,2023-06-26 10:00:00,143,275,12,17,522,449,73,10
12995,2023-06-26 11:00:00,137,292,7,11,508,416,92,10
12996,2023-06-26 12:00:00,144,266,5,10,533,467,66,12
12997,2023-06-26 13:00:00,127,260,5,14,653,526,127,11
12998,2023-06-26 14:00:00,136,272,10,13,512,436,76,14
12999,2023-06-26 15:00:00,148,272,10,17,566,449,117,8
13000,2023-06-26 16:00:00,137,284,5,11,582,499,83,8
13001,2023-06-26 17:00:00,144,252,8,19,655,550,105,13
13002,2023-06-26 18:00:00,134,296,14,15,549,493,56,14
13003,2023-06-26 19:00:00,142,298,7,11,551,389,162,8
13004,2023-06-26 20:00:00,122,292,10,10,532,383,149,5
13005,2023-06-26 21:00:00,142,255,5,13,781,577,204,11
13006,2023-06-26 22:00:00,146,255,13,10,593,511,82,14
13007,2023-06-26 23:00:00,133,272,8,17,799,566,233,10
13008,2023-06-27 00:00:00,127,267,7,16,665,522,143,12
13009,2023-06-27 01:00:00,137,289,11,16,712,614,98,14
13010,2023-06-27 02:00:00,128,297,7,19,566,421,145,6
13011,2023-06-27 03:00:00,129,255,9,19,743,577,166,11
13012,2023-06-27 04:00:00,125,270,8,15,758,673,85,6
13013,2023-06-27 05:00:00,145,262,5,18,674,578,96,5
13014,2023-06-27 06:00:00,129,265,11,11,635,507,128,8
13015,2023-06-27 07:00:00,127,253,13,18,740,543,197,9
13016,2023-06-27 08:00:00,135,251,12,15,532,383,149,10
13017,2023-06-27 09:00:00,144,250,10,16,686,521,165,8
13018,2023-06-27 10:00:00,124,258,9,16,630,443,187,8
13019,2023-06-27 11:00:00,127,293,6,16,701,610,91,13
13020,2023-06-27 12:00:00,146,260,13,18,545,465,80,9
13021,2023-06-27 13:00:00,134,298,13,17,777,640,137,5
13022,2023-06-27 14:00:00,129,295,11,15,569,447,122,11
13023,2023-06-27 15:00:00,141,274,8,10,790,591,199,6
13024,2023-06-27 16:00:00,138,279,14,19,501,385,116,5
13025,2023-06-27 17:00:00,147,257,5,15,588,444,144,11
13026,2023-06-27 18:00:00,134,297,6,10,646,468,178,9
13027,2023-06-27 19:00:00,143,268,11,19,706,568,138,10
13028,2023-06-27 20:00:00,123,269,13,17,745,653,92,5
13029,2023-06-27 21:00:00,149,272,11,10,680,582,98,14
13030,2023-06-27 22:00:00,127,293,7,14,508,404,104,11
13031,2023-06-27 23:00:00,129,281,9,11,798,637,161,5
13032,2023-06-28 00:00:00,148,252,7,19,650,543,107,11
13033,2023-06-28 01:00:00,126,252,13,18,781,696,85,9
13034,2023-06-28 02:00:00,148,275,12,13,764,604,160,6
13035,2023-06-28 03:00:00,129,271,10,19,575,465,110,13
13036,2023-06-28 04:00:00,143,284,13,16,653,553,100,13
13037,2023-06-28 05:00:00,120,251,14,10,635,539,96,7
13038,2023-06-28 06:00:00,130,250,8,17,587,528,59,14
13039,2023-06-28 07:00:00,143,250,7,16,627,537,90,7
13040,2023-06-28 08:00:00,133,277,13,12,630,544,86,6
13041,2023-06-28 09:00:00,137,255,5,18,698,573,125,6
13042,2023-06-28 10:00:00,140,286,5,16,558,394,164,8
13043,2023-06-28 11:00:00,131,285,9,12,559,459,100,14
13044,2023-06-28 12:00:00,145,274,14,14,625,533,92,11
13045,2023-06-28 13:00:00,133,285,6,14,775,661,114,10
13046,2023-06-28 14:00:00,144,266,10,11,620,526,94,5
13047,2023-06-28 15:00:00,146,265,10,13,735,567,168,5
13048,2023-06-28 16:00:00,138,289,5,10,591,503,88,11
13049,2023-06-28 17:00:00,133,282,14,15,743,629,114,11
13050,2023-06-28 18:00:00,124,253,5,19,584,425,159,13
13051,2023-06-28 19:00:00,120,287,11,14,796,664,132,12
13052,2023-06-28 20:00:00,148,265,5,15,572,451,121,10
13053,2023-06-28 21:00:00,146,251,6,11,596,438,158,14
13054,2023-06-28 22:00:00,133,258,7,12,688,523,165,6
13055,2023-06-28 23:00:00,143,269,13,17,620,475,145,9
13056,2023-06-29 00:00:00,134,287,11,18,663,540,123,8
13057,2023-06-29 01:00:00,146,273,12,19,530,410,120,14
13058,2023-06-29 02:00:00,144,276,7,16,536,453,83,7
13059,2023-06-29 03:00:00,120,298,6,15,685,486,199,7
13060,2023-06-29 04:00:00,127,294,9,12,743,570,173,14
13061,2023-06-29 05:00:00,138,263,13,13,736,620,116,10
13062,2023-06-29 06:00:00,136,282,5,13,664,562,102,7
13063,2023-06-29 07:00:00,143,269,5,17,713,612,101,7
13064,2023-06-29 08:00:00,130,294,13,11,533,474,59,8
13065,2023-06-29 09:00:00,126,259,10,17,644,569,75,7
13066,2023-06-29 10:00:00,123,270,10,16,584,458,126,10
13067,2023-06-29 11:00:00,148,286,9,13,537,393,144,6
13068,2023-06-29 12:00:00,147,257,14,17,582,433,149,5
13069,2023-06-29 13:00:00,125,250,5,13,620,510,110,9
13070,2023-06-29 14:00:00,132,253,14,15,627,443,184,13
13071,2023-06-29 15:00:00,134,290,6,10,726,593,133,6
13072,2023-06-29 16:00:00,145,261,5,15,641,496,145,9
13073,2023-06-29 17:00:00,135,290,10,16,696,533,163,13
13074,2023-06-29 18:00:00,127,287,13,10,737,601,136,7
13075,2023-06-29 19:00:00,124,289,6,10,678,517,161,12
13076,2023-06-29 20:00:00,139,260,12,11,738,574,164,5
13077,2023-06-29 21:00:00,125,286,7,10,580,406,174,9
13078,2023-06-29 22:00:00,136,255,12,15,561,471,90,13
13079,2023-06-29 23:00:00,129,257,11,13,758,578,180,11
13080,2023-06-30 00:00:00,138,276,8,13,755,587,168,9
13081,2023-06-30 01:00:00,127,297,6,14,700,576,124,12
13082,2023-06-30 02:00:00,132,284,11,10,773,616,157,7
13083,2023-06-30 03:00:00,131,270,13,17,633,484,149,12
13084,2023-06-30 04:00:00,132,267,5,15,633,552,81,13
13085,2023-06-30 05:00:00,134,255,8,17,546,469,77,11
13086,2023-06-30 06:00:00,136,252,14,13,603,474,129,8
13087,2023-06-30 07:00:00,125,276,5,18,748,547,201,9
13088,2023-06-30 08:00:00,146,295,9,17,683,479,204,9
13089,2023-06-30 09:00:00,135,263,9,15,733,623,110,8
13090,2023-06-30 10:00:00,129,299,7,11,695,565,130,13
13091,2023-06-30 11:00:00,134,277,8,10,766,560,206,7
13092,2023-06-30 12:00:00,126,263,5,16,781,684,97,10
13093,2023-06-30 13:00:00,133,267,7,11,780,586,194,11
13094,2023-06-30 14:00:00,147,292,13,14,556,451,105,13
13095,2023-06-30 15:00:00,122,283,13,18,632,447,185,12
13096,2023-06-30 16:00:00,130,259,14,16,719,516,203,13
13097,2023-06-30 17:00:00,142,281,7,13,591,458,133,11
13098,2023-06-30 18:00:00,132,273,7,11,612,504,108,9
13099,2023-06-30 19:00:00,136,282,13,15,751,652,99,13
13100,2023-06-30 20:00:00,138,257,14,10,703,587,116,8
13101,2023-06-30 21:00:00,129,298,13,16,595,448,147,10
13102,2023-06-30 22:00:00,141,275,8,18,749,562,187,5
13103,2023-06-30 23:00:00,126,262,10,16,657,527,130,13
13104,2023-07-01 00:00:00,131,272,10,15,585,432,153,11
13105,2023-07-01 01:00:00,137,276,13,11,778,664,114,11
13106,2023-07-01 02:00:00,138,261,10,16,610,479,131,14
13107,2023-07-01 03:00:00,146,292,11,15,582,419,163,8
13108,2023-07-01 04:00:00,146,250,12,18,732,653,79,14
13109,2023-07-01 05:00:00,131,282,7,15,766,668,98,9
13110,2023-07-01 06:00:00,142,263,8,13,533,461,72,14
13111,2023-07-01 07:00:00,126,296,8,14,560,461,99,11
13112,2023-07-01 08:00:00,146,269,9,15,701,575,126,13
13113,2023-07-01 09:00:00,125,267,9,15,609,538,71,8
13114,2023-07-01 10:00:00,136,298,7,12,791,709,82,9
13115,2023-07-01 11:00:00,144,260,12,18,682,541,141,14
13116,2023-07-01 12:00:00,143,270,8,18,576,452,124,14
13117,2023-07-01 13:00:00,145,275,12,16,509,365,144,8
13118,2023-07-01 14:00:00,121,286,6,13,653,481,172,8
13119,2023-07-01 15:00:00,122,259,12,17,634,547,87,9
13120,2023-07-01 16:00:00,136,293,13,17,678,556,122,9
13121,2023-07-01 17:00:00,125,272,6,17,692,510,182,7
13122,2023-07-01 18:00:00,143,251,12,16,571,412,159,12
13123,2023-07-01 19:00:00,130,298,12,15,647,516,131,5
13124,2023-07-01 20:00:00,141,268,9,17,720,578,142,11
13125,2023-07-01 21:00:00,124,288,12,19,616,529,87,8
13126,2023-07-01 22:00:00,128,273,7,17,739,607,132,12
13127,2023-07-01 23:00:00,130,259,8,15,673,593,80,7
13128,2023-07-02 00:00:00,148,255,10,13,782,563,219,13
13129,2023-07-02 01:00:00,146,252,10,16,552,454,98,13
13130,2023-07-02 02:00:00,145,270,7,12,770,543,227,13
13131,2023-07-02 03:00:00,131,269,5,12,599,536,63,9
13132,2023-07-02 04:00:00,129,288,8,11,671,588,83,12
13133,2023-07-02 05:00:00,138,293,5,17,545,452,93,8
13134,2023-07-02 06:00:00,149,253,6,10,541,414,127,14
13135,2023-07-02 07:00:00,135,255,8,12,633,510,123,7
13136,2023-07-02 08:00:00,142,279,11,10,590,485,105,14
13137,2023-07-02 09:00:00,135,291,14,14,677,552,125,14
13138,2023-07-02 10:00:00,140,264,6,10,628,445,183,8
13139,2023-07-02 11:00:00,133,264,7,14,607,517,90,7
13140,2023-07-02 12:00:00,126,250,8,15,778,556,222,5
13141,2023-07-02 13:00:00,144,259,11,17,531,411,120,5
13142,2023-07-02 14:00:00,125,280,8,16,539,432,107,5
13143,2023-07-02 15:00:00,123,254,9,11,539,428,111,7
13144,2023-07-02 16:00:00,145,265,14,16,527,395,132,14
13145,2023-07-02 17:00:00,141,276,7,13,781,570,211,6
13146,2023-07-02 18:00:00,137,255,11,11,682,556,126,8
13147,2023-07-02 19:00:00,148,251,8,17,543,422,121,8
13148,2023-07-02 20:00:00,131,262,14,17,718,640,78,8
13149,2023-07-02 21:00:00,142,273,11,13,712,502,210,6
13150,2023-07-02 22:00:00,139,254,6,14,534,393,141,7
13151,2023-07-02 23:00:00,148,262,14,11,648,511,137,12
13152,2023-07-03 00:00:00,144,273,13,10,770,587,183,5
13153,2023-07-03 01:00:00,133,256,10,11,770,561,209,10
13154,2023-07-03 02:00:00,142,261,6,12,616,482,134,7
13155,2023-07-03 03:00:00,134,262,14,15,601,441,160,9
13156,2023-07-03 04:00:00,127,292,13,13,726,637,89,12
13157,2023-07-03 05:00:00,136,283,7,15,523,446,77,12
13158,2023-07-03 06:00:00,123,259,5,17,757,608,149,5
13159,2023-07-03 07:00:00,138,269,14,12,789,624,165,9
13160,2023-07-03 08:00:00,140,265,6,15,588,467,121,8
13161,2023-07-03 09:00:00,125,287,14,17,542,482,60,11
13162,2023-07-03 10:00:00,145,269,7,18,783,661,122,10
13163,2023-07-03 11:00:00,132,295,9,13,623,501,122,9
13164,2023-07-03 12:00:00,135,299,6,17,626,466,160,10
13165,2023-07-03 13:00:00,122,272,11,18,667,512,155,13
13166,2023-07-03 14:00:00,143,282,10,17,688,526,162,12
13167,2023-07-03 15:00:00,134,297,14,14,594,482,112,9
13168,2023-07-03 16:00:00,147,270,14,18,595,526,69,12
13169,2023-07-03 17:00:00,141,283,8,16,744,637,107,10
13170,2023-07-03 18:00:00,148,290,13,17,688,549,139,5
13171,2023-07-03 19:00:00,131,252,12,15,551,462,89,12
13172,2023-07-03 20:00:00,124,276,5,16,762,661,101,10
13173,2023-07-03 21:00:00,122,265,12,10,757,588,169,8
13174,2023-07-03 22:00:00,142,289,8,10,775,684,91,5
13175,2023-07-03 23:00:00,144,268,14,16,607,542,65,12
13176,2023-07-04 00:00:00,148,252,6,16,739,665,74,7
13177,2023-07-04 01:00:00,132,275,9,16,714,513,201,10
13178,2023-07-04 02:00:00,123,272,10,13,666,582,84,14
13179,2023-07-04 03:00:00,133,261,9,19,798,669,129,13
13180,2023-07-04 04:00:00,127,261,5,18,786,576,210,6
13181,2023-07-04 05:00:00,134,256,6,15,603,422,181,5
13182,2023-07-04 06:00:00,134,281,12,18,609,490,119,7
13183,2023-07-04 07:00:00,135,282,10,12,712,505,207,11
13184,2023-07-04 08:00:00,139,259,6,18,589,517,72,9
13185,2023-07-04 09:00:00,123,299,10,12,521,467,54,12
13186,2023-07-04 10:00:00,142,264,12,11,533,428,105,8
13187,2023-07-04 11:00:00,127,297,7,17,722,513,209,13
13188,2023-07-04 12:00:00,139,257,10,17,612,483,129,6
13189,2023-07-04 13:00:00,121,265,12,17,787,703,84,7
13190,2023-07-04 14:00:00,130,294,8,11,511,397,114,7
13191,2023-07-04 15:00:00,120,278,13,18,703,540,163,14
13192,2023-07-04 16:00:00,121,290,7,14,545,464,81,6
13193,2023-07-04 17:00:00,146,251,8,15,546,485,61,7
13194,2023-07-04 18:00:00,124,255,6,14,580,412,168,7
13195,2023-07-04 19:00:00,120,284,10,18,556,466,90,12
13196,2023-07-04 20:00:00,147,262,6,17,538,420,118,11
13197,2023-07-04 21:00:00,136,298,9,14,567,399,168,12
13198,2023-07-04 22:00:00,143,276,11,13,751,644,107,12
13199,2023-07-04 23:00:00,142,292,13,12,606,430,176,7
13200,2023-07-05 00:00:00,124,294,10,18,681,507,174,6
13201,2023-07-05 01:00:00,129,260,12,16,554,457,97,8
13202,2023-07-05 02:00:00,147,299,9,19,537,428,109,5
13203,2023-07-05 03:00:00,142,261,8,13,748,667,81,7
13204,2023-07-05 04:00:00,141,281,12,17,646,559,87,9
13205,2023-07-05 05:00:00,121,270,11,10,597,507,90,6
13206,2023-07-05 06:00:00,133,256,8,19,740,625,115,9
13207,2023-07-05 07:00:00,124,273,10,15,548,456,92,12
13208,2023-07-05 08:00:00,123,284,6,10,637,563,74,10
13209,2023-07-05 09:00:00,120,264,12,11,539,401,138,11
13210,2023-07-05 10:00:00,141,258,7,11,613,474,139,7
13211,2023-07-05 11:00:00,120,284,9,18,645,500,145,13
13212,2023-07-05 12:00:00,135,262,13,19,747,566,181,11
13213,2023-07-05 13:00:00,125,293,8,10,588,441,147,7
13214,2023-07-05 14:00:00,141,258,13,19,609,489,120,9
13215,2023-07-05 15:00:00,132,267,13,19,732,561,171,10
13216,2023-07-05 16:00:00,133,264,12,12,505,388,117,8
13217,2023-07-05 17:00:00,138,274,8,17,521,401,120,11
13218,2023-07-05 18:00:00,142,286,6,14,674,582,92,14
13219,2023-07-05 19:00:00,123,262,12,10,529,395,134,5
13220,2023-07-05 20:00:00,138,268,8,16,734,599,135,10
13221,2023-07-05 21:00:00,139,258,11,16,684,591,93,14
13222,2023-07-05 22:00:00,123,265,10,14,531,390,141,9
13223,2023-07-05 23:00:00,132,252,10,11,776,623,153,7
13224,2023-07-06 00:00:00,139,289,12,12,614,528,86,9
13225,2023-07-06 01:00:00,120,284,13,16,591,522,69,5
13226,2023-07-06 02:00:00,129,261,10,15,723,601,122,12
13227,2023-07-06 03:00:00,141,282,6,13,522,465,57,12
13228,2023-07-06 04:00:00,136,288,12,13,693,538,155,5
13229,2023-07-06 05:00:00,148,264,14,19,606,442,164,6
13230,2023-07-06 06:00:00,138,297,8,12,542,380,162,5
13231,2023-07-06 07:00:00,126,279,11,12,796,637,159,6
13232,2023-07-06 08:00:00,122,275,10,17,763,568,195,8
13233,2023-07-06 09:00:00,136,252,9,12,627,557,70,14
13234,2023-07-06 10:00:00,124,271,9,13,621,472,149,7
13235,2023-07-06 11:00:00,135,283,9,10,538,422,116,7
13236,2023-07-06 12:00:00,129,261,5,18,576,498,78,13
13237,2023-07-06 13:00:00,149,272,13,16,682,479,203,10
13238,2023-07-06 14:00:00,143,259,8,11,560,498,62,5
13239,2023-07-06 15:00:00,141,291,7,10,781,578,203,14
13240,2023-07-06 16:00:00,130,285,14,15,566,489,77,11
13241,2023-07-06 17:00:00,132,296,9,15,550,413,137,8
13242,2023-07-06 18:00:00,147,298,8,15,633,560,73,9
13243,2023-07-06 19:00:00,131,284,11,18,655,485,170,12
13244,2023-07-06 20:00:00,131,285,11,11,785,656,129,14
13245,2023-07-06 21:00:00,140,259,8,15,513,390,123,13
13246,2023-07-06 22:00:00,133,283,8,18,764,604,160,6
13247,2023-07-06 23:00:00,122,292,13,19,624,560,64,6
13248,2023-07-07 00:00:00,121,260,14,17,500,442,58,14
13249,2023-07-07 01:00:00,124,267,6,12,744,646,98,13
13250,2023-07-07 02:00:00,148,285,12,12,666,503,163,7
13251,2023-07-07 03:00:00,144,253,9,12,501,449,52,7
13252,2023-07-07 04:00:00,144,276,8,15,574,424,150,7
13253,2023-07-07 05:00:00,148,288,6,17,718,602,116,5
13254,2023-07-07 06:00:00,148,298,6,11,653,459,194,13
13255,2023-07-07 07:00:00,141,299,6,16,542,405,137,7
13256,2023-07-07 08:00:00,131,255,8,11,642,481,161,11
13257,2023-07-07 09:00:00,149,266,10,17,739,653,86,10
13258,2023-07-07 10:00:00,126,283,12,19,642,462,180,12
13259,2023-07-07 11:00:00,145,264,9,17,745,642,103,6
13260,2023-07-07 12:00:00,137,292,6,17,785,704,81,10
13261,2023-07-07 13:00:00,149,294,11,13,502,442,60,14
13262,2023-07-07 14:00:00,146,299,11,10,752,532,220,13
13263,2023-07-07 15:00:00,135,270,5,14,761,555,206,11
13264,2023-07-07 16:00:00,140,278,13,12,661,560,101,7
13265,2023-07-07 17:00:00,144,271,12,13,715,610,105,7
13266,2023-07-07 18:00:00,123,282,10,13,603,434,169,6
13267,2023-07-07 19:00:00,144,267,13,10,654,463,191,8
13268,2023-07-07 20:00:00,138,294,14,14,772,582,190,7
13269,2023-07-07 21:00:00,138,282,11,18,680,528,152,11
13270,2023-07-07 22:00:00,122,288,9,12,620,463,157,12
13271,2023-07-07 23:00:00,148,273,7,15,717,570,147,8
13272,2023-07-08 00:00:00,144,250,8,17,711,565,146,14
13273,2023-07-08 01:00:00,144,285,13,12,632,523,109,11
13274,2023-07-08 02:00:00,146,269,12,19,501,355,146,5
13275,2023-07-08 03:00:00,141,276,10,19,769,690,79,11
13276,2023-07-08 04:00:00,132,271,10,12,510,455,55,14
13277,2023-07-08 05:00:00,132,260,9,11,534,410,124,14
13278,2023-07-08 06:00:00,141,250,8,14,600,492,108,6
13279,2023-07-08 07:00:00,127,281,5,11,560,462,98,6
13280,2023-07-08 08:00:00,120,256,10,14,762,664,98,5
13281,2023-07-08 09:00:00,132,284,11,16,562,405,157,11
13282,2023-07-08 10:00:00,122,271,12,17,789,668,121,10
13283,2023-07-08 11:00:00,123,297,11,15,765,557,208,6
13284,2023-07-08 12:00:00,135,277,7,17,601,491,110,7
13285,2023-07-08 13:00:00,145,296,10,19,674,523,151,5
13286,2023-07-08 14:00:00,149,262,6,11,628,556,72,7
13287,2023-07-08 15:00:00,124,295,10,15,607,459,148,6
13288,2023-07-08 16:00:00,146,273,14,13,544,452,92,14
13289,2023-07-08 17:00:00,135,258,12,18,604,485,119,11
13290,2023-07-08 18:00:00,145,272,10,10,637,503,134,7
13291,2023-07-08 19:00:00,145,295,14,10,654,503,151,9
13292,2023-07-08 20:00:00,134,258,10,10,778,563,215,14
13293,2023-07-08 21:00:00,123,288,14,14,738,590,148,11
13294,2023-07-08 22:00:00,122,291,11,10,770,691,79,11
13295,2023-07-08 23:00:00,132,270,12,18,516,455,61,10
13296,2023-07-09 00:00:00,122,280,13,12,519,365,154,11
13297,2023-07-09 01:00:00,132,291,7,10,623,508,115,9
13298,2023-07-09 02:00:00,135,281,7,17,779,592,187,6
13299,2023-07-09 03:00:00,140,273,7,18,671,488,183,11
13300,2023-07-09 04:00:00,128,253,7,10,708,597,111,10
13301,2023-07-09 05:00:00,120,254,14,10,589,417,172,10
13302,2023-07-09 06:00:00,149,289,12,10,772,577,195,14
13303,2023-07-09 07:00:00,141,260,8,12,507,422,85,10
13304,2023-07-09 08:00:00,128,268,9,15,550,421,129,10
13305,2023-07-09 09:00:00,123,253,14,18,624,528,96,7
13306,2023-07-09 10:00:00,136,296,6,19,635,564,71,8
13307,2023-07-09 11:00:00,134,251,12,17,737,552,185,12
13308,2023-07-09 12:00:00,144,288,7,17,711,609,102,7
13309,2023-07-09 13:00:00,128,267,8,12,586,439,147,14
13310,2023-07-09 14:00:00,122,275,13,17,607,545,62,9
13311,2023-07-09 15:00:00,136,288,13,16,571,434,137,6
13312,2023-07-09 16:00:00,121,280,13,18,752,527,225,7
13313,2023-07-09 17:00:00,144,276,13,14,586,518,68,12
13314,2023-07-09 18:00:00,136,284,7,16,513,427,86,9
13315,2023-07-09 19:00:00,123,294,8,16,642,474,168,12
13316,2023-07-09 20:00:00,130,286,8,17,650,566,84,5
13317,2023-07-09 21:00:00,139,286,8,17,666,512,154,6
13318,2023-07-09 22:00:00,125,293,7,14,772,575,197,8
13319,2023-07-09 23:00:00,147,269,10,10,522,413,109,9
13320,2023-07-10 00:00:00,124,253,12,19,631,531,100,8
13321,2023-07-10 01:00:00,124,291,12,12,511,432,79,7
13322,2023-07-10 02:00:00,145,273,8,17,750,628,122,14
13323,2023-07-10 03:00:00,126,255,9,10,599,513,86,8
13324,2023-07-10 04:00:00,148,299,6,17,676,488,188,14
13325,2023-07-10 05:00:00,145,265,13,13,684,601,83,8
13326,2023-07-10 06:00:00,129,291,13,13,526,455,71,7
13327,2023-07-10 07:00:00,143,255,10,12,507,425,82,9
13328,2023-07-10 08:00:00,127,258,8,14,752,572,180,14
13329,2023-07-10 09:00:00,147,299,12,14,569,437,132,8
13330,2023-07-10 10:00:00,123,285,7,12,713,597,116,5
13331,2023-07-10 11:00:00,148,291,10,17,573,471,102,12
13332,2023-07-10 12:00:00,138,270,12,15,761,532,229,8
13333,2023-07-10 13:00:00,128,256,12,19,619,441,178,5
13334,2023-07-10 14:00:00,134,290,5,19,683,493,190,6
13335,2023-07-10 15:00:00,122,275,13,15,743,618,125,10
13336,2023-07-10 16:00:00,141,269,9,16,664,542,122,12
13337,2023-07-10 17:00:00,125,296,12,12,713,624,89,13
13338,2023-07-10 18:00:00,126,269,7,19,724,537,187,9
13339,2023-07-10 19:00:00,120,294,13,14,689,541,148,8
13340,2023-07-10 20:00:00,146,292,11,11,671,600,71,11
13341,2023-07-10 21:00:00,121,288,9,16,502,449,53,7
13342,2023-07-10 22:00:00,136,279,13,19,500,364,136,12
13343,2023-07-10 23:00:00,120,298,6,16,719,639,80,8
13344,2023-07-11 00:00:00,146,295,11,18,507,449,58,11
13345,2023-07-11 01:00:00,138,275,10,14,696,523,173,11
13346,2023-07-11 02:00:00,137,273,14,17,747,544,203,9
13347,2023-07-11 03:00:00,121,254,13,15,631,473,158,10
13348,2023-07-11 04:00:00,125,260,13,16,769,623,146,7
13349,2023-07-11 05:00:00,139,282,11,14,724,643,81,12
13350,2023-07-11 06:00:00,120,288,13,14,638,457,181,8
13351,2023-07-11 07:00:00,149,255,14,11,631,474,157,6
13352,2023-07-11 08:00:00,142,281,12,13,718,588,130,9
13353,2023-07-11 09:00:00,141,293,7,16,705,616,89,8
13354,2023-07-11 10:00:00,139,270,8,15,552,408,144,12
13355,2023-07-11 11:00:00,121,287,14,11,521,368,153,8
13356,2023-07-11 12:00:00,138,268,5,12,526,401,125,7
13357,2023-07-11 13:00:00,129,275,13,19,531,407,124,12
13358,2023-07-11 14:00:00,138,269,6,13,511,445,66,6
13359,2023-07-11 15:00:00,147,283,7,14,511,447,64,13
13360,2023-07-11 16:00:00,127,263,9,13,684,611,73,11
13361,2023-07-11 17:00:00,138,263,14,13,670,520,150,14
13362,2023-07-11 18:00:00,123,296,9,16,521,458,63,13
13363,2023-07-11 19:00:00,134,272,12,15,591,482,109,7
13364,2023-07-11 20:00:00,121,252,5,17,762,642,120,14
13365,2023-07-11 21:00:00,130,292,10,13,731,566,165,11
13366,2023-07-11 22:00:00,133,263,8,11,541,462,79,8
13367,2023-07-11 23:00:00,132,267,9,17,615,540,75,14
13368,2023-07-12 00:00:00,123,265,9,15,566,467,99,14
13369,2023-07-12 01:00:00,141,262,12,12,506,414,92,10
13370,2023-07-12 02:00:00,120,276,5,17,583,500,83,9
13371,2023-07-12 03:00:00,127,298,5,16,689,540,149,6
13372,2023-07-12 04:00:00,148,270,14,17,774,576,198,12
13373,2023-07-12 05:00:00,125,273,14,18,513,366,147,8
13374,2023-07-12 06:00:00,142,264,12,19,779,656,123,8
13375,2023-07-12 07:00:00,131,289,14,13,565,480,85,8
13376,2023-07-12 08:00:00,124,268,8,16,797,580,217,8
13377,2023-07-12 09:00:00,139,273,8,11,692,569,123,13
13378,2023-07-12 10:00:00,138,266,10,19,670,515,155,8
13379,2023-07-12 11:00:00,146,279,6,13,648,539,109,7
13380,2023-07-12 12:00:00,142,297,6,18,782,584,198,11
13381,2023-07-12 13:00:00,129,274,12,11,738,584,154,5
13382,2023-07-12 14:00:00,121,271,9,15,630,461,169,11
13383,2023-07-12 15:00:00,124,285,11,10,510,427,83,6
13384,2023-07-12 16:00:00,130,255,12,11,580,454,126,13
13385,2023-07-12 17:00:00,140,254,13,12,602,490,112,9
13386,2023-07-12 18:00:00,139,291,5,19,709,566,143,10
13387,2023-07-12 19:00:00,131,262,11,18,610,509,101,9
13388,2023-07-12 20:00:00,122,286,12,13,713,572,141,5
13389,2023-07-12 21:00:00,120,270,6,13,784,683,101,14
13390,2023-07-12 22:00:00,131,295,10,14,774,683,91,5
13391,2023-07-12 23:00:00,141,288,5,10,658,573,85,8
13392,2023-07-13 00:00:00,148,285,11,11,661,537,124,12
13393,2023-07-13 01:00:00,145,279,11,17,717,529,188,12
13394,2023-07-13 02:00:00,124,258,5,19,743,583,160,7
13395,2023-07-13 03:00:00,129,264,13,11,760,656,104,10
13396,2023-07-13 04:00:00,123,289,14,10,696,492,204,10
13397,2023-07-13 05:00:00,128,279,6,18,509,441,68,14
13398,2023-07-13 06:00:00,138,260,11,12,552,493,59,14
13399,2023-07-13 07:00:00,147,287,7,13,721,523,198,14
13400,2023-07-13 08:00:00,137,275,9,15,715,617,98,11
13401,2023-07-13 09:00:00,134,282,11,16,744,618,126,13
13402,2023-07-13 10:00:00,123,297,5,16,610,485,125,8
13403,2023-07-13 11:00:00,146,278,8,11,705,625,80,12
13404,2023-07-13 12:00:00,141,281,12,18,696,543,153,7
13405,2023-07-13 13:00:00,137,257,12,19,792,688,104,6
13406,2023-07-13 14:00:00,128,257,6,14,778,602,176,9
13407,2023-07-13 15:00:00,135,291,8,15,640,470,170,14
13408,2023-07-13 16:00:00,122,277,13,14,556,389,167,5
13409,2023-07-13 17:00:00,145,252,6,13,626,464,162,12
13410,2023-07-13 18:00:00,121,288,14,11,516,412,104,5
13411,2023-07-13 19:00:00,127,273,6,17,710,540,170,10
13412,2023-07-13 20:00:00,136,287,7,19,693,621,72,10
13413,2023-07-13 21:00:00,121,277,6,13,544,441,103,7
13414,2023-07-13 22:00:00,128,255,8,19,638,508,130,12
13415,2023-07-13 23:00:00,147,277,6,19,528,384,144,6
13416,2023-07-14 00:00:00,130,278,10,19,530,424,106,8
13417,2023-07-14 01:00:00,149,266,11,19,529,431,98,12
13418,2023-07-14 02:00:00,123,276,5,13,517,405,112,8
13419,2023-07-14 03:00:00,149,270,11,10,747,557,190,6
13420,2023-07-14 04:00:00,140,290,13,17,650,527,123,7
13421,2023-07-14 05:00:00,142,266,7,16,682,553,129,8
13422,2023-07-14 06:00:00,136,262,11,18,695,502,193,13
13423,2023-07-14 07:00:00,146,298,11,11,709,616,93,11
13424,2023-07-14 08:00:00,130,287,14,18,797,709,88,11
13425,2023-07-14 09:00:00,148,280,8,16,566,501,65,12
13426,2023-07-14 10:00:00,121,288,7,19,761,602,159,10
13427,2023-07-14 11:00:00,142,294,5,16,578,427,151,13
13428,2023-07-14 12:00:00,140,262,5,18,630,498,132,7
13429,2023-07-14 13:00:00,135,273,10,12,615,514,101,14
13430,2023-07-14 14:00:00,129,262,10,19,528,460,68,14
13431,2023-07-14 15:00:00,141,294,5,14,779,580,199,14
13432,2023-07-14 16:00:00,142,266,10,12,641,528,113,5
13433,2023-07-14 17:00:00,120,265,10,12,659,479,180,10
13434,2023-07-14 18:00:00,126,288,7,10,549,446,103,9
13435,2023-07-14 19:00:00,125,271,7,17,587,440,147,14
13436,2023-07-14 20:00:00,149,256,8,16,518,382,136,12
13437,2023-07-14 21:00:00,146,270,11,17,561,437,124,12
13438,2023-07-14 22:00:00,124,292,8,18,716,628,88,14
13439,2023-07-14 23:00:00,123,291,5,18,698,601,97,6
13440,2023-07-15 00:00:00,125,286,11,11,709,626,83,11
13441,2023-07-15 01:00:00,122,287,6,14,534,380,154,13
13442,2023-07-15 02:00:00,132,265,7,14,502,423,79,11
13443,2023-07-15 03:00:00,124,274,6,19,612,511,101,5
13444,2023-07-15 04:00:00,122,295,9,19,713,516,197,12
13445,2023-07-15 05:00:00,124,266,13,16,709,580,129,5
13446,2023-07-15 06:00:00,127,262,13,13,631,523,108,8
13447,2023-07-15 07:00:00,138,274,8,13,615,494,121,13
13448,2023-07-15 08:00:00,145,253,5,11,666,557,109,8
13449,2023-07-15 09:00:00,125,286,11,11,653,498,155,12
13450,2023-07-15 10:00:00,129,272,10,16,502,370,132,8
13451,2023-07-15 11:00:00,137,299,6,11,528,406,122,5
13452,2023-07-15 12:00:00,131,277,5,14,601,443,158,14
13453,2023-07-15 13:00:00,125,283,6,10,712,526,186,7
13454,2023-07-15 14:00:00,123,299,10,10,570,435,135,14
13455,2023-07-15 15:00:00,120,296,7,15,600,471,129,10
13456,2023-07-15 16:00:00,130,282,8,12,656,579,77,5
13457,2023-07-15 17:00:00,125,286,12,17,703,505,198,12
13458,2023-07-15 18:00:00,136,269,9,10,705,616,89,11
13459,2023-07-15 19:00:00,134,273,11,13,591,425,166,12
13460,2023-07-15 20:00:00,135,292,11,11,768,652,116,13
13461,2023-07-15 21:00:00,121,251,8,15,727,556,171,7
13462,2023-07-15 22:00:00,146,278,6,17,725,512,213,12
13463,2023-07-15 23:00:00,146,262,9,12,617,485,132,7
13464,2023-07-16 00:00:00,122,285,8,12,774,543,231,6
13465,2023-07-16 01:00:00,129,292,5,15,632,448,184,12
13466,2023-07-16 02:00:00,122,283,11,13,637,448,189,11
13467,2023-07-16 03:00:00,120,254,11,14,543,412,131,9
13468,2023-07-16 04:00:00,137,262,14,12,594,533,61,12
13469,2023-07-16 05:00:00,149,252,6,14,567,399,168,5
13470,2023-07-16 06:00:00,135,274,5,13,730,648,82,10
13471,2023-07-16 07:00:00,128,283,12,16,750,631,119,8
13472,2023-07-16 08:00:00,147,267,13,13,734,594,140,5
13473,2023-07-16 09:00:00,145,258,12,19,528,432,96,7
13474,2023-07-16 10:00:00,126,291,6,19,785,566,219,6
13475,2023-07-16 11:00:00,125,253,12,14,514,409,105,6
13476,2023-07-16 12:00:00,142,279,6,18,682,539,143,8
13477,2023-07-16 13:00:00,129,266,11,14,763,601,162,10
13478,2023-07-16 14:00:00,147,269,5,15,672,476,196,10
13479,2023-07-16 15:00:00,120,272,5,17,578,513,65,14
13480,2023-07-16 16:00:00,141,279,13,17,530,415,115,11
13481,2023-07-16 17:00:00,130,263,12,14,687,611,76,5
13482,2023-07-16 18:00:00,136,288,11,16,679,485,194,6
13483,2023-07-16 19:00:00,133,297,13,12,555,484,71,5
13484,2023-07-16 20:00:00,134,289,14,13,543,395,148,12
13485,2023-07-16 21:00:00,124,294,6,17,522,446,76,10
13486,2023-07-16 22:00:00,123,295,9,10,732,617,115,11
13487,2023-07-16 23:00:00,131,294,6,15,642,523,119,11
13488,2023-07-17 00:00:00,126,265,14,19,770,590,180,8
13489,2023-07-17 01:00:00,130,278,12,15,759,558,201,12
13490,2023-07-17 02:00:00,131,268,8,10,591,485,106,10
13491,2023-07-17 03:00:00,125,294,11,17,696,509,187,11
13492,2023-07-17 04:00:00,126,257,11,11,596,446,150,5
13493,2023-07-17 05:00:00,131,285,14,19,703,591,112,10
13494,2023-07-17 06:00:00,134,262,8,18,557,494,63,9
13495,2023-07-17 07:00:00,129,267,9,11,790,685,105,8
13496,2023-07-17 08:00:00,136,272,7,10,717,515,202,9
13497,2023-07-17 09:00:00,149,278,8,18,768,634,134,8
13498,2023-07-17 10:00:00,124,254,14,17,719,514,205,7
13499,2023-07-17 11:00:00,127,283,11,19,654,578,76,7
13500,2023-07-17 12:00:00,135,269,5,17,562,492,70,12
13501,2023-07-17 13:00:00,132,252,12,13,680,576,104,11
13502,2023-07-17 14:00:00,134,277,5,18,753,629,124,10
13503,2023-07-17 15:00:00,132,295,5,18,543,460,83,11
13504,2023-07-17 16:00:00,122,285,12,12,790,558,232,14
13505,2023-07-17 17:00:00,140,268,8,15,586,505,81,8
13506,2023-07-17 18:00:00,126,284,7,14,743,534,209,9
13507,2023-07-17 19:00:00,126,276,10,12,745,610,135,13
13508,2023-07-17 20:00:00,133,294,8,14,553,427,126,9
13509,2023-07-17 21:00:00,129,264,14,13,612,544,68,5
13510,2023-07-17 22:00:00,125,265,11,12,513,374,139,9
13511,2023-07-17 23:00:00,126,290,12,14,573,496,77,8
13512,2023-07-18 00:00:00,143,263,8,19,671,580,91,8
13513,2023-07-18 01:00:00,144,285,12,15,591,432,159,9
13514,2023-07-18 02:00:00,148,297,6,11,661,487,174,6
13515,2023-07-18 03:00:00,135,285,8,16,793,626,167,12
13516,2023-07-18 04:00:00,135,297,8,16,754,672,82,14
13517,2023-07-18 05:00:00,125,255,10,10,618,512,106,11
13518,2023-07-18 06:00:00,126,270,14,16,631,490,141,7
13519,2023-07-18 07:00:00,146,283,14,10,621,447,174,12
13520,2023-07-18 08:00:00,134,270,10,11,720,585,135,6
13521,2023-07-18 09:00:00,135,288,14,17,551,439,112,11
13522,2023-07-18 10:00:00,130,286,14,18,752,626,126,13
13523,2023-07-18 11:00:00,131,275,6,18,619,555,64,8
13524,2023-07-18 12:00:00,125,285,8,16,730,556,174,5
13525,2023-07-18 13:00:00,149,262,14,14,537,424,113,11
13526,2023-07-18 14:00:00,124,253,11,17,780,619,161,14
13527,2023-07-18 15:00:00,128,274,9,12,698,561,137,8
13528,2023-07-18 16:00:00,142,298,8,10,698,614,84,9
13529,2023-07-18 17:00:00,131,259,12,11,645,513,132,7
13530,2023-07-18 18:00:00,120,274,6,15,553,418,135,5
13531,2023-07-18 19:00:00,145,253,13,19,724,529,195,5
13532,2023-07-18 20:00:00,130,297,12,16,581,515,66,9
13533,2023-07-18 21:00:00,148,288,8,13,594,523,71,6
13534,2023-07-18 22:00:00,137,269,6,11,789,668,121,6
13535,2023-07-18 23:00:00,132,262,5,12,602,487,115,9
13536,2023-07-19 00:00:00,120,280,11,18,741,586,155,11
13537,2023-07-19 01:00:00,128,263,10,13,758,623,135,13
13538,2023-07-19 02:00:00,146,296,9,11,703,559,144,13
13539,2023-07-19 03:00:00,120,265,8,14,786,650,136,8
13540,2023-07-19 04:00:00,137,268,9,14,796,612,184,10
13541,2023-07-19 05:00:00,120,289,9,13,738,522,216,7
13542,2023-07-19 06:00:00,146,298,10,16,523,448,75,5
13543,2023-07-19 07:00:00,122,270,8,11,691,511,180,9
13544,2023-07-19 08:00:00,131,299,13,10,733,605,128,12
13545,2023-07-19 09:00:00,132,273,10,15,760,547,213,6
13546,2023-07-19 10:00:00,128,260,5,13,766,590,176,10
13547,2023-07-19 11:00:00,127,261,12,16,550,400,150,5
13548,2023-07-19 12:00:00,138,264,9,15,731,536,195,10
13549,2023-07-19 13:00:00,131,269,12,10,635,487,148,11
13550,2023-07-19 14:00:00,146,259,7,18,514,380,134,6
13551,2023-07-19 15:00:00,144,296,6,10,548,456,92,9
13552,2023-07-19 16:00:00,132,281,10,16,786,684,102,12
13553,2023-07-19 17:00:00,145,275,5,10,606,507,99,8
13554,2023-07-19 18:00:00,149,255,13,11,507,358,149,11
13555,2023-07-19 19:00:00,127,285,6,17,592,509,83,11
13556,2023-07-19 20:00:00,128,286,5,16,684,547,137,7
13557,2023-07-19 21:00:00,141,271,13,13,706,530,176,10
13558,2023-07-19 22:00:00,144,263,8,17,664,525,139,6
13559,2023-07-19 23:00:00,126,295,7,16,559,448,111,10
13560,2023-07-20 00:00:00,134,265,10,15,765,682,83,13
13561,2023-07-20 01:00:00,143,282,6,12,528,448,80,8
13562,2023-07-20 02:00:00,138,292,10,19,676,514,162,10
13563,2023-07-20 03:00:00,129,269,8,11,746,539,207,7
13564,2023-07-20 04:00:00,142,261,10,17,704,511,193,5
13565,2023-07-20 05:00:00,132,267,5,19,534,441,93,9
13566,2023-07-20 06:00:00,148,299,14,17,514,392,122,9
13567,2023-07-20 07:00:00,144,297,6,12,572,461,111,11
13568,2023-07-20 08:00:00,124,295,5,10,609,460,149,9
13569,2023-07-20 09:00:00,124,282,10,19,593,454,139,5
13570,2023-07-20 10:00:00,127,258,10,19,741,651,90,5
13571,2023-07-20 11:00:00,140,268,13,14,675,604,71,10
13572,2023-07-20 12:00:00,129,256,11,13,790,573,217,12
13573,2023-07-20 13:00:00,122,267,8,10,710,630,80,10
13574,2023-07-20 14:00:00,133,275,12,13,529,459,70,9
13575,2023-07-20 15:00:00,143,259,10,11,760,662,98,5
13576,2023-07-20 16:00:00,146,251,11,18,578,519,59,5
13577,2023-07-20 17:00:00,143,259,7,10,714,504,210,13
13578,2023-07-20 18:00:00,145,260,11,19,665,511,154,10
13579,2023-07-20 19:00:00,146,284,8,11,577,506,71,12
13580,2023-07-20 20:00:00,129,269,13,10,697,578,119,12
13581,2023-07-20 21:00:00,147,298,13,10,776,615,161,13
13582,2023-07-20 22:00:00,141,274,5,16,768,586,182,14
13583,2023-07-20 23:00:00,132,288,6,18,658,486,172,7
13584,2023-07-21 00:00:00,123,259,10,16,505,453,52,9
13585,2023-07-21 01:00:00,144,257,10,19,794,608,186,14
13586,2023-07-21 02:00:00,148,252,14,16,621,523,98,9
13587,2023-07-21 03:00:00,122,277,13,19,753,629,124,9
13588,2023-07-21 04:00:00,145,265,8,16,668,554,114,11
13589,2023-07-21 05:00:00,143,282,7,10,700,602,98,9
13590,2023-07-21 06:00:00,134,265,11,16,647,524,123,8
13591,2023-07-21 07:00:00,126,253,12,17,550,488,62,6
13592,2023-07-21 08:00:00,130,288,5,19,618,500,118,13
13593,2023-07-21 09:00:00,126,252,14,11,570,442,128,10
13594,2023-07-21 10:00:00,130,251,10,12,595,436,159,6
13595,2023-07-21 11:00:00,125,276,5,17,711,523,188,13
13596,2023-07-21 12:00:00,148,283,10,13,771,669,102,6
13597,2023-07-21 13:00:00,125,258,12,18,704,586,118,7
13598,2023-07-21 14:00:00,127,287,6,11,556,447,109,12
13599,2023-07-21 15:00:00,129,291,7,17,593,507,86,10
13600,2023-07-21 16:00:00,147,252,9,14,735,547,188,11
13601,2023-07-21 17:00:00,136,294,6,18,796,661,135,5
13602,2023-07-21 18:00:00,122,283,10,11,630,504,126,9
13603,2023-07-21 19:00:00,148,291,11,14,738,538,200,13
13604,2023-07-21 20:00:00,143,264,8,14,655,543,112,12
13605,2023-07-21 21:00:00,141,275,6,10,751,557,194,9
13606,2023-07-21 22:00:00,146,279,5,19,798,588,210,5
13607,2023-07-21 23:00:00,129,267,5,14,539,424,115,11
13608,2023-07-22 00:00:00,133,280,13,18,507,409,98,9
13609,2023-07-22 01:00:00,143,275,12,16,601,527,74,8
13610,2023-07-22 02:00:00,127,260,10,15,641,563,78,13
13611,2023-07-22 03:00:00,143,276,14,11,640,461,179,5
13612,2023-07-22 04:00:00,136,294,11,19,577,494,83,14
13613,2023-07-22 05:00:00,139,255,13,13,737,586,151,6
13614,2023-07-22 06:00:00,146,269,7,18,531,421,110,8
13615,2023-07-22 07:00:00,135,296,11,19,693,614,79,12
13616,2023-07-22 08:00:00,143,280,6,19,662,562,100,8
13617,2023-07-22 09:00:00,131,275,14,16,661,561,100,6
13618,2023-07-22 10:00:00,124,253,14,14,584,447,137,6
13619,2023-07-22 11:00:00,139,296,14,15,592,522,70,6
13620,2023-07-22 12:00:00,135,267,14,17,506,367,139,6
13621,2023-07-22 13:00:00,140,265,14,19,717,637,80,7
13622,2023-07-22 14:00:00,144,257,7,12,626,547,79,14
13623,2023-07-22 15:00:00,136,286,10,10,652,491,161,6
13624,2023-07-22 16:00:00,126,254,14,10,722,564,158,8
13625,2023-07-22 17:00:00,138,250,5,15,639,494,145,6
13626,2023-07-22 18:00:00,142,275,6,18,566,479,87,7
13627,2023-07-22 19:00:00,128,265,8,14,753,605,148,14
13628,2023-07-22 20:00:00,149,268,13,13,788,682,106,9
13629,2023-07-22 21:00:00,141,282,11,13,705,590,115,9
13630,2023-07-22 22:00:00,148,274,11,10,527,413,114,5
13631,2023-07-22 23:00:00,141,291,13,15,749,609,140,13
13632,2023-07-23 00:00:00,124,282,10,11,505,445,60,11
13633,2023-07-23 01:00:00,130,253,12,17,561,452,109,9
13634,2023-07-23 02:00:00,129,278,11,13,516,363,153,6
13635,2023-07-23 03:00:00,147,293,14,13,728,511,217,10
13636,2023-07-23 04:00:00,135,259,11,14,594,467,127,14
13637,2023-07-23 05:00:00,132,293,7,10,553,452,101,9
13638,2023-07-23 06:00:00,133,268,10,18,711,629,82,7
13639,2023-07-23 07:00:00,143,268,8,19,763,558,205,10
13640,2023-07-23 08:00:00,140,253,9,13,517,462,55,12
13641,2023-07-23 09:00:00,136,277,11,16,682,593,89,6
13642,2023-07-23 10:00:00,137,283,10,11,563,453,110,8
13643,2023-07-23 11:00:00,144,266,12,15,782,680,102,10
13644,2023-07-23 12:00:00,131,255,6,17,648,534,114,10
13645,2023-07-23 13:00:00,120,252,10,12,669,593,76,10
13646,2023-07-23 14:00:00,137,254,14,17,621,529,92,11
13647,2023-07-23 15:00:00,132,290,7,16,649,518,131,13
13648,2023-07-23 16:00:00,135,269,12,17,719,547,172,5
13649,2023-07-23 17:00:00,132,287,6,15,620,462,158,10
13650,2023-07-23 18:00:00,132,255,10,18,728,633,95,13
13651,2023-07-23 19:00:00,124,287,7,11,738,610,128,7
13652,2023-07-23 20:00:00,138,272,7,17,726,613,113,10
13653,2023-07-23 21:00:00,128,256,14,10,749,632,117,5
13654,2023-07-23 22:00:00,125,266,12,11,616,468,148,7
13655,2023-07-23 23:00:00,149,293,7,13,625,475,150,5
13656,2023-07-24 00:00:00,138,250,10,11,571,481,90,13
13657,2023-07-24 01:00:00,129,286,9,12,683,499,184,5
13658,2023-07-24 02:00:00,148,274,8,19,789,669,120,6
13659,2023-07-24 03:00:00,123,298,12,10,664,500,164,6
13660,2023-07-24 04:00:00,145,259,9,12,673,583,90,11
13661,2023-07-24 05:00:00,148,254,9,11,759,573,186,9
13662,2023-07-24 06:00:00,120,254,14,14,741,567,174,5
13663,2023-07-24 07:00:00,148,291,12,10,608,436,172,14
13664,2023-07-24 08:00:00,139,262,11,15,737,584,153,13
13665,2023-07-24 09:00:00,130,269,5,15,522,396,126,6
13666,2023-07-24 10:00:00,121,283,7,16,662,527,135,6
13667,2023-07-24 11:00:00,131,296,10,13,688,518,170,11
13668,2023-07-24 12:00:00,124,287,12,14,637,479,158,11
13669,2023-07-24 13:00:00,124,298,9,19,522,429,93,7
13670,2023-07-24 14:00:00,133,262,9,13,660,470,190,9
13671,2023-07-24 15:00:00,138,286,5,16,733,607,126,12
13672,2023-07-24 16:00:00,140,284,8,19,649,480,169,11
13673,2023-07-24 17:00:00,129,291,12,16,555,470,85,10
13674,2023-07-24 18:00:00,136,286,13,11,655,564,91,12
13675,2023-07-24 19:00:00,123,265,11,12,721,591,130,7
13676,2023-07-24 20:00:00,137,258,5,16,581,515,66,11
13677,2023-07-24 21:00:00,133,280,11,10,718,587,131,11
13678,2023-07-24 22:00:00,120,288,14,12,701,543,158,10
13679,2023-07-24 23:00:00,126,289,10,11,709,634,75,11
13680,2023-07-25 00:00:00,129,254,6,19,674,493,181,5
13681,2023-07-25 01:00:00,123,253,14,17,569,410,159,9
13682,2023-07-25 02:00:00,131,285,12,11,582,446,136,11
13683,2023-07-25 03:00:00,125,250,10,11,702,545,157,13
13684,2023-07-25 04:00:00,142,270,8,15,683,539,144,6
13685,2023-07-25 05:00:00,130,269,6,19,723,576,147,5
13686,2023-07-25 06:00:00,139,273,8,13,502,434,68,14
13687,2023-07-25 07:00:00,149,259,8,19,549,458,91,6
13688,2023-07-25 08:00:00,125,293,5,16,573,480,93,13
13689,2023-07-25 09:00:00,132,258,13,19,552,453,99,6
13690,2023-07-25 10:00:00,130,275,13,13,775,696,79,11
13691,2023-07-25 11:00:00,148,298,14,16,793,650,143,14
13692,2023-07-25 12:00:00,129,265,7,11,684,562,122,5
13693,2023-07-25 13:00:00,125,260,8,10,615,479,136,11
13694,2023-07-25 14:00:00,148,289,5,19,726,557,169,5
13695,2023-07-25 15:00:00,134,260,9,16,635,570,65,10
13696,2023-07-25 16:00:00,130,255,9,11,650,521,129,7
13697,2023-07-25 17:00:00,148,290,11,17,741,615,126,12
13698,2023-07-25 18:00:00,136,294,8,13,780,667,113,11
13699,2023-07-25 19:00:00,137,266,6,11,530,417,113,8
13700,2023-07-25 20:00:00,127,299,9,15,692,487,205,9
13701,2023-07-25 21:00:00,127,291,10,12,648,495,153,13
13702,2023-07-25 22:00:00,133,261,11,19,733,588,145,7
13703,2023-07-25 23:00:00,125,277,7,14,592,496,96,5
13704,2023-07-26 00:00:00,132,284,9,18,589,481,108,7
13705,2023-07-26 01:00:00,149,279,5,14,718,566,152,5
13706,2023-07-26 02:00:00,140,265,14,16,623,449,174,7
13707,2023-07-26 03:00:00,124,293,11,11,537,477,60,8
13708,2023-07-26 04:00:00,144,263,7,18,714,588,126,13
13709,2023-07-26 05:00:00,136,267,7,10,697,615,82,7
13710,2023-07-26 06:00:00,131,296,10,12,797,600,197,6
13711,2023-07-26 07:00:00,140,253,11,18,751,547,204,6
13712,2023-07-26 08:00:00,143,250,10,10,571,500,71,8
13713,2023-07-26 09:00:00,125,284,11,18,518,383,135,8
13714,2023-07-26 10:00:00,131,283,12,12,578,482,96,8
13715,2023-07-26 11:00:00,147,295,11,13,706,554,152,12
13716,2023-07-26 12:00:00,130,252,6,12,692,527,165,14
13717,2023-07-26 13:00:00,127,260,13,12,685,519,166,12
13718,2023-07-26 14:00:00,143,297,5,16,519,390,129,7
13719,2023-07-26 15:00:00,127,255,8,12,684,552,132,7
13720,2023-07-26 16:00:00,137,259,14,19,630,512,118,14
13721,2023-07-26 17:00:00,123,280,14,14,736,566,170,6
13722,2023-07-26 18:00:00,149,285,6,10,613,532,81,12
13723,2023-07-26 19:00:00,148,296,12,18,717,576,141,7
13724,2023-07-26 20:00:00,120,274,9,19,540,418,122,11
13725,2023-07-26 21:00:00,129,275,6,19,528,464,64,7
13726,2023-07-26 22:00:00,129,286,8,17,748,542,206,10
13727,2023-07-26 23:00:00,134,280,7,10,718,570,148,8
13728,2023-07-27 00:00:00,141,280,9,16,570,448,122,11
13729,2023-07-27 01:00:00,120,276,8,13,539,386,153,12
13730,2023-07-27 02:00:00,128,262,6,19,654,564,90,13
13731,2023-07-27 03:00:00,138,275,6,13,634,495,139,10
13732,2023-07-27 04:00:00,139,288,14,16,551,420,131,7
13733,2023-07-27 05:00:00,125,267,11,15,737,644,93,10
13734,2023-07-27 06:00:00,127,281,6,19,667,580,87,9
13735,2023-07-27 07:00:00,123,276,8,13,633,503,130,14
13736,2023-07-27 08:00:00,141,283,12,15,780,701,79,13
13737,2023-07-27 09:00:00,120,289,6,17,603,434,169,6
13738,2023-07-27 10:00:00,128,266,10,16,588,523,65,13
13739,2023-07-27 11:00:00,128,294,10,19,660,568,92,8
13740,2023-07-27 12:00:00,144,269,10,10,646,561,85,11
13741,2023-07-27 13:00:00,125,296,11,15,665,466,199,12
13742,2023-07-27 14:00:00,149,286,10,14,613,430,183,14
13743,2023-07-27 15:00:00,134,284,6,17,763,539,224,9
13744,2023-07-27 16:00:00,142,258,11,14,662,580,82,7
13745,2023-07-27 17:00:00,145,271,9,16,749,574,175,7
13746,2023-07-27 18:00:00,149,254,12,19,664,513,151,14
13747,2023-07-27 19:00:00,120,261,14,13,750,635,115,9
13748,2023-07-27 20:00:00,145,288,11,16,585,463,122,7
13749,2023-07-27 21:00:00,127,287,12,15,708,595,113,12
13750,2023-07-27 22:00:00,127,259,7,10,573,506,67,14
13751,2023-07-27 23:00:00,144,295,12,15,575,433,142,7
13752,2023-07-28 00:00:00,133,274,5,16,574,408,166,5
13753,2023-07-28 01:00:00,134,298,10,17,723,586,137,5
13754,2023-07-28 02:00:00,141,265,14,13,697,556,141,11
13755,2023-07-28 03:00:00,132,277,12,14,628,503,125,8
13756,2023-07-28 04:00:00,132,267,8,14,589,431,158,10
13757,2023-07-28 05:00:00,140,270,7,15,744,530,214,5
13758,2023-07-28 06:00:00,136,261,13,16,700,541,159,9
13759,2023-07-28 07:00:00,129,275,7,14,521,379,142,11
13760,2023-07-28 08:00:00,147,273,7,17,651,457,194,12
13761,2023-07-28 09:00:00,126,291,10,11,706,508,198,12
13762,2023-07-28 10:00:00,135,254,14,17,647,540,107,13
13763,2023-07-28 11:00:00,135,285,10,14,604,537,67,13
13764,2023-07-28 12:00:00,137,268,5,10,706,528,178,12
13765,2023-07-28 13:00:00,132,252,14,13,504,436,68,14
13766,2023-07-28 14:00:00,122,276,8,10,667,520,147,9
13767,2023-07-28 15:00:00,127,257,12,19,691,541,150,12
13768,2023-07-28 16:00:00,127,259,13,18,691,613,78,6
13769,2023-07-28 17:00:00,135,260,5,19,746,617,129,7
13770,2023-07-28 18:00:00,133,260,14,15,714,499,215,7
13771,2023-07-28 19:00:00,132,275,10,12,557,408,149,6
13772,2023-07-28 20:00:00,130,298,9,15,755,578,177,13
13773,2023-07-28 21:00:00,122,281,8,19,674,527,147,10
13774,2023-07-28 22:00:00,147,298,9,15,674,538,136,8
13775,2023-07-28 23:00:00,128,256,10,15,670,497,173,10
13776,2023-07-29 00:00:00,142,278,8,18,678,590,88,10
13777,2023-07-29 01:00:00,129,291,9,15,527,469,58,10
13778,2023-07-29 02:00:00,144,294,6,13,685,615,70,11
13779,2023-07-29 03:00:00,148,268,10,16,662,546,116,8
13780,2023-07-29 04:00:00,121,288,13,14,744,572,172,12
13781,2023-07-29 05:00:00,123,253,14,12,660,531,129,6
13782,2023-07-29 06:00:00,138,292,14,17,706,560,146,8
13783,2023-07-29 07:00:00,138,287,11,15,566,445,121,6
13784,2023-07-29 08:00:00,131,298,5,11,634,490,144,11
13785,2023-07-29 09:00:00,134,285,11,13,638,515,123,14
13786,2023-07-29 10:00:00,140,276,13,14,653,532,121,6
13787,2023-07-29 11:00:00,128,285,12,10,650,543,107,9
13788,2023-07-29 12:00:00,132,280,8,17,579,486,93,8
13789,2023-07-29 13:00:00,129,280,11,12,612,442,170,6
13790,2023-07-29 14:00:00,120,267,13,18,782,630,152,13
13791,2023-07-29 15:00:00,143,272,12,19,643,506,137,11
13792,2023-07-29 16:00:00,133,279,13,16,754,596,158,6
13793,2023-07-29 17:00:00,148,253,11,18,788,626,162,9
13794,2023-07-29 18:00:00,145,283,12,10,593,521,72,7
13795,2023-07-29 19:00:00,142,268,12,15,555,479,76,7
13796,2023-07-29 20:00:00,128,299,6,13,507,426,81,5
13797,2023-07-29 21:00:00,128,293,5,16,773,568,205,14
13798,2023-07-29 22:00:00,126,268,13,15,751,672,79,14
13799,2023-07-29 23:00:00,127,275,8,19,638,535,103,10
13800,2023-07-30 00:00:00,133,284,6,11,778,640,138,13
13801,2023-07-30 01:00:00,136,271,12,12,686,497,189,14
13802,2023-07-30 02:00:00,126,288,10,19,670,486,184,8
13803,2023-07-30 03:00:00,127,287,12,14,671,488,183,13
13804,2023-07-30 04:00:00,130,275,10,14,680,552,128,8
13805,2023-07-30 05:00:00,124,262,9,18,707,597,110,7
13806,2023-07-30 06:00:00,149,260,8,16,792,642,150,13
13807,2023-07-30 07:00:00,139,252,6,18,587,507,80,12
13808,2023-07-30 08:00:00,124,258,10,12,638,503,135,11
13809,2023-07-30 09:00:00,135,258,13,17,761,627,134,7
13810,2023-07-30 10:00:00,139,283,10,16,500,388,112,13
13811,2023-07-30 11:00:00,145,278,10,10,536,435,101,11
13812,2023-07-30 12:00:00,133,286,13,19,734,527,207,6
13813,2023-07-30 13:00:00,123,261,12,16,532,459,73,10
13814,2023-07-30 14:00:00,149,266,9,13,737,611,126,14
13815,2023-07-30 15:00:00,139,271,14,13,564,438,126,8
13816,2023-07-30 16:00:00,121,269,7,11,606,539,67,6
13817,2023-07-30 17:00:00,148,267,7,11,554,498,56,6
13818,2023-07-30 18:00:00,131,297,5,19,504,362,142,10
13819,2023-07-30 19:00:00,146,291,12,15,605,430,175,10
13820,2023-07-30 20:00:00,134,299,14,15,579,413,166,14
13821,2023-07-30 21:00:00,140,279,7,15,627,524,103,6
13822,2023-07-30 22:00:00,125,274,13,15,701,512,189,9
13823,2023-07-30 23:00:00,144,293,10,19,570,497,73,14
13824,2023-07-31 00:00:00,122,267,9,11,609,439,170,8
13825,2023-07-31 01:00:00,126,269,7,12,701,625,76,10
13826,2023-07-31 02:00:00,139,267,7,17,554,428,126,7
13827,2023-07-31 03:00:00,144,251,8,15,795,589,206,14
13828,2023-07-31 04:00:00,134,275,9,17,753,626,127,9
13829,2023-07-31 05:00:00,131,281,9,16,560,422,138,6
13830,2023-07-31 06:00:00,134,253,5,12,508,439,69,8
13831,2023-07-31 07:00:00,145,254,13,11,623,444,179,12
13832,2023-07-31 08:00:00,123,281,8,15,743,665,78,6
13833,2023-07-31 09:00:00,149,263,5,16,549,434,115,11
13834,2023-07-31 10:00:00,137,296,7,10,637,534,103,11
13835,2023-07-31 11:00:00,122,295,10,10,778,682,96,12
13836,2023-07-31 12:00:00,143,255,12,12,590,432,158,12
13837,2023-07-31 13:00:00,126,291,14,17,684,533,151,8
13838,2023-07-31 14:00:00,136,250,10,18,660,497,163,11
13839,2023-07-31 15:00:00,126,263,10,16,522,402,120,13
13840,2023-07-31 16:00:00,121,254,11,19,592,459,133,11
13841,2023-07-31 17:00:00,131,257,11,17,601,442,159,6
13842,2023-07-31 18:00:00,144,289,10,14,565,447,118,5
13843,2023-07-31 19:00:00,120,290,10,12,596,502,94,10
13844,2023-07-31 20:00:00,137,295,6,15,715,576,139,11
13845,2023-07-31 21:00:00,130,279,8,15,718,622,96,14
13846,2023-07-31 22:00:00,144,263,6,18,514,405,109,6
13847,2023-07-31 23:00:00,146,278,10,13,580,459,121,5
13848,2023-08-01 00:00:00,123,251,5,15,521,415,106,14
13849,2023-08-01 01:00:00,139,285,8,10,688,588,100,5
13850,2023-08-01 02:00:00,140,267,13,15,795,581,214,12
13851,2023-08-01 03:00:00,134,266,14,15,766,654,112,9
13852,2023-08-01 04:00:00,143,265,13,13,705,567,138,10
13853,2023-08-01 05:00:00,125,283,9,10,561,478,83,8
13854,2023-08-01 06:00:00,128,266,10,13,581,509,72,9
13855,2023-08-01 07:00:00,146,266,11,19,737,542,195,10
13856,2023-08-01 08:00:00,130,287,7,18,502,423,79,14
13857,2023-08-01 09:00:00,144,251,13,11,515,449,66,7
13858,2023-08-01 10:00:00,124,285,12,15,656,484,172,11
13859,2023-08-01 11:00:00,142,285,10,19,547,454,93,6
13860,2023-08-01 12:00:00,141,291,11,14,747,650,97,6
13861,2023-08-01 13:00:00,144,265,9,16,516,385,131,12
13862,2023-08-01 14:00:00,127,257,11,15,690,486,204,5
13863,2023-08-01 15:00:00,144,290,6,16,596,525,71,11
13864,2023-08-01 16:00:00,130,295,9,12,725,519,206,8
13865,2023-08-01 17:00:00,126,254,13,13,648,488,160,9
13866,2023-08-01 18:00:00,137,287,10,12,791,578,213,9
13867,2023-08-01 19:00:00,138,284,6,14,528,423,105,12
13868,2023-08-01 20:00:00,130,267,5,16,691,567,124,11
13869,2023-08-01 21:00:00,146,288,5,14,579,504,75,9
13870,2023-08-01 22:00:00,130,272,5,18,797,675,122,7
13871,2023-08-01 23:00:00,140,299,7,11,776,551,225,9
13872,2023-08-02 00:00:00,121,271,10,13,790,641,149,7
13873,2023-08-02 01:00:00,141,260,14,14,571,447,124,8
13874,2023-08-02 02:00:00,136,274,6,19,562,447,115,8
13875,2023-08-02 03:00:00,125,270,9,14,620,465,155,5
13876,2023-08-02 04:00:00,128,298,14,16,501,361,140,12
13877,2023-08-02 05:00:00,122,257,11,14,578,447,131,13
13878,2023-08-02 06:00:00,129,277,13,18,743,530,213,7
13879,2023-08-02 07:00:00,125,269,5,12,722,568,154,8
13880,2023-08-02 08:00:00,136,257,11,14,634,506,128,11
13881,2023-08-02 09:00:00,146,280,9,17,695,489,206,14
13882,2023-08-02 10:00:00,121,295,5,15,532,385,147,12
13883,2023-08-02 11:00:00,128,293,5,19,563,422,141,8
13884,2023-08-02 12:00:00,142,264,11,14,640,512,128,9
13885,2023-08-02 13:00:00,149,295,7,12,609,430,179,14
13886,2023-08-02 14:00:00,131,267,13,15,627,444,183,7
13887,2023-08-02 15:00:00,142,271,10,17,710,555,155,12
13888,2023-08-02 16:00:00,135,254,12,12,687,486,201,11
13889,2023-08-02 17:00:00,145,252,9,13,542,444,98,6
13890,2023-08-02 18:00:00,146,269,8,19,790,690,100,13
13891,2023-08-02 19:00:00,143,266,6,17,626,529,97,6
13892,2023-08-02 20:00:00,141,255,5,13,624,544,80,6
13893,2023-08-02 21:00:00,125,264,11,15,768,618,150,6
13894,2023-08-02 22:00:00,146,275,12,13,694,615,79,8
13895,2023-08-02 23:00:00,121,275,6,11,732,531,201,8
13896,2023-08-03 00:00:00,122,256,14,11,660,569,91,13
13897,2023-08-03 01:00:00,135,253,9,11,616,434,182,13
13898,2023-08-03 02:00:00,139,299,6,11,674,526,148,10
13899,2023-08-03 03:00:00,130,270,9,14,796,627,169,9
13900,2023-08-03 04:00:00,132,288,5,17,666,516,150,5
13901,2023-08-03 05:00:00,124,283,14,13,706,556,150,12
13902,2023-08-03 06:00:00,140,295,8,11,754,574,180,13
13903,2023-08-03 07:00:00,121,265,14,19,503,405,98,8
13904,2023-08-03 08:00:00,135,258,14,19,676,537,139,13
13905,2023-08-03 09:00:00,141,252,14,16,690,506,184,9
13906,2023-08-03 10:00:00,138,273,5,10,783,629,154,9
13907,2023-08-03 11:00:00,138,291,7,13,678,500,178,8
13908,2023-08-03 12:00:00,126,281,10,15,691,515,176,11
13909,2023-08-03 13:00:00,144,260,12,11,725,647,78,6
13910,2023-08-03 14:00:00,149,267,10,18,722,597,125,7
13911,2023-08-03 15:00:00,146,277,6,16,662,509,153,12
13912,2023-08-03 16:00:00,120,265,14,13,782,671,111,11
13913,2023-08-03 17:00:00,121,287,11,16,611,545,66,12
13914,2023-08-03 18:00:00,135,278,14,14,670,597,73,13
13915,2023-08-03 19:00:00,134,257,8,17,702,530,172,8
13916,2023-08-03 20:00:00,142,274,8,15,567,398,169,7
13917,2023-08-03 21:00:00,144,252,13,15,622,436,186,8
13918,2023-08-03 22:00:00,131,283,7,13,526,438,88,14
13919,2023-08-03 23:00:00,136,251,14,16,779,605,174,14
13920,2023-08-04 00:00:00,148,262,5,13,537,381,156,11
13921,2023-08-04 01:00:00,147,262,13,13,680,496,184,14
13922,2023-08-04 02:00:00,126,251,10,10,543,487,56,11
13923,2023-08-04 03:00:00,137,257,9,18,559,459,100,7
13924,2023-08-04 04:00:00,125,270,10,16,693,496,197,5
13925,2023-08-04 05:00:00,123,252,8,13,616,453,163,10
13926,2023-08-04 06:00:00,140,262,11,14,795,567,228,10
13927,2023-08-04 07:00:00,126,272,12,18,656,539,117,7
13928,2023-08-04 08:00:00,140,269,13,13,726,582,144,6
13929,2023-08-04 09:00:00,138,276,6,19,685,514,171,5
13930,2023-08-04 10:00:00,126,270,10,12,735,631,104,13
13931,2023-08-04 11:00:00,120,265,13,17,589,443,146,11
13932,2023-08-04 12:00:00,121,283,12,10,767,541,226,10
13933,2023-08-04 13:00:00,130,254,13,12,528,451,77,7
13934,2023-08-04 14:00:00,134,297,9,17,649,559,90,7
13935,2023-08-04 15:00:00,142,261,12,19,665,540,125,13
13936,2023-08-04 16:00:00,135,266,13,14,730,545,185,12
13937,2023-08-04 17:00:00,126,271,10,19,699,580,119,12
13938,2023-08-04 18:00:00,122,276,7,14,756,561,195,14
13939,2023-08-04 19:00:00,137,266,13,15,571,481,90,5
13940,2023-08-04 20:00:00,136,281,11,13,580,439,141,5
13941,2023-08-04 21:00:00,120,291,12,18,768,632,136,5
13942,2023-08-04 22:00:00,143,264,12,18,726,633,93,8
13943,2023-08-04 23:00:00,136,283,14,17,734,644,90,10
13944,2023-08-05 00:00:00,133,271,11,19,567,491,76,10
13945,2023-08-05 01:00:00,129,251,10,10,789,698,91,8
13946,2023-08-05 02:00:00,144,296,13,15,568,505,63,11
13947,2023-08-05 03:00:00,127,299,8,12,585,485,100,5
13948,2023-08-05 04:00:00,137,291,13,18,520,422,98,7
13949,2023-08-05 05:00:00,136,284,14,17,755,533,222,5
13950,2023-08-05 06:00:00,128,282,11,13,616,498,118,12
13951,2023-08-05 07:00:00,134,252,11,14,782,597,185,6
13952,2023-08-05 08:00:00,131,252,10,12,734,547,187,5
13953,2023-08-05 09:00:00,131,278,14,19,560,419,141,5
13954,2023-08-05 10:00:00,126,272,12,11,685,496,189,5
13955,2023-08-05 11:00:00,131,258,7,17,512,363,149,7
13956,2023-08-05 12:00:00,126,295,7,11,731,609,122,12
13957,2023-08-05 13:00:00,136,258,12,12,564,423,141,12
13958,2023-08-05 14:00:00,148,295,11,10,695,530,165,10
13959,2023-08-05 15:00:00,148,258,8,11,605,471,134,14
13960,2023-08-05 16:00:00,139,259,12,18,646,558,88,11
13961,2023-08-05 17:00:00,129,278,7,17,727,543,184,10
13962,2023-08-05 18:00:00,121,275,5,14,505,400,105,13
13963,2023-08-05 19:00:00,130,286,8,15,519,363,156,13
13964,2023-08-05 20:00:00,122,278,11,19,500,377,123,11
13965,2023-08-05 21:00:00,144,289,5,13,612,483,129,6
13966,2023-08-05 22:00:00,145,262,10,18,723,568,155,6
13967,2023-08-05 23:00:00,123,284,5,13,613,454,159,6
13968,2023-08-06 00:00:00,134,260,14,11,777,651,126,11
13969,2023-08-06 01:00:00,143,297,6,17,590,415,175,10
13970,2023-08-06 02:00:00,139,281,12,13,570,470,100,7
13971,2023-08-06 03:00:00,136,269,5,15,681,513,168,12
13972,2023-08-06 04:00:00,133,255,14,14,787,620,167,7
13973,2023-08-06 05:00:00,147,280,6,13,750,659,91,7
13974,2023-08-06 06:00:00,133,261,12,18,750,667,83,5
13975,2023-08-06 07:00:00,142,279,5,19,518,409,109,5
13976,2023-08-06 08:00:00,139,283,5,11,632,508,124,10
13977,2023-08-06 09:00:00,135,272,10,16,767,681,86,5
13978,2023-08-06 10:00:00,129,285,14,16,632,467,165,5
13979,2023-08-06 11:00:00,140,275,7,17,591,421,170,11
13980,2023-08-06 12:00:00,141,257,12,15,750,618,132,12
13981,2023-08-06 13:00:00,129,295,10,19,648,580,68,9
13982,2023-08-06 14:00:00,149,272,6,17,713,540,173,13
13983,2023-08-06 15:00:00,125,299,8,13,575,513,62,10
13984,2023-08-06 16:00:00,125,260,12,10,564,399,165,14
13985,2023-08-06 17:00:00,129,277,12,19,523,459,64,11
13986,2023-08-06 18:00:00,128,297,13,16,583,480,103,6
13987,2023-08-06 19:00:00,123,258,10,11,731,553,178,6
13988,2023-08-06 20:00:00,147,256,8,19,693,491,202,7
13989,2023-08-06 21:00:00,131,277,7,14,798,700,98,11
13990,2023-08-06 22:00:00,143,298,12,17,698,488,210,6
13991,2023-08-06 23:00:00,135,285,5,18,662,571,91,13
13992,2023-08-07 00:00:00,120,275,5,14,631,479,152,8
13993,2023-08-07 01:00:00,136,283,8,14,707,603,104,13
13994,2023-08-07 02:00:00,145,272,14,11,785,585,200,10
13995,2023-08-07 03:00:00,144,255,5,17,735,576,159,9
13996,2023-08-07 04:00:00,137,260,9,13,791,579,212,13
13997,2023-08-07 05:00:00,131,265,9,15,659,466,193,6
13998,2023-08-07 06:00:00,125,283,12,15,766,633,133,9
13999,2023-08-07 07:00:00,131,276,8,12,781,694,87,7
14000,2023-08-07 08:00:00,133,292,7,10,551,416,135,9
14001,2023-08-07 09:00:00,120,275,7,12,549,448,101,5
14002,2023-08-07 10:00:00,126,299,11,18,683,492,191,8
14003,2023-08-07 11:00:00,149,295,10,19,610,449,161,9
14004,2023-08-07 12:00:00,132,293,5,10,662,486,176,5
14005,2023-08-07 13:00:00,141,293,13,12,782,585,197,10
14006,2023-08-07 14:00:00,141,250,11,16,749,613,136,12
14007,2023-08-07 15:00:00,120,287,6,19,625,466,159,8
14008,2023-08-07 16:00:00,125,296,5,16,707,515,192,12
14009,2023-08-07 17:00:00,138,294,14,17,662,472,190,12
14010,2023-08-07 18:00:00,140,274,6,19,604,517,87,5
14011,2023-08-07 19:00:00,129,273,5,13,739,638,101,10
14012,2023-08-07 20:00:00,149,266,14,11,633,564,69,12
14013,2023-08-07 21:00:00,132,262,5,18,706,611,95,7
14014,2023-08-07 22:00:00,137,299,11,19,733,604,129,6
14015,2023-08-07 23:00:00,142,272,8,16,698,556,142,10
14016,2023-08-08 00:00:00,146,281,7,14,579,443,136,8
14017,2023-08-08 01:00:00,124,288,10,15,725,647,78,7
14018,2023-08-08 02:00:00,146,253,5,19,537,422,115,5
14019,2023-08-08 03:00:00,121,252,6,15,637,513,124,9
14020,2023-08-08 04:00:00,137,286,14,14,608,484,124,6
14021,2023-08-08 05:00:00,132,269,5,19,758,664,94,10
14022,2023-08-08 06:00:00,143,264,6,16,571,416,155,14
14023,2023-08-08 07:00:00,121,261,14,11,693,499,194,6
14024,2023-08-08 08:00:00,123,280,12,12,597,490,107,14
14025,2023-08-08 09:00:00,144,255,12,12,595,432,163,7
14026,2023-08-08 10:00:00,140,282,9,10,772,576,196,10
14027,2023-08-08 11:00:00,130,253,9,12,536,394,142,14
14028,2023-08-08 12:00:00,130,259,13,17,782,618,164,13
14029,2023-08-08 13:00:00,142,281,8,12,720,631,89,10
14030,2023-08-08 14:00:00,143,283,10,17,754,616,138,8
14031,2023-08-08 15:00:00,139,268,10,18,653,483,170,11
14032,2023-08-08 16:00:00,124,278,7,14,731,652,79,14
14033,2023-08-08 17:00:00,125,283,7,19,682,555,127,5
14034,2023-08-08 18:00:00,138,294,13,13,590,449,141,5
14035,2023-08-08 19:00:00,125,260,12,19,577,476,101,10
14036,2023-08-08 20:00:00,121,281,8,16,755,634,121,11
14037,2023-08-08 21:00:00,133,275,9,10,795,591,204,5
14038,2023-08-08 22:00:00,145,295,5,17,677,588,89,6
14039,2023-08-08 23:00:00,145,286,7,16,698,552,146,5
14040,2023-08-09 00:00:00,138,258,10,19,518,366,152,8
14041,2023-08-09 01:00:00,123,297,9,10,562,494,68,5
14042,2023-08-09 02:00:00,137,294,14,11,618,464,154,11
14043,2023-08-09 03:00:00,139,253,11,16,692,539,153,13
14044,2023-08-09 04:00:00,140,279,11,15,750,641,109,9
14045,2023-08-09 05:00:00,139,293,14,14,586,509,77,8
14046,2023-08-09 06:00:00,123,259,12,10,703,617,86,12
14047,2023-08-09 07:00:00,144,264,11,15,546,416,130,6
14048,2023-08-09 08:00:00,142,273,10,15,515,397,118,10
14049,2023-08-09 09:00:00,146,281,12,18,711,627,84,7
14050,2023-08-09 10:00:00,124,278,6,17,623,506,117,5
14051,2023-08-09 11:00:00,121,262,14,13,523,409,114,7
14052,2023-08-09 12:00:00,129,277,6,13,593,440,153,10
14053,2023-08-09 13:00:00,132,255,11,11,616,505,111,5
14054,2023-08-09 14:00:00,149,280,6,13,562,474,88,14
14055,2023-08-09 15:00:00,133,267,5,15,677,598,79,11
14056,2023-08-09 16:00:00,122,285,13,11,730,608,122,10
14057,2023-08-09 17:00:00,120,277,9,17,731,575,156,14
14058,2023-08-09 18:00:00,127,260,14,11,600,453,147,12
14059,2023-08-09 19:00:00,124,250,10,15,777,615,162,13
14060,2023-08-09 20:00:00,127,283,12,13,516,379,137,12
14061,2023-08-09 21:00:00,134,280,6,16,776,570,206,8
14062,2023-08-09 22:00:00,135,285,10,14,536,397,139,8
14063,2023-08-09 23:00:00,126,299,8,15,593,485,108,10
14064,2023-08-10 00:00:00,125,271,8,16,523,431,92,13
14065,2023-08-10 01:00:00,146,279,9,12,596,446,150,12
14066,2023-08-10 02:00:00,132,257,8,19,639,498,141,14
14067,2023-08-10 03:00:00,138,273,5,16,740,578,162,9
14068,2023-08-10 04:00:00,149,256,6,17,603,462,141,11
14069,2023-08-10 05:00:00,136,251,8,18,757,559,198,12
14070,2023-08-10 06:00:00,130,290,14,11,559,457,102,12
14071,2023-08-10 07:00:00,134,277,9,14,691,531,160,12
14072,2023-08-10 08:00:00,135,256,8,19,786,654,132,14
14073,2023-08-10 09:00:00,144,284,6,19,630,454,176,7
14074,2023-08-10 10:00:00,139,288,5,19,715,542,173,13
14075,2023-08-10 11:00:00,133,273,6,18,704,523,181,14
14076,2023-08-10 12:00:00,121,256,5,11,771,648,123,6
14077,2023-08-10 13:00:00,143,286,14,17,511,401,110,13
14078,2023-08-10 14:00:00,133,293,8,17,593,498,95,9
14079,2023-08-10 15:00:00,125,297,9,17,709,586,123,11
14080,2023-08-10 16:00:00,149,284,7,11,560,393,167,8
14081,2023-08-10 17:00:00,145,284,12,10,605,524,81,7
14082,2023-08-10 18:00:00,141,281,13,11,784,603,181,10
14083,2023-08-10 19:00:00,147,272,6,14,656,498,158,11
14084,2023-08-10 20:00:00,124,258,13,16,750,578,172,14
14085,2023-08-10 21:00:00,128,293,6,13,617,479,138,11
14086,2023-08-10 22:00:00,123,259,5,11,596,450,146,11
14087,2023-08-10 23:00:00,136,264,5,16,526,465,61,14
14088,2023-08-11 00:00:00,129,296,5,19,644,466,178,13
14089,2023-08-11 01:00:00,132,269,13,18,620,501,119,9
14090,2023-08-11 02:00:00,121,264,11,12,513,387,126,7
14091,2023-08-11 03:00:00,141,254,8,17,687,540,147,7
14092,2023-08-11 04:00:00,146,259,13,18,557,484,73,11
14093,2023-08-11 05:00:00,135,297,7,10,528,421,107,14
14094,2023-08-11 06:00:00,124,288,8,11,670,498,172,11
14095,2023-08-11 07:00:00,134,276,7,13,599,517,82,9
14096,2023-08-11 08:00:00,126,272,5,17,764,681,83,10
14097,2023-08-11 09:00:00,120,267,5,19,563,417,146,9
14098,2023-08-11 10:00:00,140,294,11,19,540,475,65,14
14099,2023-08-11 11:00:00,122,255,6,12,606,503,103,8
14100,2023-08-11 12:00:00,132,296,10,12,732,600,132,12
14101,2023-08-11 13:00:00,149,283,5,17,772,577,195,14
14102,2023-08-11 14:00:00,139,265,7,12,675,550,125,10
14103,2023-08-11 15:00:00,130,258,11,15,601,451,150,13
14104,2023-08-11 16:00:00,125,298,10,16,621,505,116,14
14105,2023-08-11 17:00:00,147,276,9,14,734,535,199,6
14106,2023-08-11 18:00:00,121,285,8,18,580,446,134,14
14107,2023-08-11 19:00:00,120,290,8,15,751,652,99,14
14108,2023-08-11 20:00:00,130,278,12,16,523,466,57,12
14109,2023-08-11 21:00:00,136,291,6,14,529,388,141,12
14110,2023-08-11 22:00:00,145,297,14,12,555,396,159,9
14111,2023-08-11 23:00:00,120,296,5,12,628,550,78,12
14112,2023-08-12 00:00:00,129,281,9,11,734,605,129,13
14113,2023-08-12 01:00:00,147,273,12,12,784,640,144,14
14114,2023-08-12 02:00:00,124,274,11,11,771,660,111,8
14115,2023-08-12 03:00:00,124,265,9,10,741,588,153,9
14116,2023-08-12 04:00:00,132,288,10,18,750,561,189,9
14117,2023-08-12 05:00:00,146,281,13,14,670,494,176,9
14118,2023-08-12 06:00:00,132,277,9,15,661,540,121,12
14119,2023-08-12 07:00:00,123,278,12,13,509,440,69,13
14120,2023-08-12 08:00:00,146,253,5,10,627,516,111,8
14121,2023-08-12 09:00:00,142,298,10,11,683,613,70,10
14122,2023-08-12 10:00:00,143,269,7,18,537,455,82,13
14123,2023-08-12 11:00:00,125,286,8,12,670,562,108,14
14124,2023-08-12 12:00:00,137,250,9,12,516,412,104,5
14125,2023-08-12 13:00:00,123,262,10,16,783,627,156,7
14126,2023-08-12 14:00:00,121,259,13,12,793,678,115,7
14127,2023-08-12 15:00:00,130,256,9,18,655,504,151,5
14128,2023-08-12 16:00:00,130,289,10,15,742,618,124,6
14129,2023-08-12 17:00:00,138,271,12,16,565,470,95,5
14130,2023-08-12 18:00:00,123,266,5,16,539,398,141,12
14131,2023-08-12 19:00:00,128,290,12,11,712,599,113,14
14132,2023-08-12 20:00:00,127,280,8,12,588,487,101,12
14133,2023-08-12 21:00:00,128,281,8,18,683,523,160,9
14134,2023-08-12 22:00:00,135,281,12,16,676,579,97,10
14135,2023-08-12 23:00:00,123,264,7,19,526,400,126,12
14136,2023-08-13 00:00:00,144,256,7,17,587,413,174,13
14137,2023-08-13 01:00:00,130,298,11,11,581,436,145,11
14138,2023-08-13 02:00:00,148,257,7,10,618,433,185,6
14139,2023-08-13 03:00:00,135,281,9,13,732,522,210,10
14140,2023-08-13 04:00:00,138,284,11,10,561,501,60,13
14141,2023-08-13 05:00:00,129,264,7,13,587,411,176,12
14142,2023-08-13 06:00:00,127,265,12,13,627,489,138,11
14143,2023-08-13 07:00:00,141,251,12,16,644,575,69,5
14144,2023-08-13 08:00:00,146,281,13,14,504,426,78,8
14145,2023-08-13 09:00:00,140,261,14,10,785,574,211,5
14146,2023-08-13 10:00:00,128,288,9,10,758,542,216,9
14147,2023-08-13 11:00:00,148,277,9,14,694,616,78,5
14148,2023-08-13 12:00:00,146,276,5,14,765,647,118,11
14149,2023-08-13 13:00:00,148,285,6,16,738,528,210,7
14150,2023-08-13 14:00:00,149,283,10,15,728,519,209,6
14151,2023-08-13 15:00:00,146,276,9,17,607,496,111,12
14152,2023-08-13 16:00:00,143,252,9,11,632,474,158,7
14153,2023-08-13 17:00:00,134,265,9,17,735,576,159,6
14154,2023-08-13 18:00:00,143,251,5,18,637,448,189,6
14155,2023-08-13 19:00:00,131,290,6,16,737,551,186,14
14156,2023-08-13 20:00:00,133,275,10,17,655,570,85,11
14157,2023-08-13 21:00:00,136,263,12,15,674,542,132,14
14158,2023-08-13 22:00:00,126,293,6,13,621,485,136,14
14159,2023-08-13 23:00:00,132,298,5,19,570,480,90,7
14160,2023-08-14 00:00:00,129,271,5,15,559,397,162,10
14161,2023-08-14 01:00:00,138,256,6,12,693,532,161,10
14162,2023-08-14 02:00:00,125,288,10,13,661,563,98,8
14163,2023-08-14 03:00:00,125,271,5,16,584,503,81,12
14164,2023-08-14 04:00:00,132,289,8,11,555,475,80,12
14165,2023-08-14 05:00:00,135,299,13,11,589,472,117,6
14166,2023-08-14 06:00:00,138,293,7,17,788,584,204,12
14167,2023-08-14 07:00:00,146,278,10,14,651,583,68,6
14168,2023-08-14 08:00:00,121,274,14,15,624,510,114,7
14169,2023-08-14 09:00:00,124,293,10,14,543,407,136,7
14170,2023-08-14 10:00:00,149,277,13,19,610,458,152,13
14171,2023-08-14 11:00:00,137,294,11,13,571,501,70,13
14172,2023-08-14 12:00:00,136,290,6,16,712,520,192,13
14173,2023-08-14 13:00:00,126,282,10,14,555,393,162,10
14174,2023-08-14 14:00:00,132,298,13,13,756,545,211,11
14175,2023-08-14 15:00:00,124,250,9,10,688,488,200,8
14176,2023-08-14 16:00:00,129,273,8,11,510,439,71,6
14177,2023-08-14 17:00:00,136,297,12,19,641,451,190,8
14178,2023-08-14 18:00:00,142,255,14,12,509,433,76,9
14179,2023-08-14 19:00:00,141,292,10,10,741,578,163,9
14180,2023-08-14 20:00:00,138,251,14,11,665,543,122,11
14181,2023-08-14 21:00:00,133,252,5,10,705,627,78,13
14182,2023-08-14 22:00:00,140,255,9,17,736,628,108,6
14183,2023-08-14 23:00:00,134,293,13,11,640,570,70,8
14184,2023-08-15 00:00:00,129,284,11,19,529,455,74,5
14185,2023-08-15 01:00:00,149,270,8,18,697,527,170,9
14186,2023-08-15 02:00:00,129,293,5,17,661,569,92,12
14187,2023-08-15 03:00:00,145,280,9,15,720,523,197,7
14188,2023-08-15 04:00:00,147,269,6,15,516,440,76,13
14189,2023-08-15 05:00:00,124,271,9,19,660,578,82,12
14190,2023-08-15 06:00:00,141,266,11,10,680,506,174,10
14191,2023-08-15 07:00:00,143,256,6,10,782,663,119,9
14192,2023-08-15 08:00:00,143,273,7,13,701,553,148,8
14193,2023-08-15 09:00:00,124,298,14,10,670,511,159,14
14194,2023-08-15 10:00:00,136,283,11,16,678,512,166,9
14195,2023-08-15 11:00:00,144,251,8,18,704,573,131,5
14196,2023-08-15 12:00:00,129,276,8,12,626,498,128,11
14197,2023-08-15 13:00:00,130,272,13,11,752,572,180,7
14198,2023-08-15 14:00:00,143,286,6,14,521,400,121,13
14199,2023-08-15 15:00:00,125,289,5,18,588,418,170,7
14200,2023-08-15 16:00:00,122,282,6,15,699,574,125,8
14201,2023-08-15 17:00:00,130,260,11,12,543,435,108,6
14202,2023-08-15 18:00:00,133,281,12,10,783,641,142,14
14203,2023-08-15 19:00:00,121,259,9,14,747,634,113,14
14204,2023-08-15 20:00:00,145,277,6,15,723,596,127,9
14205,2023-08-15 21:00:00,123,281,14,10,754,584,170,13
14206,2023-08-15 22:00:00,127,286,10,13,742,639,103,13
14207,2023-08-15 23:00:00,130,286,12,12,635,548,87,5
14208,2023-08-16 00:00:00,124,281,13,11,508,455,53,7
14209,2023-08-16 01:00:00,141,298,12,11,650,506,144,7
14210,2023-08-16 02:00:00,123,270,14,18,786,566,220,9
14211,2023-08-16 03:00:00,141,251,6,18,562,478,84,13
14212,2023-08-16 04:00:00,142,268,6,16,602,513,89,14
14213,2023-08-16 05:00:00,139,296,13,10,768,609,159,5
14214,2023-08-16 06:00:00,148,285,13,15,601,513,88,9
14215,2023-08-16 07:00:00,130,296,14,13,568,438,130,9
14216,2023-08-16 08:00:00,144,290,11,18,721,544,177,5
14217,2023-08-16 09:00:00,140,258,5,19,501,380,121,11
14218,2023-08-16 10:00:00,128,263,7,15,776,559,217,10
14219,2023-08-16 11:00:00,137,254,14,12,640,561,79,13
14220,2023-08-16 12:00:00,135,273,14,16,503,383,120,10
14221,2023-08-16 13:00:00,129,277,13,11,603,461,142,10
14222,2023-08-16 14:00:00,124,267,13,12,750,610,140,12
14223,2023-08-16 15:00:00,133,295,8,14,743,668,75,12
14224,2023-08-16 16:00:00,129,295,9,10,737,564,173,13
14225,2023-08-16 17:00:00,121,260,6,17,763,608,155,7
14226,2023-08-16 18:00:00,121,269,6,19,536,392,144,14
14227,2023-08-16 19:00:00,120,262,5,14,571,422,149,8
14228,2023-08-16 20:00:00,129,297,12,16,728,626,102,13
14229,2023-08-16 21:00:00,148,296,8,16,653,475,178,12
14230,2023-08-16 22:00:00,149,254,6,11,701,564,137,10
14231,2023-08-16 23:00:00,121,287,6,13,576,501,75,8
14232,2023-08-17 00:00:00,121,272,12,18,714,512,202,13
14233,2023-08-17 01:00:00,135,284,8,16,655,489,166,10
14234,2023-08-17 02:00:00,145,254,13,11,789,563,226,7
14235,2023-08-17 03:00:00,132,282,9,16,689,488,201,8
14236,2023-08-17 04:00:00,137,272,5,19,651,561,90,10
14237,2023-08-17 05:00:00,127,299,14,14,523,391,132,11
14238,2023-08-17 06:00:00,134,264,10,19,742,532,210,6
14239,2023-08-17 07:00:00,133,281,8,13,716,603,113,14
14240,2023-08-17 08:00:00,121,251,5,19,627,511,116,13
14241,2023-08-17 09:00:00,135,251,11,19,612,478,134,13
14242,2023-08-17 10:00:00,122,274,11,13,666,565,101,6
14243,2023-08-17 11:00:00,146,271,8,14,746,575,171,12
14244,2023-08-17 12:00:00,127,274,7,15,509,437,72,6
14245,2023-08-17 13:00:00,140,265,6,12,762,567,195,14
14246,2023-08-17 14:00:00,135,297,11,10,540,389,151,9
14247,2023-08-17 15:00:00,137,253,5,10,774,608,166,13
14248,2023-08-17 16:00:00,125,289,9,18,771,555,216,6
14249,2023-08-17 17:00:00,123,294,14,17,784,604,180,14
14250,2023-08-17 18:00:00,122,264,14,11,719,635,84,8
14251,2023-08-17 19:00:00,131,284,13,11,736,612,124,9
14252,2023-08-17 20:00:00,127,278,8,14,780,676,104,8
14253,2023-08-17 21:00:00,136,285,14,18,601,499,102,9
14254,2023-08-17 22:00:00,126,261,13,19,609,497,112,10
14255,2023-08-17 23:00:00,136,287,9,10,583,458,125,10
14256,2023-08-18 00:00:00,123,262,11,10,688,514,174,12
14257,2023-08-18 01:00:00,142,287,7,13,590,520,70,14
14258,2023-08-18 02:00:00,122,277,11,13,510,449,61,6
14259,2023-08-18 03:00:00,135,281,13,11,678,527,151,13
14260,2023-08-18 04:00:00,120,255,13,19,789,639,150,8
14261,2023-08-18 05:00:00,137,296,6,11,582,514,68,9
14262,2023-08-18 06:00:00,145,261,13,17,747,649,98,5
14263,2023-08-18 07:00:00,132,270,8,14,700,626,74,11
14264,2023-08-18 08:00:00,149,275,8,16,738,594,144,7
14265,2023-08-18 09:00:00,130,266,7,15,728,585,143,11
14266,2023-08-18 10:00:00,148,270,7,19,760,554,206,7
14267,2023-08-18 11:00:00,126,282,8,18,654,462,192,8
14268,2023-08-18 12:00:00,120,273,10,19,579,497,82,9
14269,2023-08-18 13:00:00,138,288,11,10,509,391,118,11
14270,2023-08-18 14:00:00,139,279,13,16,659,486,173,14
14271,2023-08-18 15:00:00,120,251,9,14,634,455,179,7
14272,2023-08-18 16:00:00,136,254,8,18,796,659,137,14
14273,2023-08-18 17:00:00,135,259,7,16,716,596,120,10
14274,2023-08-18 18:00:00,121,272,9,12,685,572,113,12
14275,2023-08-18 19:00:00,144,256,13,19,690,606,84,6
14276,2023-08-18 20:00:00,125,294,12,17,525,428,97,12
14277,2023-08-18 21:00:00,140,255,14,14,515,401,114,6
14278,2023-08-18 22:00:00,149,298,10,10,526,391,135,10
14279,2023-08-18 23:00:00,138,280,12,10,547,449,98,9
14280,2023-08-19 00:00:00,127,255,13,14,723,522,201,13
14281,2023-08-19 01:00:00,147,287,11,13,666,547,119,6
14282,2023-08-19 02:00:00,135,280,12,18,661,548,113,14
14283,2023-08-19 03:00:00,134,280,12,11,713,516,197,8
14284,2023-08-19 04:00:00,145,285,9,11,570,493,77,6
14285,2023-08-19 05:00:00,131,291,11,18,795,604,191,13
14286,2023-08-19 06:00:00,124,299,6,12,702,617,85,9
14287,2023-08-19 07:00:00,120,279,14,17,790,568,222,11
14288,2023-08-19 08:00:00,148,296,13,14,614,546,68,7
14289,2023-08-19 09:00:00,120,258,12,12,746,666,80,8
14290,2023-08-19 10:00:00,146,274,14,12,611,474,137,13
14291,2023-08-19 11:00:00,146,299,9,14,655,475,180,7
14292,2023-08-19 12:00:00,126,266,11,10,769,572,197,5
14293,2023-08-19 13:00:00,121,268,8,12,500,406,94,14
14294,2023-08-19 14:00:00,138,275,10,18,536,411,125,14
14295,2023-08-19 15:00:00,134,283,8,13,625,464,161,11
14296,2023-08-19 16:00:00,124,259,12,17,749,564,185,5
14297,2023-08-19 17:00:00,144,264,12,14,537,454,83,6
14298,2023-08-19 18:00:00,124,296,7,10,673,505,168,10
14299,2023-08-19 19:00:00,139,262,7,18,578,412,166,12
14300,2023-08-19 20:00:00,138,280,12,17,687,606,81,12
14301,2023-08-19 21:00:00,136,274,10,18,728,612,116,8
14302,2023-08-19 22:00:00,144,257,13,18,502,398,104,11
14303,2023-08-19 23:00:00,145,298,12,10,636,457,179,11
14304,2023-08-20 00:00:00,130,284,10,16,528,394,134,14
14305,2023-08-20 01:00:00,136,267,13,15,620,536,84,8
14306,2023-08-20 02:00:00,129,289,5,17,651,527,124,13
14307,2023-08-20 03:00:00,146,295,13,18,529,417,112,14
14308,2023-08-20 04:00:00,143,273,11,14,578,505,73,14
14309,2023-08-20 05:00:00,136,289,7,15,557,478,79,8
14310,2023-08-20 06:00:00,135,267,11,12,618,492,126,7
14311,2023-08-20 07:00:00,125,281,12,17,524,467,57,9
14312,2023-08-20 08:00:00,133,250,13,19,737,649,88,5
14313,2023-08-20 09:00:00,145,267,6,17,751,657,94,8
14314,2023-08-20 10:00:00,126,263,8,10,556,460,96,14
14315,2023-08-20 11:00:00,121,264,11,11,507,435,72,9
14316,2023-08-20 12:00:00,149,263,6,16,622,488,134,14
14317,2023-08-20 13:00:00,121,265,11,18,520,408,112,14
14318,2023-08-20 14:00:00,128,252,14,15,505,426,79,6
14319,2023-08-20 15:00:00,123,291,13,11,593,491,102,5
14320,2023-08-20 16:00:00,127,259,8,18,505,443,62,10
14321,2023-08-20 17:00:00,136,272,9,15,514,393,121,13
14322,2023-08-20 18:00:00,142,260,14,17,756,551,205,9
14323,2023-08-20 19:00:00,129,280,13,13,792,628,164,9
14324,2023-08-20 20:00:00,137,272,13,13,624,526,98,6
14325,2023-08-20 21:00:00,136,278,14,15,679,527,152,9
14326,2023-08-20 22:00:00,120,294,13,19,521,396,125,11
14327,2023-08-20 23:00:00,137,286,12,14,665,532,133,9
14328,2023-08-21 00:00:00,143,292,10,17,599,444,155,8
14329,2023-08-21 01:00:00,139,259,8,11,651,572,79,11
14330,2023-08-21 02:00:00,133,251,12,11,726,649,77,5
14331,2023-08-21 03:00:00,131,269,13,11,779,630,149,13
14332,2023-08-21 04:00:00,126,253,7,17,584,446,138,8
14333,2023-08-21 05:00:00,133,299,9,16,592,531,61,12
14334,2023-08-21 06:00:00,149,267,6,12,748,665,83,7
14335,2023-08-21 07:00:00,149,263,8,19,601,464,137,12
14336,2023-08-21 08:00:00,143,287,12,18,589,509,80,10
14337,2023-08-21 09:00:00,133,279,12,15,666,577,89,5
14338,2023-08-21 10:00:00,140,252,11,17,529,433,96,12
14339,2023-08-21 11:00:00,126,261,9,18,558,472,86,13
14340,2023-08-21 12:00:00,132,278,8,12,589,437,152,6
14341,2023-08-21 13:00:00,143,289,6,18,640,516,124,6
14342,2023-08-21 14:00:00,123,273,11,10,782,584,198,5
14343,2023-08-21 15:00:00,133,264,14,12,511,435,76,11
14344,2023-08-21 16:00:00,127,294,8,10,761,655,106,10
14345,2023-08-21 17:00:00,139,266,5,14,652,515,137,12
14346,2023-08-21 18:00:00,133,259,10,11,681,525,156,14
14347,2023-08-21 19:00:00,126,253,9,12,580,506,74,7
14348,2023-08-21 20:00:00,138,275,11,10,610,531,79,14
14349,2023-08-21 21:00:00,124,266,10,17,635,511,124,5
14350,2023-08-21 22:00:00,142,284,6,16,622,537,85,12
14351,2023-08-21 23:00:00,120,286,8,12,618,477,141,6
14352,2023-08-22 00:00:00,136,289,12,12,575,418,157,5
14353,2023-08-22 01:00:00,140,284,14,14,579,451,128,6
14354,2023-08-22 02:00:00,128,295,5,10,626,534,92,5
14355,2023-08-22 03:00:00,138,277,10,10,676,607,69,5
14356,2023-08-22 04:00:00,120,286,5,15,690,511,179,11
14357,2023-08-22 05:00:00,139,268,10,13,587,526,61,14
14358,2023-08-22 06:00:00,124,258,5,14,665,565,100,8
14359,2023-08-22 07:00:00,133,270,14,13,775,612,163,11
14360,2023-08-22 08:00:00,139,277,5,13,748,670,78,13
14361,2023-08-22 09:00:00,124,278,12,13,680,611,69,9
14362,2023-08-22 10:00:00,139,274,8,10,679,516,163,9
14363,2023-08-22 11:00:00,140,293,10,17,735,517,218,10
14364,2023-08-22 12:00:00,130,278,5,12,644,526,118,6
14365,2023-08-22 13:00:00,133,267,14,10,745,663,82,10
14366,2023-08-22 14:00:00,145,254,8,16,504,418,86,12
14367,2023-08-22 15:00:00,141,282,10,18,569,502,67,8
14368,2023-08-22 16:00:00,120,290,9,17,634,477,157,13
14369,2023-08-22 17:00:00,135,259,7,12,756,568,188,13
14370,2023-08-22 18:00:00,140,251,9,18,619,442,177,10
14371,2023-08-22 19:00:00,124,264,9,12,616,473,143,7
14372,2023-08-22 20:00:00,134,264,6,18,556,446,110,14
14373,2023-08-22 21:00:00,147,253,7,17,530,399,131,8
14374,2023-08-22 22:00:00,136,266,8,11,546,444,102,6
14375,2023-08-22 23:00:00,124,280,11,15,508,440,68,7
14376,2023-08-23 00:00:00,126,287,10,18,608,487,121,6
14377,2023-08-23 01:00:00,135,264,14,16,640,566,74,6
14378,2023-08-23 02:00:00,149,255,11,10,569,409,160,6
14379,2023-08-23 03:00:00,135,269,11,11,791,648,143,9
14380,2023-08-23 04:00:00,132,297,10,18,787,578,209,9
14381,2023-08-23 05:00:00,144,265,14,16,636,511,125,11
14382,2023-08-23 06:00:00,145,286,12,18,780,590,190,10
14383,2023-08-23 07:00:00,124,282,11,16,764,671,93,9
14384,2023-08-23 08:00:00,135,291,13,11,765,658,107,11
14385,2023-08-23 09:00:00,133,284,6,15,740,532,208,7
14386,2023-08-23 10:00:00,136,275,5,11,607,459,148,9
14387,2023-08-23 11:00:00,140,267,10,15,665,466,199,9
14388,2023-08-23 12:00:00,142,276,14,11,671,485,186,13
14389,2023-08-23 13:00:00,123,262,5,12,618,488,130,10
14390,2023-08-23 14:00:00,145,272,11,18,735,595,140,14
14391,2023-08-23 15:00:00,123,258,6,15,579,424,155,13
14392,2023-08-23 16:00:00,134,291,13,15,693,578,115,8
14393,2023-08-23 17:00:00,126,286,9,16,597,443,154,5
14394,2023-08-23 18:00:00,135,269,9,12,754,607,147,13
14395,2023-08-23 19:00:00,139,294,8,18,538,424,114,6
14396,2023-08-23 20:00:00,144,272,13,15,551,486,65,13
14397,2023-08-23 21:00:00,131,282,10,16,773,659,114,7
14398,2023-08-23 22:00:00,144,274,5,16,778,684,94,6
14399,2023-08-23 23:00:00,135,284,14,16,627,491,136,8
14400,2023-08-24 00:00:00,134,293,7,15,590,420,170,7
14401,2023-08-24 01:00:00,134,265,14,14,641,572,69,9
14402,2023-08-24 02:00:00,120,278,14,17,685,585,100,14
14403,2023-08-24 03:00:00,126,272,10,10,666,491,175,7
14404,2023-08-24 04:00:00,121,283,14,18,592,479,113,10
14405,2023-08-24 05:00:00,149,253,5,15,605,453,152,14
14406,2023-08-24 06:00:00,130,269,5,17,762,543,219,9
14407,2023-08-24 07:00:00,121,289,5,17,545,487,58,14
14408,2023-08-24 08:00:00,137,290,9,13,740,600,140,12
14409,2023-08-24 09:00:00,147,262,12,11,569,438,131,6
14410,2023-08-24 10:00:00,127,272,5,13,765,688,77,6
14411,2023-08-24 11:00:00,137,292,10,19,724,575,149,8
14412,2023-08-24 12:00:00,139,261,14,12,608,522,86,8
14413,2023-08-24 13:00:00,120,286,11,17,619,529,90,13
14414,2023-08-24 14:00:00,146,277,6,13,525,397,128,14
14415,2023-08-24 15:00:00,148,277,13,16,699,525,174,14
14416,2023-08-24 16:00:00,134,260,9,19,513,410,103,5
14417,2023-08-24 17:00:00,147,255,10,13,644,463,181,13
14418,2023-08-24 18:00:00,141,268,7,16,716,578,138,11
14419,2023-08-24 19:00:00,142,292,7,15,779,604,175,8
14420,2023-08-24 20:00:00,142,261,9,14,642,485,157,13
14421,2023-08-24 21:00:00,141,250,6,13,732,623,109,11
14422,2023-08-24 22:00:00,139,278,6,10,696,507,189,14
14423,2023-08-24 23:00:00,139,297,12,15,672,477,195,12
14424,2023-08-25 00:00:00,120,264,14,10,562,430,132,13
14425,2023-08-25 01:00:00,127,278,12,15,610,485,125,10
14426,2023-08-25 02:00:00,143,257,7,10,720,580,140,11
14427,2023-08-25 03:00:00,140,270,12,11,771,632,139,13
14428,2023-08-25 04:00:00,137,272,11,14,521,435,86,5
14429,2023-08-25 05:00:00,138,253,9,15,636,522,114,8
14430,2023-08-25 06:00:00,146,296,6,11,793,693,100,5
14431,2023-08-25 07:00:00,141,276,7,19,707,541,166,6
14432,2023-08-25 08:00:00,121,250,12,11,608,508,100,12
14433,2023-08-25 09:00:00,122,280,8,16,540,472,68,8
14434,2023-08-25 10:00:00,139,286,7,18,538,419,119,5
14435,2023-08-25 11:00:00,120,296,9,15,618,539,79,7
14436,2023-08-25 12:00:00,145,256,6,16,769,629,140,13
14437,2023-08-25 13:00:00,123,281,13,13,766,659,107,14
14438,2023-08-25 14:00:00,125,298,6,19,539,377,162,8
14439,2023-08-25 15:00:00,140,281,7,14,627,481,146,8
14440,2023-08-25 16:00:00,126,292,13,15,782,698,84,7
14441,2023-08-25 17:00:00,139,292,6,13,558,412,146,12
14442,2023-08-25 18:00:00,136,293,7,17,552,418,134,5
14443,2023-08-25 19:00:00,135,285,5,11,787,580,207,10
14444,2023-08-25 20:00:00,130,260,5,17,655,488,167,5
14445,2023-08-25 21:00:00,130,254,14,19,585,476,109,5
14446,2023-08-25 22:00:00,129,288,9,11,637,472,165,10
14447,2023-08-25 23:00:00,149,272,11,11,631,522,109,11
14448,2023-08-26 00:00:00,145,265,10,11,693,547,146,8
14449,2023-08-26 01:00:00,139,275,14,13,707,558,149,13
14450,2023-08-26 02:00:00,127,252,12,12,721,566,155,12
14451,2023-08-26 03:00:00,141,296,10,16,797,646,151,14
14452,2023-08-26 04:00:00,122,270,9,12,524,460,64,5
14453,2023-08-26 05:00:00,149,251,5,16,639,574,65,11
14454,2023-08-26 06:00:00,129,286,6,16,762,668,94,5
14455,2023-08-26 07:00:00,140,256,12,13,689,496,193,6
14456,2023-08-26 08:00:00,144,266,11,11,712,543,169,7
14457,2023-08-26 09:00:00,131,294,12,15,763,680,83,9
14458,2023-08-26 10:00:00,122,298,7,19,563,398,165,6
14459,2023-08-26 11:00:00,145,289,11,17,764,663,101,7
14460,2023-08-26 12:00:00,121,277,9,13,606,504,102,5
14461,2023-08-26 13:00:00,142,291,14,19,606,469,137,5
14462,2023-08-26 14:00:00,124,293,11,17,529,392,137,10
14463,2023-08-26 15:00:00,131,275,8,14,608,426,182,11
14464,2023-08-26 16:00:00,130,273,7,18,667,488,179,11
14465,2023-08-26 17:00:00,130,264,9,10,681,549,132,11
14466,2023-08-26 18:00:00,121,283,13,19,504,392,112,8
14467,2023-08-26 19:00:00,133,283,9,11,768,663,105,13
14468,2023-08-26 20:00:00,144,298,10,13,793,659,134,5
14469,2023-08-26 21:00:00,129,285,10,18,656,579,77,13
14470,2023-08-26 22:00:00,141,293,13,15,547,390,157,9
14471,2023-08-26 23:00:00,130,267,14,12,633,502,131,5
14472,2023-08-27 00:00:00,146,258,7,15,544,472,72,9
14473,2023-08-27 01:00:00,131,258,10,17,669,523,146,13
14474,2023-08-27 02:00:00,143,254,9,15,771,691,80,10
14475,2023-08-27 03:00:00,143,282,6,19,633,514,119,12
14476,2023-08-27 04:00:00,127,296,13,17,731,559,172,14
14477,2023-08-27 05:00:00,148,299,11,10,648,457,191,14
14478,2023-08-27 06:00:00,145,283,6,13,558,399,159,10
14479,2023-08-27 07:00:00,145,287,10,17,715,584,131,14
14480,2023-08-27 08:00:00,122,270,14,18,625,496,129,5
14481,2023-08-27 09:00:00,131,280,5,10,595,471,124,12
14482,2023-08-27 10:00:00,141,279,9,19,505,413,92,14
14483,2023-08-27 11:00:00,131,272,12,19,570,500,70,11
14484,2023-08-27 12:00:00,130,269,7,19,674,560,114,14
14485,2023-08-27 13:00:00,137,287,5,11,785,621,164,13
14486,2023-08-27 14:00:00,126,258,12,11,634,554,80,7
14487,2023-08-27 15:00:00,129,281,7,18,787,609,178,12
14488,2023-08-27 16:00:00,125,293,11,17,792,582,210,7
14489,2023-08-27 17:00:00,146,270,7,17,771,598,173,12
14490,2023-08-27 18:00:00,123,275,10,18,543,453,90,6
14491,2023-08-27 19:00:00,148,272,14,12,611,521,90,6
14492,2023-08-27 20:00:00,144,286,10,14,667,530,137,5
14493,2023-08-27 21:00:00,120,284,5,16,734,555,179,10
14494,2023-08-27 22:00:00,146,288,5,17,507,429,78,6
14495,2023-08-27 23:00:00,129,296,8,13,732,579,153,11
14496,2023-08-28 00:00:00,133,250,8,16,726,535,191,14
14497,2023-08-28 01:00:00,130,258,5,16,572,445,127,9
14498,2023-08-28 02:00:00,128,250,8,17,652,472,180,5
14499,2023-08-28 03:00:00,129,280,13,15,650,472,178,5
14500,2023-08-28 04:00:00,143,261,6,11,768,567,201,11
14501,2023-08-28 05:00:00,122,258,12,11,759,642,117,10
14502,2023-08-28 06:00:00,125,256,5,14,548,485,63,13
14503,2023-08-28 07:00:00,125,256,11,15,614,488,126,6
14504,2023-08-28 08:00:00,121,265,5,13,521,378,143,9
14505,2023-08-28 09:00:00,121,284,13,17,733,524,209,11
14506,2023-08-28 10:00:00,130,264,14,18,549,438,111,5
14507,2023-08-28 11:00:00,143,299,11,10,617,487,130,10
14508,2023-08-28 12:00:00,129,250,12,18,739,592,147,9
14509,2023-08-28 13:00:00,120,252,5,17,635,466,169,7
14510,2023-08-28 14:00:00,132,269,7,18,528,420,108,11
14511,2023-08-28 15:00:00,136,297,9,19,796,701,95,9
14512,2023-08-28 16:00:00,129,290,14,14,725,602,123,7
14513,2023-08-28 17:00:00,144,269,8,10,560,436,124,9
14514,2023-08-28 18:00:00,130,281,5,17,574,506,68,5
14515,2023-08-28 19:00:00,149,293,8,18,738,597,141,5
14516,2023-08-28 20:00:00,131,292,11,18,562,400,162,9
14517,2023-08-28 21:00:00,121,279,14,13,632,504,128,12
14518,2023-08-28 22:00:00,132,262,8,15,756,556,200,14
14519,2023-08-28 23:00:00,123,283,8,17,774,691,83,13
14520,2023-08-29 00:00:00,121,274,14,13,783,666,117,11
14521,2023-08-29 01:00:00,149,255,5,13,528,454,74,14
14522,2023-08-29 02:00:00,121,291,13,10,796,675,121,8
14523,2023-08-29 03:00:00,124,254,7,15,601,460,141,13
14524,2023-08-29 04:00:00,132,255,12,10,675,493,182,10
14525,2023-08-29 05:00:00,141,288,6,13,600,520,80,5
14526,2023-08-29 06:00:00,137,259,11,18,633,558,75,8
14527,2023-08-29 07:00:00,149,253,6,18,793,624,169,6
14528,2023-08-29 08:00:00,140,261,8,12,728,586,142,13
14529,2023-08-29 09:00:00,141,289,8,13,737,648,89,14
14530,2023-08-29 10:00:00,134,251,14,16,542,435,107,5
14531,2023-08-29 11:00:00,124,254,13,13,581,411,170,10
14532,2023-08-29 12:00:00,129,254,13,13,589,463,126,8
14533,2023-08-29 13:00:00,127,260,6,11,584,440,144,13
14534,2023-08-29 14:00:00,122,264,7,11,729,574,155,12
14535,2023-08-29 15:00:00,148,291,13,11,537,469,68,8
14536,2023-08-29 16:00:00,130,295,11,11,593,503,90,5
14537,2023-08-29 17:00:00,128,257,9,16,725,635,90,11
14538,2023-08-29 18:00:00,140,262,8,12,779,670,109,11
14539,2023-08-29 19:00:00,122,297,10,13,657,492,165,14
14540,2023-08-29 20:00:00,129,277,10,19,695,494,201,13
14541,2023-08-29 21:00:00,130,277,5,16,678,501,177,10
14542,2023-08-29 22:00:00,134,271,11,15,538,417,121,11
14543,2023-08-29 23:00:00,142,276,6,11,760,666,94,8
14544,2023-08-30 00:00:00,147,291,5,14,652,568,84,9
14545,2023-08-30 01:00:00,130,299,10,15,749,598,151,12
14546,2023-08-30 02:00:00,133,257,10,15,561,402,159,8
14547,2023-08-30 03:00:00,129,279,6,13,616,478,138,8
14548,2023-08-30 04:00:00,127,260,11,12,524,370,154,5
14549,2023-08-30 05:00:00,134,263,5,11,727,594,133,12
14550,2023-08-30 06:00:00,124,265,9,12,709,594,115,6
14551,2023-08-30 07:00:00,124,258,5,19,632,494,138,7
14552,2023-08-30 08:00:00,147,252,6,14,798,694,104,7
14553,2023-08-30 09:00:00,134,286,11,14,507,393,114,14
14554,2023-08-30 10:00:00,128,250,13,19,693,514,179,13
14555,2023-08-30 11:00:00,137,263,7,19,713,582,131,8
14556,2023-08-30 12:00:00,144,284,6,10,749,533,216,10
14557,2023-08-30 13:00:00,146,260,13,12,513,434,79,13
14558,2023-08-30 14:00:00,148,252,6,12,667,512,155,8
14559,2023-08-30 15:00:00,139,291,13,12,586,522,64,5
14560,2023-08-30 16:00:00,143,295,14,13,698,612,86,12
14561,2023-08-30 17:00:00,124,276,14,14,760,559,201,14
14562,2023-08-30 18:00:00,131,288,12,12,614,493,121,10
14563,2023-08-30 19:00:00,145,259,12,15,525,418,107,13
14564,2023-08-30 20:00:00,147,256,11,16,668,470,198,13
14565,2023-08-30 21:00:00,130,270,10,10,530,456,74,14
14566,2023-08-30 22:00:00,128,256,12,12,567,490,77,8
14567,2023-08-30 23:00:00,122,256,9,19,684,598,86,14
14568,2023-08-31 00:00:00,145,268,11,10,549,476,73,14
14569,2023-08-31 01:00:00,131,284,7,16,549,463,86,10
14570,2023-08-31 02:00:00,131,251,10,10,715,599,116,13
14571,2023-08-31 03:00:00,138,287,12,13,597,489,108,8
14572,2023-08-31 04:00:00,142,272,11,19,538,443,95,12
14573,2023-08-31 05:00:00,134,295,10,15,651,481,170,7
14574,2023-08-31 06:00:00,148,258,9,18,576,459,117,12
14575,2023-08-31 07:00:00,142,280,9,18,788,568,220,6
14576,2023-08-31 08:00:00,127,292,8,11,627,465,162,5
14577,2023-08-31 09:00:00,133,257,6,12,715,641,74,6
14578,2023-08-31 10:00:00,127,282,7,17,717,617,100,7
14579,2023-08-31 11:00:00,145,261,13,18,643,493,150,11
14580,2023-08-31 12:00:00,129,290,12,14,715,518,197,11
14581,2023-08-31 13:00:00,125,250,5,14,640,465,175,9
14582,2023-08-31 14:00:00,131,277,5,17,559,460,99,9
14583,2023-08-31 15:00:00,123,252,9,19,726,555,171,10
14584,2023-08-31 16:00:00,124,269,6,14,656,550,106,9
14585,2023-08-31 17:00:00,145,262,13,13,602,507,95,10
14586,2023-08-31 18:00:00,126,260,8,17,505,371,134,10
14587,2023-08-31 19:00:00,141,290,6,11,604,429,175,11
14588,2023-08-31 20:00:00,136,256,10,11,770,666,104,10
14589,2023-08-31 21:00:00,123,275,14,18,699,493,206,10
14590,2023-08-31 22:00:00,145,297,7,16,688,528,160,9
14591,2023-08-31 23:00:00,147,271,8,10,779,551,228,9
14592,2023-09-01 00:00:00,149,258,8,18,684,499,185,7
14593,2023-09-01 01:00:00,146,296,12,10,722,644,78,14
14594,2023-09-01 02:00:00,142,297,9,14,612,445,167,10
14595,2023-09-01 03:00:00,146,276,13,14,587,427,160,5
14596,2023-09-01 04:00:00,133,263,7,11,668,497,171,12
14597,2023-09-01 05:00:00,134,265,9,19,553,428,125,9
14598,2023-09-01 06:00:00,125,279,10,12,660,550,110,5
14599,2023-09-01 07:00:00,131,298,10,15,525,429,96,13
14600,2023-09-01 08:00:00,129,278,10,10,552,469,83,13
14601,2023-09-01 09:00:00,126,274,14,11,539,467,72,12
14602,2023-09-01 10:00:00,144,268,13,10,792,649,143,6
14603,2023-09-01 11:00:00,130,285,10,13,790,574,216,6
14604,2023-09-01 12:00:00,122,253,10,10,617,551,66,7
14605,2023-09-01 13:00:00,135,293,7,13,563,423,140,5
14606,2023-09-01 14:00:00,125,256,11,13,774,547,227,6
14607,2023-09-01 15:00:00,136,262,9,18,638,493,145,10
14608,2023-09-01 16:00:00,147,272,5,13,552,476,76,12
14609,2023-09-01 17:00:00,130,258,6,13,601,438,163,6
14610,2023-09-01 18:00:00,149,267,11,17,518,406,112,13
14611,2023-09-01 19:00:00,144,284,12,12,745,603,142,14
14612,2023-09-01 20:00:00,135,256,10,17,750,614,136,14
14613,2023-09-01 21:00:00,126,273,14,18,640,512,128,12
14614,2023-09-01 22:00:00,139,293,14,12,648,539,109,9
14615,2023-09-01 23:00:00,123,250,8,15,727,554,173,14
14616,2023-09-02 00:00:00,149,255,12,18,552,398,154,13
14617,2023-09-02 01:00:00,127,276,11,14,545,400,145,13
14618,2023-09-02 02:00:00,134,251,8,12,764,567,197,14
14619,2023-09-02 03:00:00,131,278,11,18,785,617,168,9
14620,2023-09-02 04:00:00,122,288,7,13,742,557,185,9
14621,2023-09-02 05:00:00,122,252,9,14,561,447,114,10
14622,2023-09-02 06:00:00,147,296,5,19,748,573,175,8
14623,2023-09-02 07:00:00,141,251,10,11,764,561,203,12
14624,2023-09-02 08:00:00,126,271,8,18,666,536,130,5
14625,2023-09-02 09:00:00,124,282,10,18,619,452,167,7
14626,2023-09-02 10:00:00,127,298,13,18,632,524,108,9
14627,2023-09-02 11:00:00,140,268,6,16,525,439,86,13
14628,2023-09-02 12:00:00,136,250,12,10,683,534,149,8
14629,2023-09-02 13:00:00,132,264,13,10,525,387,138,11
14630,2023-09-02 14:00:00,128,277,11,10,719,635,84,13
14631,2023-09-02 15:00:00,125,263,7,10,679,528,151,5
14632,2023-09-02 16:00:00,133,276,6,14,669,552,117,5
14633,2023-09-02 17:00:00,142,298,11,16,755,536,219,6
14634,2023-09-02 18:00:00,124,296,12,18,557,402,155,8
14635,2023-09-02 19:00:00,124,255,7,11,593,502,91,6
14636,2023-09-02 20:00:00,149,258,5,17,553,444,109,6
14637,2023-09-02 21:00:00,124,263,12,18,646,516,130,6
14638,2023-09-02 22:00:00,133,259,12,19,709,526,183,9
14639,2023-09-02 23:00:00,124,277,14,15,544,478,66,9
14640,2023-09-03 00:00:00,125,271,9,13,574,467,107,6
14641,2023-09-03 01:00:00,127,275,8,15,767,606,161,14
14642,2023-09-03 02:00:00,138,276,10,15,567,446,121,6
14643,2023-09-03 03:00:00,136,271,10,15,664,536,128,7
14644,2023-09-03 04:00:00,123,261,11,14,747,606,141,6
14645,2023-09-03 05:00:00,149,262,5,13,629,451,178,8
14646,2023-09-03 06:00:00,141,288,14,16,548,439,109,6
14647,2023-09-03 07:00:00,124,251,7,13,788,695,93,9
14648,2023-09-03 08:00:00,141,266,12,12,590,499,91,8
14649,2023-09-03 09:00:00,126,292,5,10,774,636,138,9
14650,2023-09-03 10:00:00,130,287,13,18,633,469,164,8
14651,2023-09-03 11:00:00,145,299,11,16,553,429,124,10
14652,2023-09-03 12:00:00,147,286,8,11,533,430,103,5
14653,2023-09-03 13:00:00,124,263,7,10,674,533,141,13
14654,2023-09-03 14:00:00,139,256,13,13,608,528,80,9
14655,2023-09-03 15:00:00,136,269,10,16,677,523,154,6
14656,2023-09-03 16:00:00,140,275,6,18,731,618,113,7
14657,2023-09-03 17:00:00,137,263,11,12,741,519,222,10
14658,2023-09-03 18:00:00,121,270,12,11,747,660,87,9
14659,2023-09-03 19:00:00,137,291,13,14,754,652,102,10
14660,2023-09-03 20:00:00,142,255,13,15,663,546,117,5
14661,2023-09-03 21:00:00,132,254,12,19,539,475,64,8
14662,2023-09-03 22:00:00,121,253,12,15,663,534,129,9
14663,2023-09-03 23:00:00,122,279,11,13,643,482,161,11
14664,2023-09-04 00:00:00,128,273,14,17,559,423,136,10
14665,2023-09-04 01:00:00,138,280,8,18,793,561,232,7
14666,2023-09-04 02:00:00,146,266,12,15,601,525,76,12
14667,2023-09-04 03:00:00,127,295,13,10,550,494,56,8
14668,2023-09-04 04:00:00,132,270,10,14,779,670,109,9
14669,2023-09-04 05:00:00,148,288,8,19,739,639,100,12
14670,2023-09-04 06:00:00,125,299,7,19,646,482,164,8
14671,2023-09-04 07:00:00,124,271,8,15,692,512,180,12
14672,2023-09-04 08:00:00,148,279,6,19,727,543,184,14
14673,2023-09-04 09:00:00,133,259,5,14,500,372,128,13
14674,2023-09-04 10:00:00,134,269,10,19,722,516,206,14
14675,2023-09-04 11:00:00,134,284,12,18,785,619,166,8
14676,2023-09-04 12:00:00,126,251,6,18,750,550,200,11
14677,2023-09-04 13:00:00,128,253,9,15,733,639,94,14
14678,2023-09-04 14:00:00,133,274,14,16,775,569,206,9
14679,2023-09-04 15:00:00,130,271,5,10,661,577,84,11
14680,2023-09-04 16:00:00,124,293,6,15,556,389,167,6
14681,2023-09-04 17:00:00,140,287,9,16,703,628,75,12
14682,2023-09-04 18:00:00,149,292,7,17,603,435,168,12
14683,2023-09-04 19:00:00,130,283,9,19,703,562,141,12
14684,2023-09-04 20:00:00,127,267,6,18,504,363,141,7
14685,2023-09-04 21:00:00,125,281,13,18,715,572,143,12
14686,2023-09-04 22:00:00,127,267,11,13,699,541,158,11
14687,2023-09-04 23:00:00,126,280,10,18,573,474,99,14
14688,2023-09-05 00:00:00,127,291,9,16,793,576,217,10
14689,2023-09-05 01:00:00,143,258,10,18,797,650,147,11
14690,2023-09-05 02:00:00,128,277,11,17,576,452,124,6
14691,2023-09-05 03:00:00,133,269,14,18,559,472,87,5
14692,2023-09-05 04:00:00,145,287,14,15,615,453,162,11
14693,2023-09-05 05:00:00,131,287,13,12,732,614,118,6
14694,2023-09-05 06:00:00,134,278,13,11,796,590,206,12
14695,2023-09-05 07:00:00,132,255,14,18,587,521,66,6
14696,2023-09-05 08:00:00,122,277,10,15,625,470,155,10
14697,2023-09-05 09:00:00,148,299,13,15,661,525,136,5
14698,2023-09-05 10:00:00,137,295,10,15,588,465,123,10
14699,2023-09-05 11:00:00,137,280,14,14,536,453,83,12
14700,2023-09-05 12:00:00,128,273,11,10,685,585,100,14
14701,2023-09-05 13:00:00,142,271,11,16,782,666,116,10
14702,2023-09-05 14:00:00,134,269,12,10,703,501,202,13
14703,2023-09-05 15:00:00,133,287,13,18,653,495,158,11
14704,2023-09-05 16:00:00,149,293,6,15,667,474,193,12
14705,2023-09-05 17:00:00,129,276,12,16,649,551,98,8
14706,2023-09-05 18:00:00,141,262,10,14,645,528,117,14
14707,2023-09-05 19:00:00,131,269,11,18,567,422,145,9
14708,2023-09-05 20:00:00,133,255,10,13,783,629,154,13
14709,2023-09-05 21:00:00,122,264,13,17,559,423,136,13
14710,2023-09-05 22:00:00,147,270,7,11,655,565,90,12
14711,2023-09-05 23:00:00,146,266,14,18,626,511,115,10
14712,2023-09-06 00:00:00,126,298,5,15,656,540,116,10
14713,2023-09-06 01:00:00,148,267,10,11,682,513,169,8
14714,2023-09-06 02:00:00,146,288,10,18,655,574,81,5
14715,2023-09-06 03:00:00,145,268,8,16,754,551,203,5
14716,2023-09-06 04:00:00,140,280,5,19,784,550,234,14
14717,2023-09-06 05:00:00,131,282,6,17,650,546,104,6
14718,2023-09-06 06:00:00,142,268,5,10,697,597,100,9
14719,2023-09-06 07:00:00,134,291,14,15,604,429,175,14
14720,2023-09-06 08:00:00,140,264,6,15,538,380,158,11
14721,2023-09-06 09:00:00,143,260,8,19,520,446,74,6
14722,2023-09-06 10:00:00,142,252,5,12,740,556,184,13
14723,2023-09-06 11:00:00,147,296,5,10,596,521,75,13
14724,2023-09-06 12:00:00,137,293,12,11,704,505,199,14
14725,2023-09-06 13:00:00,141,287,10,19,729,554,175,14
14726,2023-09-06 14:00:00,145,295,10,10,711,523,188,12
14727,2023-09-06 15:00:00,139,282,6,12,760,622,138,7
14728,2023-09-06 16:00:00,125,264,10,19,604,474,130,11
14729,2023-09-06 17:00:00,129,273,12,17,709,543,166,13
14730,2023-09-06 18:00:00,132,266,7,13,618,541,77,12
14731,2023-09-06 19:00:00,141,283,13,11,564,465,99,10
14732,2023-09-06 20:00:00,144,266,7,15,542,487,55,10
14733,2023-09-06 21:00:00,143,273,9,10,671,489,182,7
14734,2023-09-06 22:00:00,139,282,12,17,651,516,135,7
14735,2023-09-06 23:00:00,143,276,10,14,611,541,70,6
14736,2023-09-07 00:00:00,130,282,10,14,775,651,124,6
14737,2023-09-07 01:00:00,137,256,9,14,799,573,226,10
14738,2023-09-07 02:00:00,120,268,8,17,555,483,72,6
14739,2023-09-07 03:00:00,135,257,10,18,747,573,174,9
14740,2023-09-07 04:00:00,122,278,5,13,729,544,185,10
14741,2023-09-07 05:00:00,130,264,13,17,619,534,85,5
14742,2023-09-07 06:00:00,130,283,5,17,603,469,134,12
14743,2023-09-07 07:00:00,131,290,8,16,787,702,85,12
14744,2023-09-07 08:00:00,127,259,13,18,533,409,124,11
14745,2023-09-07 09:00:00,136,261,13,12,500,382,118,5
14746,2023-09-07 10:00:00,132,290,13,14,795,675,120,8
14747,2023-09-07 11:00:00,149,266,9,12,574,444,130,14
14748,2023-09-07 12:00:00,138,270,13,14,529,433,96,6
14749,2023-09-07 13:00:00,147,256,10,14,598,509,89,11
14750,2023-09-07 14:00:00,141,252,7,18,524,448,76,9
14751,2023-09-07 15:00:00,141,277,12,19,519,394,125,8
14752,2023-09-07 16:00:00,143,294,7,16,701,578,123,5
14753,2023-09-07 17:00:00,137,279,5,19,658,536,122,10
14754,2023-09-07 18:00:00,130,270,7,12,766,599,167,12
14755,2023-09-07 19:00:00,122,264,5,17,689,522,167,14
14756,2023-09-07 20:00:00,121,274,14,15,528,384,144,12
14757,2023-09-07 21:00:00,134,275,10,14,631,496,135,10
14758,2023-09-07 22:00:00,127,267,8,10,543,423,120,8
14759,2023-09-07 23:00:00,143,259,7,15,781,546,235,6
14760,2023-09-08 00:00:00,142,281,9,11,562,468,94,14
14761,2023-09-08 01:00:00,137,298,9,15,523,448,75,14
14762,2023-09-08 02:00:00,123,290,13,19,664,549,115,8
14763,2023-09-08 03:00:00,140,253,6,15,637,550,87,12
14764,2023-09-08 04:00:00,121,257,6,15,773,617,156,6
14765,2023-09-08 05:00:00,143,260,13,11,582,436,146,14
14766,2023-09-08 06:00:00,141,273,9,12,522,394,128,7
14767,2023-09-08 07:00:00,120,263,13,15,651,494,157,10
14768,2023-09-08 08:00:00,121,282,12,16,728,610,118,6
14769,2023-09-08 09:00:00,135,274,13,16,736,644,92,7
14770,2023-09-08 10:00:00,149,270,9,11,717,625,92,13
14771,2023-09-08 11:00:00,145,285,11,12,622,462,160,5
14772,2023-09-08 12:00:00,122,256,11,19,551,429,122,13
14773,2023-09-08 13:00:00,148,293,13,11,514,361,153,13
14774,2023-09-08 14:00:00,132,280,12,14,524,469,55,9
14775,2023-09-08 15:00:00,144,273,7,17,708,496,212,11
14776,2023-09-08 16:00:00,133,269,6,16,539,464,75,8
14777,2023-09-08 17:00:00,120,279,11,12,557,464,93,10
14778,2023-09-08 18:00:00,123,253,13,15,617,467,150,12
14779,2023-09-08 19:00:00,148,288,13,13,593,432,161,11
14780,2023-09-08 20:00:00,120,282,14,17,730,581,149,14
14781,2023-09-08 21:00:00,138,260,14,13,592,514,78,6
14782,2023-09-08 22:00:00,135,257,9,19,688,608,80,10
14783,2023-09-08 23:00:00,125,262,12,10,610,442,168,9
14784,2023-09-09 00:00:00,124,280,5,14,694,618,76,14
14785,2023-09-09 01:00:00,125,282,10,19,730,646,84,10
14786,2023-09-09 02:00:00,147,294,9,12,713,561,152,7
14787,2023-09-09 03:00:00,127,262,5,14,546,430,116,6
14788,2023-09-09 04:00:00,137,269,14,15,728,587,141,12
14789,2023-09-09 05:00:00,122,274,14,15,684,574,110,12
14790,2023-09-09 06:00:00,121,263,13,12,736,603,133,7
14791,2023-09-09 07:00:00,124,298,8,15,628,561,67,13
14792,2023-09-09 08:00:00,129,250,5,17,595,460,135,7
14793,2023-09-09 09:00:00,139,290,14,13,539,441,98,10
14794,2023-09-09 10:00:00,137,298,10,19,595,420,175,14
14795,2023-09-09 11:00:00,123,269,6,19,593,465,128,7
14796,2023-09-09 12:00:00,125,283,13,19,761,663,98,5
14797,2023-09-09 13:00:00,141,294,10,10,502,382,120,8
14798,2023-09-09 14:00:00,138,290,13,15,690,571,119,8
14799,2023-09-09 15:00:00,121,258,12,16,705,631,74,10
14800,2023-09-09 16:00:00,141,261,7,16,531,388,143,5
14801,2023-09-09 17:00:00,129,294,9,10,670,521,149,9
14802,2023-09-09 18:00:00,148,285,8,18,735,627,108,5
14803,2023-09-09 19:00:00,138,260,14,15,567,441,126,5
14804,2023-09-09 20:00:00,120,299,13,17,637,525,112,11
14805,2023-09-09 21:00:00,148,299,11,13,544,428,116,8
14806,2023-09-09 22:00:00,132,287,11,16,578,512,66,5
14807,2023-09-09 23:00:00,125,277,11,15,513,449,64,11
14808,2023-09-10 00:00:00,143,268,10,15,558,427,131,6
14809,2023-09-10 01:00:00,128,272,9,15,526,407,119,8
14810,2023-09-10 02:00:00,137,288,10,12,599,476,123,8
14811,2023-09-10 03:00:00,139,262,5,17,644,512,132,14
14812,2023-09-10 04:00:00,149,285,7,15,508,431,77,11
14813,2023-09-10 05:00:00,121,297,13,12,638,566,72,14
14814,2023-09-10 06:00:00,124,260,14,11,783,648,135,9
14815,2023-09-10 07:00:00,149,263,7,15,686,591,95,6
14816,2023-09-10 08:00:00,143,274,14,14,743,658,85,5
14817,2023-09-10 09:00:00,141,265,11,16,648,470,178,7
14818,2023-09-10 10:00:00,131,277,9,11,735,645,90,6
14819,2023-09-10 11:00:00,136,250,10,10,631,547,84,10
14820,2023-09-10 12:00:00,123,296,13,10,572,475,97,6
14821,2023-09-10 13:00:00,148,284,7,13,778,596,182,14
14822,2023-09-10 14:00:00,138,282,12,15,592,513,79,10
14823,2023-09-10 15:00:00,142,267,11,13,605,489,116,13
14824,2023-09-10 16:00:00,147,277,11,15,670,543,127,11
14825,2023-09-10 17:00:00,143,294,11,17,666,535,131,11
14826,2023-09-10 18:00:00,141,283,10,12,613,449,164,12
14827,2023-09-10 19:00:00,130,269,13,19,535,381,154,10
14828,2023-09-10 20:00:00,121,281,14,19,581,458,123,6
14829,2023-09-10 21:00:00,143,286,12,13,692,542,150,5
14830,2023-09-10 22:00:00,126,269,7,17,549,485,64,12
14831,2023-09-10 23:00:00,130,298,10,11,755,621,134,10
14832,2023-09-11 00:00:00,132,270,13,19,674,542,132,12
14833,2023-09-11 01:00:00,124,296,10,15,526,429,97,13
14834,2023-09-11 02:00:00,128,250,13,19,513,443,70,6
14835,2023-09-11 03:00:00,120,256,11,18,550,485,65,14
14836,2023-09-11 04:00:00,125,253,8,17,669,562,107,14
14837,2023-09-11 05:00:00,138,269,6,18,757,657,100,8
14838,2023-09-11 06:00:00,127,250,6,17,517,418,99,6
14839,2023-09-11 07:00:00,124,253,14,19,707,632,75,9
14840,2023-09-11 08:00:00,138,263,8,17,679,524,155,7
14841,2023-09-11 09:00:00,138,288,12,11,713,581,132,12
14842,2023-09-11 10:00:00,145,285,5,16,562,439,123,10
14843,2023-09-11 11:00:00,143,281,9,11,640,455,185,7
14844,2023-09-11 12:00:00,120,287,14,18,511,430,81,7
14845,2023-09-11 13:00:00,141,280,10,19,662,585,77,8
14846,2023-09-11 14:00:00,147,288,11,18,715,525,190,5
14847,2023-09-11 15:00:00,131,263,5,13,558,482,76,8
14848,2023-09-11 16:00:00,129,261,14,12,747,630,117,10
14849,2023-09-11 17:00:00,126,292,9,18,704,534,170,13
14850,2023-09-11 18:00:00,145,264,11,13,558,411,147,6
14851,2023-09-11 19:00:00,143,253,7,14,784,568,216,5
14852,2023-09-11 20:00:00,129,297,7,17,575,500,75,10
14853,2023-09-11 21:00:00,133,275,12,19,729,564,165,7
14854,2023-09-11 22:00:00,129,297,13,19,581,434,147,10
14855,2023-09-11 23:00:00,137,255,9,14,516,453,63,8
14856,2023-09-12 00:00:00,121,270,12,16,733,555,178,7
14857,2023-09-12 01:00:00,124,295,6,13,672,518,154,9
14858,2023-09-12 02:00:00,126,279,10,10,660,531,129,13
14859,2023-09-12 03:00:00,136,265,9,13,507,389,118,11
14860,2023-09-12 04:00:00,122,274,14,13,699,528,171,5
14861,2023-09-12 05:00:00,129,268,13,11,709,511,198,14
14862,2023-09-12 06:00:00,123,271,6,10,793,653,140,9
14863,2023-09-12 07:00:00,144,293,6,14,624,441,183,13
14864,2023-09-12 08:00:00,142,272,7,14,668,541,127,7
14865,2023-09-12 09:00:00,143,259,14,16,614,431,183,10
14866,2023-09-12 10:00:00,147,250,9,14,701,585,116,8
14867,2023-09-12 11:00:00,123,268,10,19,564,446,118,7
14868,2023-09-12 12:00:00,137,269,9,13,635,553,82,11
14869,2023-09-12 13:00:00,141,279,11,18,685,610,75,5
14870,2023-09-12 14:00:00,130,265,5,11,599,438,161,11
14871,2023-09-12 15:00:00,134,271,7,14,754,630,124,5
14872,2023-09-12 16:00:00,134,277,13,17,744,593,151,14
14873,2023-09-12 17:00:00,140,286,7,18,508,390,118,9
14874,2023-09-12 18:00:00,130,265,14,11,607,495,112,9
14875,2023-09-12 19:00:00,144,293,12,11,707,536,171,11
14876,2023-09-12 20:00:00,130,282,9,19,669,513,156,7
14877,2023-09-12 21:00:00,144,284,9,11,596,509,87,13
14878,2023-09-12 22:00:00,135,272,5,10,674,576,98,8
14879,2023-09-12 23:00:00,136,271,5,16,531,428,103,14
14880,2023-09-13 00:00:00,124,289,6,10,527,411,116,7
14881,2023-09-13 01:00:00,136,291,13,10,738,523,215,8
14882,2023-09-13 02:00:00,127,290,12,18,624,445,179,12
14883,2023-09-13 03:00:00,124,265,14,14,501,404,97,6
14884,2023-09-13 04:00:00,122,276,11,17,641,495,146,10
14885,2023-09-13 05:00:00,127,283,11,18,665,524,141,8
14886,2023-09-13 06:00:00,138,262,9,17,781,595,186,10
14887,2023-09-13 07:00:00,142,252,6,18,695,559,136,11
14888,2023-09-13 08:00:00,133,290,13,12,738,562,176,9
14889,2023-09-13 09:00:00,132,272,10,17,765,652,113,14
14890,2023-09-13 10:00:00,128,282,6,15,710,638,72,8
14891,2023-09-13 11:00:00,122,265,13,14,549,427,122,5
14892,2023-09-13 12:00:00,132,262,5,12,772,603,169,8
14893,2023-09-13 13:00:00,125,296,13,14,506,385,121,6
14894,2023-09-13 14:00:00,145,255,13,18,610,440,170,8
14895,2023-09-13 15:00:00,120,286,7,11,701,530,171,7
14896,2023-09-13 16:00:00,124,288,14,18,509,416,93,14
14897,2023-09-13 17:00:00,138,267,6,17,543,381,162,5
14898,2023-09-13 18:00:00,148,269,10,15,663,575,88,5
14899,2023-09-13 19:00:00,121,298,9,14,555,447,108,7
14900,2023-09-13 20:00:00,129,272,13,13,606,456,150,5
14901,2023-09-13 21:00:00,126,290,9,17,538,441,97,11
14902,2023-09-13 22:00:00,135,259,9,14,629,451,178,13
14903,2023-09-13 23:00:00,143,296,12,19,618,436,182,9
14904,2023-09-14 00:00:00,136,286,12,13,561,405,156,12
14905,2023-09-14 01:00:00,138,286,14,16,712,630,82,14
14906,2023-09-14 02:00:00,145,290,6,15,728,568,160,5
14907,2023-09-14 03:00:00,132,282,14,17,660,579,81,13
14908,2023-09-14 04:00:00,147,264,6,14,533,377,156,12
14909,2023-09-14 05:00:00,147,277,14,13,784,704,80,7
14910,2023-09-14 06:00:00,137,280,6,11,765,618,147,11
14911,2023-09-14 07:00:00,131,292,5,16,508,432,76,14
14912,2023-09-14 08:00:00,131,288,7,17,632,532,100,5
14913,2023-09-14 09:00:00,135,287,12,17,681,589,92,7
14914,2023-09-14 10:00:00,137,289,12,15,676,600,76,11
14915,2023-09-14 11:00:00,137,285,8,18,788,658,130,9
14916,2023-09-14 12:00:00,136,262,9,12,582,431,151,9
14917,2023-09-14 13:00:00,125,298,9,17,740,551,189,6
14918,2023-09-14 14:00:00,123,273,8,13,525,410,115,13
14919,2023-09-14 15:00:00,147,268,6,19,699,542,157,14
14920,2023-09-14 16:00:00,122,273,11,14,708,579,129,10
14921,2023-09-14 17:00:00,123,273,5,15,578,438,140,13
14922,2023-09-14 18:00:00,128,271,13,18,730,533,197,9
14923,2023-09-14 19:00:00,122,298,7,18,603,517,86,13
14924,2023-09-14 20:00:00,135,263,12,18,603,521,82,7
14925,2023-09-14 21:00:00,148,266,6,19,730,582,148,9
14926,2023-09-14 22:00:00,138,282,13,16,765,679,86,14
14927,2023-09-14 23:00:00,133,275,14,15,752,593,159,11
14928,2023-09-15 00:00:00,148,265,10,10,762,562,200,7
14929,2023-09-15 01:00:00,137,270,14,11,569,491,78,11
14930,2023-09-15 02:00:00,148,287,10,11,544,399,145,10
14931,2023-09-15 03:00:00,129,277,13,15,630,445,185,13
14932,2023-09-15 04:00:00,132,280,13,15,693,597,96,7
14933,2023-09-15 05:00:00,149,295,11,19,792,631,161,14
14934,2023-09-15 06:00:00,131,278,14,17,657,482,175,13
14935,2023-09-15 07:00:00,142,274,6,13,621,537,84,7
14936,2023-09-15 08:00:00,127,298,9,16,568,409,159,12
14937,2023-09-15 09:00:00,129,272,12,11,570,441,129,6
14938,2023-09-15 10:00:00,136,263,7,16,787,650,137,13
14939,2023-09-15 11:00:00,131,257,12,16,606,432,174,5
14940,2023-09-15 12:00:00,138,262,6,18,639,500,139,14
14941,2023-09-15 13:00:00,120,276,10,16,636,520,116,6
14942,2023-09-15 14:00:00,122,284,9,13,661,525,136,9
14943,2023-09-15 15:00:00,145,281,6,11,653,577,76,5
14944,2023-09-15 16:00:00,130,257,13,17,752,668,84,6
14945,2023-09-15 17:00:00,147,276,12,18,697,502,195,9
14946,2023-09-15 18:00:00,128,262,6,13,710,609,101,10
14947,2023-09-15 19:00:00,147,260,11,18,615,453,162,10
14948,2023-09-15 20:00:00,142,264,10,15,710,549,161,13
14949,2023-09-15 21:00:00,140,264,13,13,692,551,141,11
14950,2023-09-15 22:00:00,135,257,6,19,599,534,65,6
14951,2023-09-15 23:00:00,132,255,9,12,627,537,90,9
14952,2023-09-16 00:00:00,124,299,6,19,795,573,222,10
14953,2023-09-16 01:00:00,121,275,11,16,580,484,96,8
14954,2023-09-16 02:00:00,137,260,13,17,788,562,226,6
14955,2023-09-16 03:00:00,122,254,11,16,682,562,120,9
14956,2023-09-16 04:00:00,131,286,6,14,521,365,156,8
14957,2023-09-16 05:00:00,142,263,11,13,762,595,167,10
14958,2023-09-16 06:00:00,133,263,11,17,684,560,124,10
14959,2023-09-16 07:00:00,133,264,7,15,645,459,186,5
14960,2023-09-16 08:00:00,133,254,10,16,666,555,111,7
14961,2023-09-16 09:00:00,140,297,14,17,701,541,160,13
14962,2023-09-16 10:00:00,138,252,6,14,639,574,65,5
14963,2023-09-16 11:00:00,120,282,12,13,788,618,170,11
14964,2023-09-16 12:00:00,145,258,14,13,692,590,102,6
14965,2023-09-16 13:00:00,138,259,14,17,562,438,124,5
14966,2023-09-16 14:00:00,141,270,7,17,623,539,84,11
14967,2023-09-16 15:00:00,131,255,13,16,624,533,91,14
14968,2023-09-16 16:00:00,135,250,10,17,604,498,106,10
14969,2023-09-16 17:00:00,120,269,8,18,639,544,95,7
14970,2023-09-16 18:00:00,124,262,14,13,695,505,190,7
14971,2023-09-16 19:00:00,124,261,9,17,646,512,134,13
14972,2023-09-16 20:00:00,149,278,6,17,651,475,176,11
14973,2023-09-16 21:00:00,144,283,5,15,731,581,150,6
14974,2023-09-16 22:00:00,120,286,14,14,734,528,206,8
14975,2023-09-16 23:00:00,124,270,14,19,732,606,126,13
14976,2023-09-17 00:00:00,133,262,7,14,706,627,79,9
14977,2023-09-17 01:00:00,122,280,12,19,608,447,161,11
14978,2023-09-17 02:00:00,122,265,14,16,798,703,95,13
14979,2023-09-17 03:00:00,139,269,11,12,578,463,115,10
14980,2023-09-17 04:00:00,136,252,5,16,785,674,111,14
14981,2023-09-17 05:00:00,148,282,7,13,667,579,88,13
14982,2023-09-17 06:00:00,121,251,10,11,675,550,125,11
14983,2023-09-17 07:00:00,134,275,14,10,706,603,103,12
14984,2023-09-17 08:00:00,131,266,12,11,551,406,145,13
14985,2023-09-17 09:00:00,147,267,13,15,692,531,161,10
14986,2023-09-17 10:00:00,125,288,12,17,782,569,213,12
14987,2023-09-17 11:00:00,122,260,9,13,728,627,101,13
14988,2023-09-17 12:00:00,123,287,5,11,724,598,126,5
14989,2023-09-17 13:00:00,135,271,14,19,665,500,165,10
14990,2023-09-17 14:00:00,149,250,6,12,617,437,180,14
14991,2023-09-17 15:00:00,127,267,9,19,654,466,188,8
14992,2023-09-17 16:00:00,148,294,11,17,735,613,122,11
14993,2023-09-17 17:00:00,124,277,7,16,628,470,158,14
14994,2023-09-17 18:00:00,133,287,7,16,506,424,82,11
14995,2023-09-17 19:00:00,139,282,9,12,722,575,147,10
14996,2023-09-17 20:00:00,138,295,13,14,682,511,171,11
14997,2023-09-17 21:00:00,132,270,8,14,789,634,155,10
14998,2023-09-17 22:00:00,147,275,10,16,561,461,100,7
14999,2023-09-17 23:00:00,130,272,5,10,712,501,211,6
15000,2023-09-18 00:00:00,137,262,14,11,678,556,122,12
15001,2023-09-18 01:00:00,120,258,9,17,576,496,80,11
15002,2023-09-18 02:00:00,125,258,12,16,632,482,150,8
15003,2023-09-18 03:00:00,123,264,11,19,656,465,191,5
15004,2023-09-18 04:00:00,149,293,7,14,620,536,84,10
15005,2023-09-18 05:00:00,125,260,10,13,704,554,150,7
15006,2023-09-18 06:00:00,130,279,8,18,572,433,139,6
15007,2023-09-18 07:00:00,147,259,8,17,603,454,149,9
15008,2023-09-18 08:00:00,147,256,12,19,702,512,190,9
15009,2023-09-18 09:00:00,140,275,11,19,665,538,127,8
15010,2023-09-18 10:00:00,128,274,6,18,746,649,97,7
15011,2023-09-18 11:00:00,145,274,11,19,765,535,230,5
15012,2023-09-18 12:00:00,128,287,7,18,527,381,146,14
15013,2023-09-18 13:00:00,147,271,10,17,660,487,173,14
15014,2023-09-18 14:00:00,140,261,11,18,647,562,85,5
15015,2023-09-18 15:00:00,136,264,10,12,636,558,78,11
15016,2023-09-18 16:00:00,128,283,10,13,712,537,175,5
15017,2023-09-18 17:00:00,133,294,14,13,622,442,180,6
15018,2023-09-18 18:00:00,120,288,7,12,569,428,141,8
15019,2023-09-18 19:00:00,147,270,8,18,773,554,219,11
15020,2023-09-18 20:00:00,125,283,9,17,766,573,193,8
15021,2023-09-18 21:00:00,126,258,13,15,577,449,128,6
15022,2023-09-18 22:00:00,122,254,9,19,773,628,145,12
15023,2023-09-18 23:00:00,134,293,6,17,662,593,69,10
15024,2023-09-19 00:00:00,130,269,10,17,732,576,156,9
15025,2023-09-19 01:00:00,121,260,6,19,557,414,143,6
15026,2023-09-19 02:00:00,130,284,12,19,758,603,155,12
15027,2023-09-19 03:00:00,127,288,14,12,574,407,167,13
15028,2023-09-19 04:00:00,142,282,8,11,531,438,93,9
15029,2023-09-19 05:00:00,129,252,9,12,506,416,90,12
15030,2023-09-19 06:00:00,127,298,13,19,628,562,66,7
15031,2023-09-19 07:00:00,124,279,13,17,769,555,214,14
15032,2023-09-19 08:00:00,125,291,7,19,693,498,195,7
15033,2023-09-19 09:00:00,120,279,13,13,601,464,137,5
15034,2023-09-19 10:00:00,120,284,9,14,784,589,195,6
15035,2023-09-19 11:00:00,132,297,7,16,732,546,186,11
15036,2023-09-19 12:00:00,145,286,6,12,705,573,132,8
15037,2023-09-19 13:00:00,137,287,5,17,694,547,147,5
15038,2023-09-19 14:00:00,143,251,9,13,559,466,93,14
15039,2023-09-19 15:00:00,120,257,8,16,735,549,186,7
15040,2023-09-19 16:00:00,121,266,12,19,798,654,144,6
15041,2023-09-19 17:00:00,125,299,11,10,621,535,86,14
15042,2023-09-19 18:00:00,146,272,11,17,738,590,148,11
15043,2023-09-19 19:00:00,138,261,13,14,552,452,100,13
15044,2023-09-19 20:00:00,136,279,9,17,555,431,124,11
15045,2023-09-19 21:00:00,120,250,5,16,792,686,106,13
15046,2023-09-19 22:00:00,125,250,10,11,547,478,69,14
15047,2023-09-19 23:00:00,120,250,6,16,609,505,104,10
15048,2023-09-20 00:00:00,126,251,12,13,556,434,122,5
15049,2023-09-20 01:00:00,124,298,10,19,680,536,144,14
15050,2023-09-20 02:00:00,124,289,14,10,780,567,213,5
15051,2023-09-20 03:00:00,147,298,5,14,797,611,186,11
15052,2023-09-20 04:00:00,140,292,8,13,504,365,139,5
15053,2023-09-20 05:00:00,140,297,7,11,757,563,194,9
15054,2023-09-20 06:00:00,135,280,6,10,609,435,174,6
15055,2023-09-20 07:00:00,132,267,10,18,660,572,88,11
15056,2023-09-20 08:00:00,126,294,8,18,691,581,110,12
15057,2023-09-20 09:00:00,134,294,11,19,501,380,121,7
15058,2023-09-20 10:00:00,132,250,6,18,514,441,73,5
15059,2023-09-20 11:00:00,147,275,9,15,541,414,127,14
15060,2023-09-20 12:00:00,139,289,13,17,570,452,118,14
15061,2023-09-20 13:00:00,136,291,6,19,791,624,167,11
15062,2023-09-20 14:00:00,130,296,8,13,537,394,143,6
15063,2023-09-20 15:00:00,123,270,10,18,544,425,119,9
15064,2023-09-20 16:00:00,146,291,9,14,679,545,134,14
15065,2023-09-20 17:00:00,146,256,5,18,681,603,78,14
15066,2023-09-20 18:00:00,126,255,9,11,702,582,120,11
15067,2023-09-20 19:00:00,136,258,12,17,680,503,177,6
15068,2023-09-20 20:00:00,126,292,7,14,747,670,77,6
15069,2023-09-20 21:00:00,138,266,13,13,781,558,223,10
15070,2023-09-20 22:00:00,147,299,8,17,714,640,74,5
15071,2023-09-20 23:00:00,123,262,7,12,768,555,213,7
15072,2023-09-21 00:00:00,139,285,11,19,641,576,65,11
15073,2023-09-21 01:00:00,137,255,9,17,744,622,122,12
15074,2023-09-21 02:00:00,141,271,9,18,655,476,179,14
15075,2023-09-21 03:00:00,139,264,10,14,645,518,127,12
15076,2023-09-21 04:00:00,141,298,11,14,712,549,163,5
15077,2023-09-21 05:00:00,123,278,7,14,709,497,212,9
15078,2023-09-21 06:00:00,149,271,9,11,750,531,219,14
15079,2023-09-21 07:00:00,124,284,8,14,725,582,143,13
15080,2023-09-21 08:00:00,134,295,5,10,644,470,174,12
15081,2023-09-21 09:00:00,140,272,5,16,697,565,132,6
15082,2023-09-21 10:00:00,130,282,12,19,579,410,169,11
15083,2023-09-21 11:00:00,122,258,8,18,577,485,92,11
15084,2023-09-21 12:00:00,124,252,10,11,734,553,181,6
15085,2023-09-21 13:00:00,123,261,8,15,624,510,114,14
15086,2023-09-21 14:00:00,146,294,13,12,708,500,208,9
15087,2023-09-21 15:00:00,124,297,11,18,638,448,190,9
15088,2023-09-21 16:00:00,148,273,14,16,751,528,223,12
15089,2023-09-21 17:00:00,147,260,13,14,564,407,157,9
15090,2023-09-21 18:00:00,124,250,12,15,753,591,162,6
15091,2023-09-21 19:00:00,137,273,12,17,614,512,102,10
15092,2023-09-21 20:00:00,135,258,13,13,501,417,84,12
15093,2023-09-21 21:00:00,146,291,11,13,721,643,78,12
15094,2023-09-21 22:00:00,133,251,13,14,705,572,133,7
15095,2023-09-21 23:00:00,140,268,12,19,556,405,151,8
15096,2023-09-22 00:00:00,123,273,10,10,761,677,84,14
15097,2023-09-22 01:00:00,137,251,10,18,595,506,89,8
15098,2023-09-22 02:00:00,128,293,5,15,604,456,148,13
15099,2023-09-22 03:00:00,124,274,6,13,761,567,194,13
15100,2023-09-22 04:00:00,143,268,6,19,747,557,190,14
15101,2023-09-22 05:00:00,147,288,9,10,669,514,155,13
15102,2023-09-22 06:00:00,131,289,10,19,575,440,135,13
15103,2023-09-22 07:00:00,129,276,6,10,584,423,161,13
15104,2023-09-22 08:00:00,130,283,12,12,789,614,175,6
15105,2023-09-22 09:00:00,143,254,10,10,709,603,106,12
15106,2023-09-22 10:00:00,146,258,6,12,550,475,75,14
15107,2023-09-22 11:00:00,144,279,11,17,751,608,143,7
15108,2023-09-22 12:00:00,120,268,6,19,684,602,82,5
15109,2023-09-22 13:00:00,142,280,6,17,695,507,188,14
15110,2023-09-22 14:00:00,130,293,12,12,570,490,80,11
15111,2023-09-22 15:00:00,143,291,5,15,551,451,100,10
15112,2023-09-22 16:00:00,122,287,6,18,555,488,67,6
15113,2023-09-22 17:00:00,121,253,5,15,591,528,63,14
15114,2023-09-22 18:00:00,133,262,10,10,680,531,149,7
15115,2023-09-22 19:00:00,139,295,5,19,744,548,196,12
15116,2023-09-22 20:00:00,142,299,8,11,688,489,199,13
15117,2023-09-22 21:00:00,142,276,13,18,675,529,146,10
15118,2023-09-22 22:00:00,147,297,13,14,582,438,144,13
15119,2023-09-22 23:00:00,121,293,12,10,629,518,111,13
15120,2023-09-23 00:00:00,138,264,7,15,723,507,216,14
15121,2023-09-23 01:00:00,123,297,9,13,720,637,83,10
15122,2023-09-23 02:00:00,127,296,6,18,533,446,87,14
15123,2023-09-23 03:00:00,120,287,10,10,533,390,143,11
15124,2023-09-23 04:00:00,148,273,11,14,618,537,81,13
15125,2023-09-23 05:00:00,139,295,13,14,600,524,76,8
15126,2023-09-23 06:00:00,134,284,7,18,735,590,145,14
15127,2023-09-23 07:00:00,131,253,10,15,790,641,149,8
15128,2023-09-23 08:00:00,147,261,5,12,598,514,84,6
15129,2023-09-23 09:00:00,143,290,7,12,706,504,202,7
15130,2023-09-23 10:00:00,139,277,11,17,754,577,177,11
15131,2023-09-23 11:00:00,131,287,7,17,788,670,118,12
15132,2023-09-23 12:00:00,144,264,11,15,537,378,159,11
15133,2023-09-23 13:00:00,137,281,7,15,627,518,109,5
15134,2023-09-23 14:00:00,147,290,7,13,577,517,60,14
15135,2023-09-23 15:00:00,128,258,5,10,744,646,98,10
15136,2023-09-23 16:00:00,120,259,9,17,734,644,90,13
15137,2023-09-23 17:00:00,149,251,10,16,519,393,126,6
15138,2023-09-23 18:00:00,133,286,10,14,585,455,130,10
15139,2023-09-23 19:00:00,131,293,5,11,798,629,169,5
15140,2023-09-23 20:00:00,128,255,9,10,523,456,67,13
15141,2023-09-23 21:00:00,147,277,9,11,607,478,129,10
15142,2023-09-23 22:00:00,137,280,7,18,534,439,95,6
15143,2023-09-23 23:00:00,133,269,5,11,581,429,152,12
15144,2023-09-24 00:00:00,130,288,6,17,788,628,160,6
15145,2023-09-24 01:00:00,127,273,12,16,643,499,144,14
15146,2023-09-24 02:00:00,147,299,8,16,512,372,140,11
15147,2023-09-24 03:00:00,143,293,9,14,623,545,78,13
15148,2023-09-24 04:00:00,127,275,11,15,752,617,135,12
15149,2023-09-24 05:00:00,139,252,12,11,736,629,107,9
15150,2023-09-24 06:00:00,145,257,5,14,723,575,148,12
15151,2023-09-24 07:00:00,144,299,6,12,501,364,137,5
15152,2023-09-24 08:00:00,140,286,12,12,552,408,144,12
15153,2023-09-24 09:00:00,143,269,7,14,713,547,166,7
15154,2023-09-24 10:00:00,143,272,7,14,571,486,85,8
15155,2023-09-24 11:00:00,124,298,7,13,736,517,219,5
15156,2023-09-24 12:00:00,125,252,7,13,798,585,213,8
15157,2023-09-24 13:00:00,147,289,7,15,716,631,85,11
15158,2023-09-24 14:00:00,137,299,9,10,748,582,166,7
15159,2023-09-24 15:00:00,143,269,12,18,767,554,213,11
15160,2023-09-24 16:00:00,137,256,10,13,570,445,125,5
15161,2023-09-24 17:00:00,146,251,10,10,502,440,62,11
15162,2023-09-24 18:00:00,129,263,12,14,706,543,163,10
15163,2023-09-24 19:00:00,120,280,11,15,700,587,113,8
15164,2023-09-24 20:00:00,128,261,6,18,634,549,85,14
15165,2023-09-24 21:00:00,138,274,14,13,594,481,113,11
15166,2023-09-24 22:00:00,143,291,11,12,718,505,213,9
15167,2023-09-24 23:00:00,130,253,6,10,782,614,168,11
15168,2023-09-25 00:00:00,144,277,10,10,764,568,196,9
15169,2023-09-25 01:00:00,121,279,6,17,718,598,120,5
15170,2023-09-25 02:00:00,149,297,13,15,544,485,59,14
15171,2023-09-25 03:00:00,138,292,11,18,581,419,162,10
15172,2023-09-25 04:00:00,147,255,10,17,670,497,173,14
15173,2023-09-25 05:00:00,132,252,11,14,765,589,176,14
15174,2023-09-25 06:00:00,129,290,11,10,593,455,138,14
15175,2023-09-25 07:00:00,133,270,7,14,588,495,93,14
15176,2023-09-25 08:00:00,144,286,12,11,546,397,149,8
15177,2023-09-25 09:00:00,137,285,7,19,520,372,148,8
15178,2023-09-25 10:00:00,128,266,5,16,671,511,160,5
15179,2023-09-25 11:00:00,131,256,6,17,755,643,112,8
15180,2023-09-25 12:00:00,145,259,13,19,644,500,144,10
15181,2023-09-25 13:00:00,122,257,13,10,642,462,180,5
15182,2023-09-25 14:00:00,137,299,10,11,753,584,169,13
15183,2023-09-25 15:00:00,140,257,13,16,745,625,120,6
15184,2023-09-25 16:00:00,124,253,10,18,596,421,175,6
15185,2023-09-25 17:00:00,137,299,12,10,651,542,109,6
15186,2023-09-25 18:00:00,128,270,9,11,747,626,121,7
15187,2023-09-25 19:00:00,142,293,10,13,721,599,122,13
15188,2023-09-25 20:00:00,140,294,11,18,543,398,145,12
15189,2023-09-25 21:00:00,148,290,7,17,624,544,80,6
15190,2023-09-25 22:00:00,149,292,8,11,593,433,160,12
15191,2023-09-25 23:00:00,135,296,5,15,627,488,139,8
15192,2023-09-26 00:00:00,125,288,14,17,505,365,140,6
15193,2023-09-26 01:00:00,134,266,8,17,541,439,102,6
15194,2023-09-26 02:00:00,148,252,14,12,715,635,80,13
15195,2023-09-26 03:00:00,131,260,11,18,598,461,137,6
15196,2023-09-26 04:00:00,131,288,10,13,631,467,164,7
15197,2023-09-26 05:00:00,145,280,10,10,637,559,78,11
15198,2023-09-26 06:00:00,123,263,11,11,730,562,168,8
15199,2023-09-26 07:00:00,142,252,13,13,506,416,90,10
15200,2023-09-26 08:00:00,133,271,10,18,647,470,177,5
15201,2023-09-26 09:00:00,135,293,13,13,655,576,79,6
15202,2023-09-26 10:00:00,121,251,13,10,794,607,187,8
15203,2023-09-26 11:00:00,140,290,10,16,630,504,126,14
15204,2023-09-26 12:00:00,141,258,11,12,799,638,161,7
15205,2023-09-26 13:00:00,122,288,10,19,756,662,94,11
15206,2023-09-26 14:00:00,120,258,8,17,781,582,199,7
15207,2023-09-26 15:00:00,147,268,11,16,622,476,146,9
15208,2023-09-26 16:00:00,124,254,8,17,629,441,188,7
15209,2023-09-26 17:00:00,133,297,8,11,575,514,61,12
15210,2023-09-26 18:00:00,128,262,6,10,664,550,114,5
15211,2023-09-26 19:00:00,123,251,13,16,537,397,140,6
15212,2023-09-26 20:00:00,138,260,11,18,651,513,138,10
15213,2023-09-26 21:00:00,137,273,6,19,677,550,127,12
15214,2023-09-26 22:00:00,123,259,12,10,682,594,88,8
15215,2023-09-26 23:00:00,129,295,14,16,788,645,143,14
15216,2023-09-27 00:00:00,146,277,6,14,691,589,102,11
15217,2023-09-27 01:00:00,127,277,8,10,765,608,157,10
15218,2023-09-27 02:00:00,128,263,9,13,603,462,141,13
15219,2023-09-27 03:00:00,128,265,12,11,758,665,93,10
15220,2023-09-27 04:00:00,148,268,13,17,657,561,96,9
15221,2023-09-27 05:00:00,144,277,12,13,672,565,107,13
15222,2023-09-27 06:00:00,126,250,13,18,682,496,186,7
15223,2023-09-27 07:00:00,132,271,8,13,675,555,120,6
15224,2023-09-27 08:00:00,144,298,13,13,591,479,112,5
15225,2023-09-27 09:00:00,132,258,10,12,650,509,141,10
15226,2023-09-27 10:00:00,134,250,8,19,676,524,152,9
15227,2023-09-27 11:00:00,130,281,14,11,562,426,136,9
15228,2023-09-27 12:00:00,142,284,8,13,736,621,115,10
15229,2023-09-27 13:00:00,136,277,6,15,794,713,81,10
15230,2023-09-27 14:00:00,135,278,13,19,712,610,102,7
15231,2023-09-27 15:00:00,146,298,9,17,749,532,217,9
15232,2023-09-27 16:00:00,141,282,5,12,539,451,88,12
15233,2023-09-27 17:00:00,120,291,9,13,517,408,109,14
15234,2023-09-27 18:00:00,133,284,8,19,702,536,166,7
15235,2023-09-27 19:00:00,143,286,5,18,790,699,91,6
15236,2023-09-27 20:00:00,141,265,13,13,729,563,166,7
15237,2023-09-27 21:00:00,143,292,9,10,748,601,147,9
15238,2023-09-27 22:00:00,138,254,7,11,555,400,155,13
15239,2023-09-27 23:00:00,136,298,10,11,628,541,87,7
15240,2023-09-28 00:00:00,139,251,7,15,637,498,139,9
15241,2023-09-28 01:00:00,132,279,13,11,767,552,215,5
15242,2023-09-28 02:00:00,130,296,13,15,797,715,82,14
15243,2023-09-28 03:00:00,129,263,14,17,650,558,92,11
15244,2023-09-28 04:00:00,143,280,11,19,611,502,109,10
15245,2023-09-28 05:00:00,137,273,7,14,597,526,71,8
15246,2023-09-28 06:00:00,133,258,8,17,782,655,127,10
15247,2023-09-28 07:00:00,140,277,13,19,522,393,129,6
15248,2023-09-28 08:00:00,148,264,8,15,625,539,86,10
15249,2023-09-28 09:00:00,125,264,10,11,523,391,132,8
15250,2023-09-28 10:00:00,148,293,9,19,766,584,182,6
15251,2023-09-28 11:00:00,147,281,10,15,790,650,140,6
15252,2023-09-28 12:00:00,137,280,5,11,594,440,154,9
15253,2023-09-28 13:00:00,128,284,9,14,780,635,145,8
15254,2023-09-28 14:00:00,126,278,8,13,584,515,69,12
15255,2023-09-28 15:00:00,143,280,10,18,691,551,140,13
15256,2023-09-28 16:00:00,131,280,14,11,510,452,58,6
15257,2023-09-28 17:00:00,127,250,7,18,783,641,142,9
15258,2023-09-28 18:00:00,130,256,10,15,541,468,73,12
15259,2023-09-28 19:00:00,132,286,13,16,705,529,176,11
15260,2023-09-28 20:00:00,145,267,7,17,719,506,213,6
15261,2023-09-28 21:00:00,147,274,6,16,537,379,158,11
15262,2023-09-28 22:00:00,130,288,14,13,549,490,59,12
15263,2023-09-28 23:00:00,142,279,12,12,528,467,61,9
15264,2023-09-29 00:00:00,138,267,12,17,739,645,94,13
15265,2023-09-29 01:00:00,124,288,9,19,672,512,160,9
15266,2023-09-29 02:00:00,138,287,13,16,635,567,68,6
15267,2023-09-29 03:00:00,130,258,7,17,799,596,203,9
15268,2023-09-29 04:00:00,121,264,10,16,503,419,84,11
15269,2023-09-29 05:00:00,135,274,5,13,641,557,84,10
15270,2023-09-29 06:00:00,121,297,7,10,679,523,156,13
15271,2023-09-29 07:00:00,133,273,5,16,707,539,168,13
15272,2023-09-29 08:00:00,138,295,6,16,763,675,88,9
15273,2023-09-29 09:00:00,137,285,7,17,689,616,73,10
15274,2023-09-29 10:00:00,130,291,9,13,623,501,122,10
15275,2023-09-29 11:00:00,140,289,14,14,718,604,114,10
15276,2023-09-29 12:00:00,144,288,5,16,738,572,166,12
15277,2023-09-29 13:00:00,129,290,10,17,623,520,103,13
15278,2023-09-29 14:00:00,132,296,5,12,714,558,156,11
15279,2023-09-29 15:00:00,129,264,9,11,663,557,106,8
15280,2023-09-29 16:00:00,145,278,12,10,792,571,221,8
15281,2023-09-29 17:00:00,139,280,13,15,745,658,87,7
15282,2023-09-29 18:00:00,138,273,9,15,587,434,153,5
15283,2023-09-29 19:00:00,137,299,11,10,567,446,121,9
15284,2023-09-29 20:00:00,122,256,9,12,773,686,87,10
15285,2023-09-29 21:00:00,149,269,6,14,538,433,105,12
15286,2023-09-29 22:00:00,130,268,14,10,502,383,119,7
15287,2023-09-29 23:00:00,134,269,11,16,579,407,172,7
15288,2023-09-30 00:00:00,133,256,14,19,782,572,210,5
15289,2023-09-30 01:00:00,141,255,9,19,737,546,191,13
15290,2023-09-30 02:00:00,147,271,9,10,585,488,97,8
15291,2023-09-30 03:00:00,123,278,5,18,623,469,154,7
15292,2023-09-30 04:00:00,135,254,13,19,513,433,80,12
15293,2023-09-30 05:00:00,129,261,8,12,682,536,146,9
15294,2023-09-30 06:00:00,149,290,10,17,689,482,207,12
15295,2023-09-30 07:00:00,147,261,14,17,744,606,138,5
15296,2023-09-30 08:00:00,143,255,12,14,644,515,129,9
15297,2023-09-30 09:00:00,138,269,13,15,667,490,177,10
15298,2023-09-30 10:00:00,139,274,12,11,686,564,122,9
15299,2023-09-30 11:00:00,146,297,14,11,540,404,136,12
15300,2023-09-30 12:00:00,142,275,12,12,605,460,145,9
15301,2023-09-30 13:00:00,140,293,13,16,738,548,190,6
15302,2023-09-30 14:00:00,132,287,5,17,634,449,185,8
15303,2023-09-30 15:00:00,140,259,5,17,680,517,163,12
15304,2023-09-30 16:00:00,123,281,11,10,647,522,125,5
15305,2023-09-30 17:00:00,141,266,7,19,798,561,237,12
15306,2023-09-30 18:00:00,149,264,13,15,530,391,139,9
15307,2023-09-30 19:00:00,123,289,7,19,702,609,93,8
15308,2023-09-30 20:00:00,138,251,6,13,613,433,180,9
15309,2023-09-30 21:00:00,122,284,10,12,606,514,92,8
15310,2023-09-30 22:00:00,145,258,13,18,634,465,169,6
15311,2023-09-30 23:00:00,140,280,13,12,507,407,100,9
15312,2023-10-01 00:00:00,143,277,7,10,679,569,110,8
15313,2023-10-01 01:00:00,127,260,13,18,757,602,155,12
15314,2023-10-01 02:00:00,137,272,8,13,692,494,198,5
15315,2023-10-01 03:00:00,124,299,10,12,685,480,205,13
15316,2023-10-01 04:00:00,121,282,10,18,541,443,98,6
15317,2023-10-01 05:00:00,144,250,12,12,530,434,96,13
15318,2023-10-01 06:00:00,136,252,11,11,640,493,147,13
15319,2023-10-01 07:00:00,142,259,6,16,632,567,65,11
15320,2023-10-01 08:00:00,141,269,9,19,791,629,162,6
15321,2023-10-01 09:00:00,123,269,5,17,500,392,108,6
15322,2023-10-01 10:00:00,139,262,6,12,516,396,120,11
15323,2023-10-01 11:00:00,129,275,5,11,515,426,89,10
15324,2023-10-01 12:00:00,127,291,10,15,587,415,172,13
15325,2023-10-01 13:00:00,135,295,14,10,552,447,105,14
15326,2023-10-01 14:00:00,132,281,12,17,686,559,127,7
15327,2023-10-01 15:00:00,121,269,13,10,789,591,198,14
15328,2023-10-01 16:00:00,120,294,10,15,550,443,107,12
15329,2023-10-01 17:00:00,139,264,5,16,720,569,151,11
15330,2023-10-01 18:00:00,141,276,8,17,544,414,130,11
15331,2023-10-01 19:00:00,146,292,10,15,522,469,53,11
15332,2023-10-01 20:00:00,142,286,13,15,614,480,134,14
15333,2023-10-01 21:00:00,143,270,14,17,641,520,121,9
15334,2023-10-01 22:00:00,122,258,10,13,661,484,177,14
15335,2023-10-01 23:00:00,131,258,9,13,704,535,169,7
15336,2023-10-02 00:00:00,131,254,9,19,689,595,94,5
15337,2023-10-02 01:00:00,131,255,10,14,666,564,102,5
15338,2023-10-02 02:00:00,135,287,14,11,613,531,82,13
15339,2023-10-02 03:00:00,123,283,9,18,628,548,80,5
15340,2023-10-02 04:00:00,144,270,14,16,582,411,171,10
15341,2023-10-02 05:00:00,147,251,11,19,798,578,220,10
15342,2023-10-02 06:00:00,137,294,13,10,685,502,183,13
15343,2023-10-02 07:00:00,136,264,14,16,718,542,176,9
15344,2023-10-02 08:00:00,148,271,14,19,696,569,127,14
15345,2023-10-02 09:00:00,139,258,11,10,550,446,104,8
15346,2023-10-02 10:00:00,148,273,6,12,767,641,126,11
15347,2023-10-02 11:00:00,144,250,9,16,522,386,136,9
15348,2023-10-02 12:00:00,129,295,6,15,710,603,107,9
15349,2023-10-02 13:00:00,139,284,9,15,793,685,108,12
15350,2023-10-02 14:00:00,122,250,8,18,536,448,88,12
15351,2023-10-02 15:00:00,121,279,12,11,519,465,54,12
15352,2023-10-02 16:00:00,123,270,10,12,578,437,141,14
15353,2023-10-02 17:00:00,123,286,12,18,693,619,74,5
15354,2023-10-02 18:00:00,120,266,9,15,745,614,131,5
15355,2023-10-02 19:00:00,128,263,14,12,561,428,133,6
15356,2023-10-02 20:00:00,139,287,14,14,667,554,113,6
15357,2023-10-02 21:00:00,133,250,10,19,761,620,141,11
15358,2023-10-02 22:00:00,142,256,11,10,699,504,195,7
15359,2023-10-02 23:00:00,124,272,7,14,552,407,145,5
15360,2023-10-03 00:00:00,120,297,7,11,588,516,72,6
15361,2023-10-03 01:00:00,140,277,11,10,679,577,102,12
15362,2023-10-03 02:00:00,130,256,10,15,783,582,201,9
15363,2023-10-03 03:00:00,148,275,13,15,779,575,204,13
15364,2023-10-03 04:00:00,143,263,14,10,729,552,177,9
15365,2023-10-03 05:00:00,120,267,5,18,510,365,145,10
15366,2023-10-03 06:00:00,137,260,13,13,625,499,126,12
15367,2023-10-03 07:00:00,131,287,11,14,771,604,167,14
15368,2023-10-03 08:00:00,124,283,11,15,726,566,160,5
15369,2023-10-03 09:00:00,129,299,5,14,548,440,108,13
15370,2023-10-03 10:00:00,140,266,5,13,616,525,91,13
15371,2023-10-03 11:00:00,141,278,7,11,540,388,152,8
15372,2023-10-03 12:00:00,122,268,6,15,589,426,163,5
15373,2023-10-03 13:00:00,128,256,7,19,618,504,114,14
15374,2023-10-03 14:00:00,132,278,9,10,567,482,85,11
15375,2023-10-03 15:00:00,127,261,11,16,670,588,82,5
15376,2023-10-03 16:00:00,139,280,8,17,615,538,77,10
15377,2023-10-03 17:00:00,135,250,13,14,569,482,87,9
15378,2023-10-03 18:00:00,138,258,11,15,794,589,205,10
15379,2023-10-03 19:00:00,142,266,9,19,722,616,106,12
15380,2023-10-03 20:00:00,138,277,5,18,741,582,159,12
15381,2023-10-03 21:00:00,123,295,12,14,585,488,97,11
15382,2023-10-03 22:00:00,148,292,8,18,614,552,62,10
15383,2023-10-03 23:00:00,132,262,11,17,607,442,165,11
15384,2023-10-04 00:00:00,122,272,9,17,567,453,114,13
15385,2023-10-04 01:00:00,122,278,14,16,537,376,161,13
15386,2023-10-04 02:00:00,134,279,10,14,681,507,174,9
15387,2023-10-04 03:00:00,144,256,5,12,586,435,151,11
15388,2023-10-04 04:00:00,127,298,10,11,672,483,189,14
15389,2023-10-04 05:00:00,132,259,6,16,742,555,187,11
15390,2023-10-04 06:00:00,144,257,5,19,751,563,188,9
15391,2023-10-04 07:00:00,135,277,13,19,693,517,176,14
15392,2023-10-04 08:00:00,148,276,12,13,608,514,94,9
15393,2023-10-04 09:00:00,122,299,9,19,532,457,75,6
15394,2023-10-04 10:00:00,122,291,6,19,639,569,70,14
15395,2023-10-04 11:00:00,123,287,8,12,678,512,166,10
15396,2023-10-04 12:00:00,142,289,12,16,654,496,158,10
15397,2023-10-04 13:00:00,142,285,14,16,594,532,62,12
15398,2023-10-04 14:00:00,135,298,13,12,784,683,101,11
15399,2023-10-04 15:00:00,136,283,12,15,635,565,70,13
15400,2023-10-04 16:00:00,125,280,6,12,713,545,168,9
15401,2023-10-04 17:00:00,124,267,13,14,751,568,183,5
15402,2023-10-04 18:00:00,148,279,7,10,626,478,148,8
15403,2023-10-04 19:00:00,128,266,6,17,723,525,198,8
15404,2023-10-04 20:00:00,140,254,13,14,552,462,90,8
15405,2023-10-04 21:00:00,139,298,10,11,521,382,139,11
15406,2023-10-04 22:00:00,120,262,12,18,504,437,67,10
15407,2023-10-04 23:00:00,138,252,12,13,698,585,113,8
15408,2023-10-05 00:00:00,142,277,6,16,662,520,142,12
15409,2023-10-05 01:00:00,128,259,13,14,787,673,114,9
15410,2023-10-05 02:00:00,135,277,5,10,783,646,137,8
15411,2023-10-05 03:00:00,148,261,13,16,666,518,148,10
15412,2023-10-05 04:00:00,124,281,12,12,748,634,114,9
15413,2023-10-05 05:00:00,123,281,9,19,772,635,137,13
15414,2023-10-05 06:00:00,134,273,9,19,677,478,199,12
15415,2023-10-05 07:00:00,131,257,13,19,593,512,81,11
15416,2023-10-05 08:00:00,120,272,11,18,590,516,74,5
15417,2023-10-05 09:00:00,128,273,10,10,548,386,162,10
15418,2023-10-05 10:00:00,144,279,5,12,590,423,167,13
15419,2023-10-05 11:00:00,145,296,5,11,506,414,92,9
15420,2023-10-05 12:00:00,149,251,7,12,617,511,106,6
15421,2023-10-05 13:00:00,136,252,13,10,758,634,124,6
15422,2023-10-05 14:00:00,121,258,8,12,570,481,89,7
15423,2023-10-05 15:00:00,145,293,6,16,654,490,164,10
15424,2023-10-05 16:00:00,133,283,14,18,795,665,130,9
15425,2023-10-05 17:00:00,128,291,10,14,609,491,118,11
15426,2023-10-05 18:00:00,143,285,9,11,564,464,100,5
15427,2023-10-05 19:00:00,130,283,9,18,702,534,168,6
15428,2023-10-05 20:00:00,133,299,14,12,556,418,138,7
15429,2023-10-05 21:00:00,135,255,10,17,656,586,70,12
15430,2023-10-05 22:00:00,144,254,6,16,688,570,118,8
15431,2023-10-05 23:00:00,121,259,12,10,728,596,132,8
15432,2023-10-06 00:00:00,148,278,13,13,774,646,128,6
15433,2023-10-06 01:00:00,147,270,13,14,533,451,82,9
15434,2023-10-06 02:00:00,141,278,10,15,551,462,89,10
15435,2023-10-06 03:00:00,141,258,12,14,645,566,79,11
15436,2023-10-06 04:00:00,147,287,10,17,544,470,74,9
15437,2023-10-06 05:00:00,143,276,9,12,516,391,125,6
15438,2023-10-06 06:00:00,136,250,12,13,514,360,154,12
15439,2023-10-06 07:00:00,138,261,6,17,550,463,87,5
15440,2023-10-06 08:00:00,121,253,9,12,588,493,95,8
15441,2023-10-06 09:00:00,123,269,13,14,509,445,64,12
15442,2023-10-06 10:00:00,149,298,9,19,686,582,104,10
15443,2023-10-06 11:00:00,146,292,10,11,647,575,72,9
15444,2023-10-06 12:00:00,136,291,6,13,531,474,57,5
15445,2023-10-06 13:00:00,136,257,12,10,622,444,178,10
15446,2023-10-06 14:00:00,149,297,13,16,531,469,62,12
15447,2023-10-06 15:00:00,148,294,12,14,519,375,144,6
15448,2023-10-06 16:00:00,138,268,9,18,529,427,102,8
15449,2023-10-06 17:00:00,143,268,8,18,653,529,124,9
15450,2023-10-06 18:00:00,122,265,7,12,753,652,101,13
15451,2023-10-06 19:00:00,131,258,14,10,523,379,144,12
15452,2023-10-06 20:00:00,145,260,6,18,678,494,184,14
15453,2023-10-06 21:00:00,123,262,11,13,768,619,149,9
15454,2023-10-06 22:00:00,129,287,12,14,737,621,116,14
15455,2023-10-06 23:00:00,136,261,12,15,589,481,108,13
15456,2023-10-07 00:00:00,139,275,12,12,619,510,109,9
15457,2023-10-07 01:00:00,144,281,11,11,504,439,65,9
15458,2023-10-07 02:00:00,140,278,8,11,691,615,76,9
15459,2023-10-07 03:00:00,127,254,12,12,703,535,168,5
15460,2023-10-07 04:00:00,147,291,11,18,764,535,229,11
15461,2023-10-07 05:00:00,135,254,7,10,552,449,103,13
15462,2023-10-07 06:00:00,129,266,13,11,765,549,216,13
15463,2023-10-07 07:00:00,141,276,8,15,573,512,61,11
15464,2023-10-07 08:00:00,148,270,8,12,501,396,105,10
15465,2023-10-07 09:00:00,130,273,9,11,744,625,119,9
15466,2023-10-07 10:00:00,141,263,6,14,564,473,91,13
15467,2023-10-07 11:00:00,128,262,8,16,588,497,91,11
15468,2023-10-07 12:00:00,135,277,14,14,559,467,92,12
15469,2023-10-07 13:00:00,138,275,8,11,585,430,155,12
15470,2023-10-07 14:00:00,149,269,9,17,613,454,159,12
15471,2023-10-07 15:00:00,146,278,9,16,739,556,183,9
15472,2023-10-07 16:00:00,149,267,9,19,549,441,108,8
15473,2023-10-07 17:00:00,141,266,9,17,673,505,168,8
15474,2023-10-07 18:00:00,138,288,7,18,577,484,93,11
15475,2023-10-07 19:00:00,124,251,13,19,697,627,70,10
15476,2023-10-07 20:00:00,123,282,6,17,554,489,65,11
15477,2023-10-07 21:00:00,138,279,6,19,730,576,154,11
15478,2023-10-07 22:00:00,143,275,6,18,775,576,199,6
15479,2023-10-07 23:00:00,129,279,14,11,520,381,139,11
15480,2023-10-08 00:00:00,137,292,9,19,728,546,182,12
15481,2023-10-08 01:00:00,143,281,14,12,536,425,111,14
15482,2023-10-08 02:00:00,124,277,5,12,578,471,107,5
15483,2023-10-08 03:00:00,146,269,13,15,566,484,82,10
15484,2023-10-08 04:00:00,144,278,8,16,569,499,70,12
15485,2023-10-08 05:00:00,122,275,12,16,684,571,113,8
15486,2023-10-08 06:00:00,140,282,9,13,721,637,84,5
15487,2023-10-08 07:00:00,123,261,6,15,536,435,101,6
15488,2023-10-08 08:00:00,138,270,9,13,530,453,77,11
15489,2023-10-08 09:00:00,132,292,9,12,578,425,153,8
15490,2023-10-08 10:00:00,148,292,9,16,540,451,89,10
15491,2023-10-08 11:00:00,148,293,6,18,608,508,100,14
15492,2023-10-08 12:00:00,139,261,6,17,735,571,164,14
15493,2023-10-08 13:00:00,141,282,13,10,648,541,107,14
15494,2023-10-08 14:00:00,131,276,11,11,790,578,212,14
15495,2023-10-08 15:00:00,135,298,5,16,513,406,107,12
15496,2023-10-08 16:00:00,139,294,13,14,726,596,130,13
15497,2023-10-08 17:00:00,127,295,14,10,651,472,179,6
15498,2023-10-08 18:00:00,123,291,12,19,567,438,129,9
15499,2023-10-08 19:00:00,125,279,10,11,732,542,190,6
15500,2023-10-08 20:00:00,139,271,10,13,788,600,188,11
15501,2023-10-08 21:00:00,131,296,5,17,617,544,73,14
15502,2023-10-08 22:00:00,144,253,10,18,778,616,162,9
15503,2023-10-08 23:00:00,128,270,7,13,613,442,171,12
15504,2023-10-09 00:00:00,141,296,5,13,782,689,93,7
15505,2023-10-09 01:00:00,121,287,11,14,505,367,138,6
15506,2023-10-09 02:00:00,140,264,10,10,730,578,152,6
15507,2023-10-09 03:00:00,134,292,7,19,590,451,139,7
15508,2023-10-09 04:00:00,132,282,8,14,554,404,150,13
15509,2023-10-09 05:00:00,132,280,7,16,725,567,158,7
15510,2023-10-09 06:00:00,130,258,12,12,677,597,80,9
15511,2023-10-09 07:00:00,140,263,7,10,591,501,90,6
15512,2023-10-09 08:00:00,133,262,13,14,539,456,83,12
15513,2023-10-09 09:00:00,146,250,11,12,661,593,68,11
15514,2023-10-09 10:00:00,132,299,13,16,623,457,166,8
15515,2023-10-09 11:00:00,120,291,14,11,503,444,59,6
15516,2023-10-09 12:00:00,131,272,13,12,596,475,121,8
15517,2023-10-09 13:00:00,143,278,11,11,769,662,107,12
15518,2023-10-09 14:00:00,135,269,7,16,791,585,206,10
15519,2023-10-09 15:00:00,128,260,8,10,735,554,181,12
15520,2023-10-09 16:00:00,143,289,6,12,729,553,176,8
15521,2023-10-09 17:00:00,140,264,13,14,772,650,122,11
15522,2023-10-09 18:00:00,142,288,6,15,701,532,169,10
15523,2023-10-09 19:00:00,134,278,7,13,651,574,77,12
15524,2023-10-09 20:00:00,137,270,7,11,722,610,112,9
15525,2023-10-09 21:00:00,142,273,10,16,661,563,98,12
15526,2023-10-09 22:00:00,130,257,6,16,634,505,129,6
15527,2023-10-09 23:00:00,120,266,7,18,540,437,103,12
15528,2023-10-10 00:00:00,124,254,10,11,707,566,141,14
15529,2023-10-10 01:00:00,131,287,14,15,619,488,131,7
15530,2023-10-10 02:00:00,135,278,12,10,624,541,83,12
15531,2023-10-10 03:00:00,134,282,5,19,537,473,64,7
15532,2023-10-10 04:00:00,146,256,5,15,539,415,124,12
15533,2023-10-10 05:00:00,139,278,9,12,566,508,58,7
15534,2023-10-10 06:00:00,142,281,8,12,679,574,105,6
15535,2023-10-10 07:00:00,123,257,8,14,504,434,70,5
15536,2023-10-10 08:00:00,122,299,7,13,660,552,108,9
15537,2023-10-10 09:00:00,143,261,10,14,698,560,138,9
15538,2023-10-10 10:00:00,124,271,9,11,554,424,130,12
15539,2023-10-10 11:00:00,128,273,13,10,706,585,121,12
15540,2023-10-10 12:00:00,141,296,6,14,525,413,112,13
15541,2023-10-10 13:00:00,120,296,11,11,522,419,103,9
15542,2023-10-10 14:00:00,120,294,7,19,521,467,54,11
15543,2023-10-10 15:00:00,128,271,13,14,602,487,115,8
15544,2023-10-10 16:00:00,130,290,13,12,708,532,176,11
15545,2023-10-10 17:00:00,140,299,11,18,742,644,98,13
15546,2023-10-10 18:00:00,138,295,5,15,691,533,158,13
15547,2023-10-10 19:00:00,131,275,8,18,754,643,111,14
15548,2023-10-10 20:00:00,144,298,14,17,592,470,122,9
15549,2023-10-10 21:00:00,144,250,11,14,698,587,111,7
15550,2023-10-10 22:00:00,148,298,14,17,597,440,157,13
15551,2023-10-10 23:00:00,125,284,8,10,736,619,117,12
15552,2023-10-11 00:00:00,137,290,12,14,552,490,62,7
15553,2023-10-11 01:00:00,130,280,13,14,698,618,80,14
15554,2023-10-11 02:00:00,140,292,14,16,685,518,167,6
15555,2023-10-11 03:00:00,129,297,10,11,746,594,152,13
15556,2023-10-11 04:00:00,131,269,11,13,664,511,153,13
15557,2023-10-11 05:00:00,134,268,9,15,719,557,162,9
15558,2023-10-11 06:00:00,133,276,8,10,675,541,134,11
15559,2023-10-11 07:00:00,140,282,10,10,504,401,103,6
15560,2023-10-11 08:00:00,128,275,11,13,779,685,94,12
15561,2023-10-11 09:00:00,120,292,10,19,650,524,126,10
15562,2023-10-11 10:00:00,140,291,7,16,726,552,174,13
15563,2023-10-11 11:00:00,140,260,13,13,503,380,123,12
15564,2023-10-11 12:00:00,148,257,5,11,661,549,112,12
15565,2023-10-11 13:00:00,133,293,11,19,713,553,160,13
15566,2023-10-11 14:00:00,134,250,7,13,541,452,89,9
15567,2023-10-11 15:00:00,143,271,5,10,632,481,151,8
15568,2023-10-11 16:00:00,135,269,12,18,614,471,143,10
15569,2023-10-11 17:00:00,122,274,14,11,638,502,136,8
15570,2023-10-11 18:00:00,127,273,13,14,789,676,113,13
15571,2023-10-11 19:00:00,123,266,6,19,631,464,167,8
15572,2023-10-11 20:00:00,142,264,6,14,776,640,136,7
15573,2023-10-11 21:00:00,146,294,9,18,626,520,106,14
15574,2023-10-11 22:00:00,147,277,10,13,639,489,150,11
15575,2023-10-11 23:00:00,136,260,8,17,675,535,140,7
15576,2023-10-12 00:00:00,134,256,8,19,505,426,79,9
15577,2023-10-12 01:00:00,147,255,6,11,663,515,148,12
15578,2023-10-12 02:00:00,139,283,7,19,635,474,161,5
15579,2023-10-12 03:00:00,120,255,7,17,605,507,98,11
15580,2023-10-12 04:00:00,132,251,11,16,720,601,119,7
15581,2023-10-12 05:00:00,136,285,14,12,522,397,125,11
15582,2023-10-12 06:00:00,124,271,10,10,705,566,139,7
15583,2023-10-12 07:00:00,124,258,12,14,620,508,112,12
15584,2023-10-12 08:00:00,132,257,10,16,616,477,139,14
15585,2023-10-12 09:00:00,148,271,6,16,715,605,110,11
15586,2023-10-12 10:00:00,133,282,10,17,523,421,102,11
15587,2023-10-12 11:00:00,148,263,7,11,691,617,74,7
15588,2023-10-12 12:00:00,122,252,5,13,607,444,163,6
15589,2023-10-12 13:00:00,145,258,14,14,601,440,161,11
15590,2023-10-12 14:00:00,125,288,14,14,666,551,115,9
15591,2023-10-12 15:00:00,133,257,11,14,723,627,96,10
15592,2023-10-12 16:00:00,139,262,9,16,552,411,141,14
15593,2023-10-12 17:00:00,120,260,5,12,525,443,82,13
15594,2023-10-12 18:00:00,122,261,11,13,557,501,56,7
15595,2023-10-12 19:00:00,139,288,9,19,632,484,148,11
15596,2023-10-12 20:00:00,146,288,9,17,775,613,162,13
15597,2023-10-12 21:00:00,144,268,12,10,765,679,86,13
15598,2023-10-12 22:00:00,139,263,14,10,596,516,80,9
15599,2023-10-12 23:00:00,125,282,13,15,783,672,111,10
15600,2023-10-13 00:00:00,145,261,5,17,526,426,100,10
15601,2023-10-13 01:00:00,147,297,14,13,701,595,106,5
15602,2023-10-13 02:00:00,139,282,11,10,559,417,142,10
15603,2023-10-13 03:00:00,127,269,7,17,776,597,179,11
15604,2023-10-13 04:00:00,132,285,14,12,778,685,93,10
15605,2023-10-13 05:00:00,145,281,6,15,578,446,132,10
15606,2023-10-13 06:00:00,125,250,14,15,642,577,65,7
15607,2023-10-13 07:00:00,140,299,5,15,649,543,106,9
15608,2023-10-13 08:00:00,139,290,5,15,648,507,141,7
15609,2023-10-13 09:00:00,126,296,6,19,717,583,134,9
15610,2023-10-13 10:00:00,149,254,11,17,528,432,96,12
15611,2023-10-13 11:00:00,148,254,10,13,750,668,82,12
15612,2023-10-13 12:00:00,133,274,8,17,789,591,198,10
15613,2023-10-13 13:00:00,121,253,8,16,675,588,87,6
15614,2023-10-13 14:00:00,138,283,13,18,668,564,104,6
15615,2023-10-13 15:00:00,135,258,10,19,781,600,181,8
15616,2023-10-13 16:00:00,149,272,12,19,788,691,97,11
15617,2023-10-13 17:00:00,145,257,14,12,579,485,94,12
15618,2023-10-13 18:00:00,134,254,8,10,660,529,131,7
15619,2023-10-13 19:00:00,145,262,7,18,606,481,125,10
15620,2023-10-13 20:00:00,123,267,11,14,636,488,148,13
15621,2023-10-13 21:00:00,148,284,9,15,600,532,68,7
15622,2023-10-13 22:00:00,146,258,12,10,693,540,153,7
15623,2023-10-13 23:00:00,139,257,12,10,559,497,62,14
15624,2023-10-14 00:00:00,140,283,5,19,535,377,158,11
15625,2023-10-14 01:00:00,140,277,5,17,695,620,75,14
15626,2023-10-14 02:00:00,123,265,6,16,550,406,144,5
15627,2023-10-14 03:00:00,127,299,7,18,645,479,166,10
15628,2023-10-14 04:00:00,143,275,11,12,616,462,154,14
15629,2023-10-14 05:00:00,147,264,14,10,508,427,81,5
15630,2023-10-14 06:00:00,120,290,14,11,556,459,97,12
15631,2023-10-14 07:00:00,139,285,12,13,562,399,163,14
15632,2023-10-14 08:00:00,127,286,6,14,758,561,197,5
15633,2023-10-14 09:00:00,137,261,10,19,504,389,115,13
15634,2023-10-14 10:00:00,138,289,5,11,528,389,139,12
15635,2023-10-14 11:00:00,134,267,8,16,520,466,54,6
15636,2023-10-14 12:00:00,128,263,8,16,523,376,147,6
15637,2023-10-14 13:00:00,134,299,14,11,593,427,166,13
15638,2023-10-14 14:00:00,122,278,9,10,780,623,157,8
15639,2023-10-14 15:00:00,140,261,11,13,672,578,94,5
15640,2023-10-14 16:00:00,142,274,5,19,564,446,118,11
15641,2023-10-14 17:00:00,149,273,12,19,599,504,95,13
15642,2023-10-14 18:00:00,149,267,8,10,613,529,84,6
15643,2023-10-14 19:00:00,141,260,5,19,741,635,106,14
15644,2023-10-14 20:00:00,134,257,5,16,502,392,110,9
15645,2023-10-14 21:00:00,126,293,6,18,518,378,140,10
15646,2023-10-14 22:00:00,127,251,5,19,696,550,146,10
15647,2023-10-14 23:00:00,144,260,14,18,540,459,81,10
15648,2023-10-15 00:00:00,123,250,7,19,662,554,108,10
15649,2023-10-15 01:00:00,131,282,9,11,530,430,100,12
15650,2023-10-15 02:00:00,142,263,7,11,773,642,131,7
15651,2023-10-15 03:00:00,135,270,8,15,553,489,64,9
15652,2023-10-15 04:00:00,138,250,14,10,673,602,71,9
15653,2023-10-15 05:00:00,139,286,11,12,546,424,122,10
15654,2023-10-15 06:00:00,137,278,14,18,584,484,100,13
15655,2023-10-15 07:00:00,139,257,10,15,679,509,170,9
15656,2023-10-15 08:00:00,133,269,7,19,617,433,184,12
15657,2023-10-15 09:00:00,142,265,11,19,666,493,173,10
15658,2023-10-15 10:00:00,146,292,13,14,759,570,189,8
15659,2023-10-15 11:00:00,137,258,6,15,522,409,113,13
15660,2023-10-15 12:00:00,147,284,12,13,525,387,138,14
15661,2023-10-15 13:00:00,137,281,7,17,782,627,155,8
15662,2023-10-15 14:00:00,144,263,8,13,676,585,91,7
15663,2023-10-15 15:00:00,125,293,12,12,531,434,97,8
15664,2023-10-15 16:00:00,135,275,6,16,690,603,87,7
15665,2023-10-15 17:00:00,134,266,8,11,738,547,191,10
15666,2023-10-15 18:00:00,143,295,14,18,762,564,198,12
15667,2023-10-15 19:00:00,139,250,6,14,560,444,116,12
15668,2023-10-15 20:00:00,130,295,7,12,542,471,71,13
15669,2023-10-15 21:00:00,149,294,9,12,773,630,143,9
15670,2023-10-15 22:00:00,144,296,7,12,661,492,169,13
15671,2023-10-15 23:00:00,122,280,9,14,679,598,81,14
15672,2023-10-16 00:00:00,124,271,8,18,715,562,153,13
15673,2023-10-16 01:00:00,138,280,9,15,734,588,146,7
15674,2023-10-16 02:00:00,130,274,8,16,733,654,79,13
15675,2023-10-16 03:00:00,137,250,9,15,554,494,60,13
15676,2023-10-16 04:00:00,123,295,10,18,589,495,94,13
15677,2023-10-16 05:00:00,138,271,8,19,501,411,90,10
15678,2023-10-16 06:00:00,134,254,14,17,796,652,144,5
15679,2023-10-16 07:00:00,128,271,14,19,541,420,121,9
15680,2023-10-16 08:00:00,125,254,12,16,771,566,205,13
15681,2023-10-16 09:00:00,145,283,5,13,625,466,159,8
15682,2023-10-16 10:00:00,124,286,5,13,691,503,188,5
15683,2023-10-16 11:00:00,134,289,11,10,703,511,192,9
15684,2023-10-16 12:00:00,147,290,5,19,527,411,116,14
15685,2023-10-16 13:00:00,142,280,5,13,542,460,82,14
15686,2023-10-16 14:00:00,138,253,12,14,501,389,112,10
15687,2023-10-16 15:00:00,146,270,14,14,794,655,139,12
15688,2023-10-16 16:00:00,137,278,9,13,530,458,72,8
15689,2023-10-16 17:00:00,127,276,13,11,733,533,200,5
15690,2023-10-16 18:00:00,134,272,6,14,583,494,89,9
15691,2023-10-16 19:00:00,143,270,13,13,787,675,112,7
15692,2023-10-16 20:00:00,144,267,6,10,572,427,145,9
15693,2023-10-16 21:00:00,121,290,6,16,637,529,108,6
15694,2023-10-16 22:00:00,143,282,5,14,634,506,128,13
15695,2023-10-16 23:00:00,127,293,14,13,608,509,99,9
15696,2023-10-17 00:00:00,138,297,13,16,518,377,141,13
15697,2023-10-17 01:00:00,137,254,5,19,645,506,139,13
15698,2023-10-17 02:00:00,127,263,5,17,566,415,151,8
15699,2023-10-17 03:00:00,124,259,13,16,762,612,150,11
15700,2023-10-17 04:00:00,139,255,8,19,577,498,79,11
15701,2023-10-17 05:00:00,139,271,12,12,750,638,112,5
15702,2023-10-17 06:00:00,146,286,13,13,796,590,206,6
15703,2023-10-17 07:00:00,133,291,12,17,797,669,128,7
15704,2023-10-17 08:00:00,138,288,14,14,559,444,115,11
15705,2023-10-17 09:00:00,130,268,6,18,734,623,111,11
15706,2023-10-17 10:00:00,145,293,7,13,573,434,139,8
15707,2023-10-17 11:00:00,131,260,11,18,507,382,125,14
15708,2023-10-17 12:00:00,120,283,9,19,766,675,91,13
15709,2023-10-17 13:00:00,123,266,9,16,675,532,143,11
15710,2023-10-17 14:00:00,124,282,6,11,525,367,158,7
15711,2023-10-17 15:00:00,128,281,11,10,600,492,108,11
15712,2023-10-17 16:00:00,131,294,7,13,722,617,105,12
15713,2023-10-17 17:00:00,131,288,7,17,683,570,113,9
15714,2023-10-17 18:00:00,132,287,7,17,702,577,125,10
15715,2023-10-17 19:00:00,128,263,12,11,683,558,125,10
15716,2023-10-17 20:00:00,132,263,13,17,599,529,70,12
15717,2023-10-17 21:00:00,141,293,14,11,673,484,189,11
15718,2023-10-17 22:00:00,138,278,13,11,548,488,60,6
15719,2023-10-17 23:00:00,123,285,12,18,539,467,72,7
15720,2023-10-18 00:00:00,139,288,7,15,549,472,77,7
15721,2023-10-18 01:00:00,124,263,9,11,665,526,139,13
15722,2023-10-18 02:00:00,135,289,6,12,521,408,113,12
15723,2023-10-18 03:00:00,141,259,13,18,545,439,106,7
15724,2023-10-18 04:00:00,123,298,14,17,587,504,83,7
15725,2023-10-18 05:00:00,135,293,11,14,736,536,200,9
15726,2023-10-18 06:00:00,142,277,11,13,713,506,207,8
15727,2023-10-18 07:00:00,120,258,10,19,685,502,183,9
15728,2023-10-18 08:00:00,128,274,13,19,522,417,105,9
15729,2023-10-18 09:00:00,137,266,11,16,757,575,182,12
15730,2023-10-18 10:00:00,140,279,7,18,795,557,238,7
15731,2023-10-18 11:00:00,143,255,13,12,665,574,91,10
15732,2023-10-18 12:00:00,141,282,8,11,619,443,176,7
15733,2023-10-18 13:00:00,143,254,13,12,719,530,189,9
15734,2023-10-18 14:00:00,141,296,5,10,761,614,147,10
15735,2023-10-18 15:00:00,122,260,10,12,632,543,89,13
15736,2023-10-18 16:00:00,131,262,8,10,570,453,117,13
15737,2023-10-18 17:00:00,141,251,6,17,617,510,107,13
15738,2023-10-18 18:00:00,139,267,5,15,618,534,84,8
15739,2023-10-18 19:00:00,123,273,14,10,632,505,127,11
15740,2023-10-18 20:00:00,123,287,12,19,511,420,91,5
15741,2023-10-18 21:00:00,149,290,14,18,788,695,93,12
15742,2023-10-18 22:00:00,137,286,11,11,574,426,148,10
15743,2023-10-18 23:00:00,127,253,10,12,701,579,122,9
15744,2023-10-19 00:00:00,147,253,6,11,605,510,95,5
15745,2023-10-19 01:00:00,134,295,9,12,627,552,75,5
15746,2023-10-19 02:00:00,130,260,6,14,741,549,192,13
15747,2023-10-19 03:00:00,132,267,12,17,780,659,121,5
15748,2023-10-19 04:00:00,133,297,10,16,707,524,183,7
15749,2023-10-19 05:00:00,149,251,6,16,502,362,140,7
15750,2023-10-19 06:00:00,148,292,13,17,763,573,190,8
15751,2023-10-19 07:00:00,140,285,14,16,673,547,126,14
15752,2023-10-19 08:00:00,136,289,13,16,607,467,140,7
15753,2023-10-19 09:00:00,131,265,6,13,685,599,86,13
15754,2023-10-19 10:00:00,145,285,12,12,695,584,111,8
15755,2023-10-19 11:00:00,143,266,9,10,614,499,115,14
15756,2023-10-19 12:00:00,149,269,13,12,585,431,154,8
15757,2023-10-19 13:00:00,139,283,7,17,747,649,98,7
15758,2023-10-19 14:00:00,146,250,5,18,724,626,98,7
15759,2023-10-19 15:00:00,142,289,9,10,590,476,114,10
15760,2023-10-19 16:00:00,125,267,10,14,632,477,155,12
15761,2023-10-19 17:00:00,135,294,11,18,627,447,180,14
15762,2023-10-19 18:00:00,141,282,10,17,761,683,78,11
15763,2023-10-19 19:00:00,129,251,6,13,739,648,91,13
15764,2023-10-19 20:00:00,146,262,9,14,799,622,177,13
15765,2023-10-19 21:00:00,138,259,7,14,732,574,158,9
15766,2023-10-19 22:00:00,124,279,9,11,599,447,152,7
15767,2023-10-19 23:00:00,141,296,9,17,626,547,79,9
15768,2023-10-20 00:00:00,133,259,7,13,552,413,139,11
15769,2023-10-20 01:00:00,131,277,14,14,773,552,221,11
15770,2023-10-20 02:00:00,142,255,14,13,632,501,131,6
15771,2023-10-20 03:00:00,133,270,9,16,512,436,76,8
15772,2023-10-20 04:00:00,126,275,7,19,535,463,72,7
15773,2023-10-20 05:00:00,141,253,8,10,710,555,155,12
15774,2023-10-20 06:00:00,123,285,10,12,797,600,197,10
15775,2023-10-20 07:00:00,141,258,12,10,690,570,120,8
15776,2023-10-20 08:00:00,140,262,5,17,533,457,76,6
15777,2023-10-20 09:00:00,133,276,14,19,514,414,100,8
15778,2023-10-20 10:00:00,130,292,5,18,585,514,71,14
15779,2023-10-20 11:00:00,138,273,13,10,703,620,83,5
15780,2023-10-20 12:00:00,134,284,9,12,792,578,214,6
15781,2023-10-20 13:00:00,133,290,13,19,796,630,166,6
15782,2023-10-20 14:00:00,125,265,7,18,745,632,113,5
15783,2023-10-20 15:00:00,149,250,7,16,607,531,76,14
15784,2023-10-20 16:00:00,133,281,11,15,699,548,151,13
15785,2023-10-20 17:00:00,143,259,13,18,671,521,150,12
15786,2023-10-20 18:00:00,121,250,8,13,734,531,203,14
15787,2023-10-20 19:00:00,149,261,10,16,561,429,132,7
15788,2023-10-20 20:00:00,144,265,7,17,766,577,189,5
15789,2023-10-20 21:00:00,137,289,11,14,536,430,106,6
15790,2023-10-20 22:00:00,137,264,11,17,519,451,68,14
15791,2023-10-20 23:00:00,124,261,13,10,504,411,93,10
15792,2023-10-21 00:00:00,133,277,7,13,768,604,164,6
15793,2023-10-21 01:00:00,146,298,8,12,587,460,127,9
15794,2023-10-21 02:00:00,138,295,10,17,505,409,96,14
15795,2023-10-21 03:00:00,138,255,11,15,798,700,98,8
15796,2023-10-21 04:00:00,139,254,6,17,595,530,65,7
15797,2023-10-21 05:00:00,142,292,5,10,571,414,157,13
15798,2023-10-21 06:00:00,149,252,13,17,556,475,81,6
15799,2023-10-21 07:00:00,122,259,9,18,503,363,140,7
15800,2023-10-21 08:00:00,143,261,9,15,707,582,125,14
15801,2023-10-21 09:00:00,129,281,12,14,529,401,128,8
15802,2023-10-21 10:00:00,139,268,14,13,541,480,61,7
15803,2023-10-21 11:00:00,137,265,11,11,723,643,80,11
15804,2023-10-21 12:00:00,148,256,9,15,783,580,203,12
15805,2023-10-21 13:00:00,145,263,6,11,741,645,96,13
15806,2023-10-21 14:00:00,133,297,8,13,729,616,113,9
15807,2023-10-21 15:00:00,132,258,7,10,742,656,86,9
15808,2023-10-21 16:00:00,134,287,6,16,584,461,123,6
15809,2023-10-21 17:00:00,149,262,13,17,762,623,139,10
15810,2023-10-21 18:00:00,120,256,12,16,684,535,149,6
15811,2023-10-21 19:00:00,149,297,5,17,559,472,87,8
15812,2023-10-21 20:00:00,130,252,10,13,788,594,194,8
15813,2023-10-21 21:00:00,143,267,9,10,534,464,70,6
15814,2023-10-21 22:00:00,141,282,11,10,676,516,160,5
15815,2023-10-21 23:00:00,134,260,11,19,703,580,123,11
15816,2023-10-22 00:00:00,146,286,9,19,722,616,106,12
15817,2023-10-22 01:00:00,126,287,14,12,603,492,111,9
15818,2023-10-22 02:00:00,127,287,10,19,572,503,69,13
15819,2023-10-22 03:00:00,128,280,7,10,674,583,91,7
15820,2023-10-22 04:00:00,127,275,11,18,744,524,220,7
15821,2023-10-22 05:00:00,125,266,9,18,727,552,175,6
15822,2023-10-22 06:00:00,131,274,14,12,784,617,167,5
15823,2023-10-22 07:00:00,124,279,12,17,571,512,59,6
15824,2023-10-22 08:00:00,149,262,10,12,525,385,140,13
15825,2023-10-22 09:00:00,125,274,7,14,738,625,113,13
15826,2023-10-22 10:00:00,120,292,11,18,672,565,107,6
15827,2023-10-22 11:00:00,128,274,11,16,594,533,61,13
15828,2023-10-22 12:00:00,122,269,8,11,710,501,209,9
15829,2023-10-22 13:00:00,133,254,9,19,556,424,132,14
15830,2023-10-22 14:00:00,123,250,6,14,674,484,190,7
15831,2023-10-22 15:00:00,131,277,10,17,750,603,147,14
15832,2023-10-22 16:00:00,129,258,9,14,780,641,139,8
15833,2023-10-22 17:00:00,126,295,7,18,650,550,100,6
15834,2023-10-22 18:00:00,146,266,12,19,737,660,77,6
15835,2023-10-22 19:00:00,145,251,7,12,616,491,125,7
15836,2023-10-22 20:00:00,127,277,13,11,556,400,156,6
15837,2023-10-22 21:00:00,143,281,5,16,753,666,87,10
15838,2023-10-22 22:00:00,130,251,5,11,728,511,217,11
15839,2023-10-22 23:00:00,135,266,6,15,630,484,146,12
15840,2023-10-23 00:00:00,136,272,8,13,665,544,121,5
15841,2023-10-23 01:00:00,144,253,13,16,589,513,76,7
15842,2023-10-23 02:00:00,125,278,12,18,555,393,162,6
15843,2023-10-23 03:00:00,126,261,14,10,563,502,61,13
15844,2023-10-23 04:00:00,138,252,7,18,749,524,225,9
15845,2023-10-23 05:00:00,139,259,13,17,587,438,149,5
15846,2023-10-23 06:00:00,125,295,13,18,746,608,138,6
15847,2023-10-23 07:00:00,135,252,12,13,698,539,159,11
15848,2023-10-23 08:00:00,146,279,8,10,788,699,89,6
15849,2023-10-23 09:00:00,128,297,11,14,651,568,83,7
15850,2023-10-23 10:00:00,125,287,14,12,706,600,106,7
15851,2023-10-23 11:00:00,132,258,11,10,784,615,169,5
15852,2023-10-23 12:00:00,126,285,8,15,613,501,112,7
15853,2023-10-23 13:00:00,146,256,8,10,749,626,123,11
15854,2023-10-23 14:00:00,124,260,5,11,635,447,188,5
15855,2023-10-23 15:00:00,146,263,9,18,522,369,153,11
15856,2023-10-23 16:00:00,135,281,14,18,750,552,198,13
15857,2023-10-23 17:00:00,136,258,5,11,590,444,146,14
15858,2023-10-23 18:00:00,133,294,10,13,725,555,170,6
15859,2023-10-23 19:00:00,126,289,7,14,544,420,124,11
15860,2023-10-23 20:00:00,126,257,12,19,621,551,70,5
15861,2023-10-23 21:00:00,120,278,6,11,754,623,131,7
15862,2023-10-23 22:00:00,125,270,8,17,679,530,149,11
15863,2023-10-23 23:00:00,143,275,10,14,574,484,90,7
15864,2023-10-24 00:00:00,137,285,9,11,722,528,194,8
15865,2023-10-24 01:00:00,139,259,14,18,508,422,86,12
15866,2023-10-24 02:00:00,144,259,12,19,684,608,76,5
15867,2023-10-24 03:00:00,144,295,5,12,531,387,144,13
15868,2023-10-24 04:00:00,135,267,11,10,578,411,167,5
15869,2023-10-24 05:00:00,125,299,10,12,660,574,86,9
15870,2023-10-24 06:00:00,136,253,10,11,702,623,79,8
15871,2023-10-24 07:00:00,129,287,5,17,792,698,94,14
15872,2023-10-24 08:00:00,137,269,7,15,679,571,108,12
15873,2023-10-24 09:00:00,127,267,12,11,640,493,147,10
15874,2023-10-24 10:00:00,144,256,5,16,547,429,118,11
15875,2023-10-24 11:00:00,144,269,12,16,784,560,224,12
15876,2023-10-24 12:00:00,139,267,13,10,503,423,80,9
15877,2023-10-24 13:00:00,147,258,7,18,676,491,185,11
15878,2023-10-24 14:00:00,136,292,7,16,531,437,94,14
15879,2023-10-24 15:00:00,123,255,7,11,641,546,95,10
15880,2023-10-24 16:00:00,145,267,5,19,567,430,137,5
15881,2023-10-24 17:00:00,146,268,13,10,646,559,87,5
15882,2023-10-24 18:00:00,143,253,5,17,567,478,89,7
15883,2023-10-24 19:00:00,128,295,10,17,746,654,92,14
15884,2023-10-24 20:00:00,134,261,8,19,730,646,84,14
15885,2023-10-24 21:00:00,136,297,11,10,755,553,202,14
15886,2023-10-24 22:00:00,131,290,6,16,734,611,123,8
15887,2023-10-24 23:00:00,133,298,6,19,789,649,140,6
15888,2023-10-25 00:00:00,120,272,6,16,543,433,110,13
15889,2023-10-25 01:00:00,121,264,7,14,696,578,118,10
15890,2023-10-25 02:00:00,145,259,14,10,582,486,96,8
15891,2023-10-25 03:00:00,120,277,8,15,790,558,232,12
15892,2023-10-25 04:00:00,123,297,6,14,780,678,102,12
15893,2023-10-25 05:00:00,137,292,9,17,708,618,90,11
15894,2023-10-25 06:00:00,125,272,12,15,728,598,130,8
15895,2023-10-25 07:00:00,143,295,9,11,650,553,97,11
15896,2023-10-25 08:00:00,121,261,6,19,649,509,140,12
15897,2023-10-25 09:00:00,144,281,11,17,714,580,134,8
15898,2023-10-25 10:00:00,142,297,9,13,684,542,142,9
15899,2023-10-25 11:00:00,139,269,11,12,554,438,116,10
15900,2023-10-25 12:00:00,130,274,14,16,706,508,198,14
15901,2023-10-25 13:00:00,127,299,14,11,518,414,104,9
15902,2023-10-25 14:00:00,132,290,11,16,790,695,95,9
15903,2023-10-25 15:00:00,146,275,12,12,673,580,93,6
15904,2023-10-25 16:00:00,144,287,10,12,521,457,64,12
15905,2023-10-25 17:00:00,131,271,8,18,740,644,96,14
15906,2023-10-25 18:00:00,146,259,9,17,561,442,119,9
15907,2023-10-25 19:00:00,135,288,9,15,605,542,63,11
15908,2023-10-25 20:00:00,128,264,9,11,500,366,134,11
15909,2023-10-25 21:00:00,126,295,12,12,534,413,121,14
15910,2023-10-25 22:00:00,149,258,10,17,660,563,97,12
15911,2023-10-25 23:00:00,121,280,9,10,739,651,88,10
15912,2023-10-26 00:00:00,138,283,11,11,608,500,108,11
15913,2023-10-26 01:00:00,123,257,5,15,622,444,178,10
15914,2023-10-26 02:00:00,139,279,14,17,526,380,146,6
15915,2023-10-26 03:00:00,146,281,7,13,582,509,73,8
15916,2023-10-26 04:00:00,122,273,13,14,717,564,153,12
15917,2023-10-26 05:00:00,149,277,7,13,541,481,60,11
15918,2023-10-26 06:00:00,131,262,11,12,745,584,161,5
15919,2023-10-26 07:00:00,126,298,8,13,526,381,145,14
15920,2023-10-26 08:00:00,125,278,12,19,537,473,64,12
15921,2023-10-26 09:00:00,143,257,12,19,507,422,85,6
15922,2023-10-26 10:00:00,129,259,10,16,639,496,143,10
15923,2023-10-26 11:00:00,137,293,7,18,603,507,96,13
15924,2023-10-26 12:00:00,148,282,11,17,524,411,113,10
15925,2023-10-26 13:00:00,126,299,8,18,514,422,92,8
15926,2023-10-26 14:00:00,129,299,9,11,545,435,110,12
15927,2023-10-26 15:00:00,149,262,8,12,554,487,67,14
15928,2023-10-26 16:00:00,140,284,10,18,723,544,179,5
15929,2023-10-26 17:00:00,148,285,12,18,636,505,131,10
15930,2023-10-26 18:00:00,131,275,8,12,551,480,71,7
15931,2023-10-26 19:00:00,122,262,9,19,557,431,126,7
15932,2023-10-26 20:00:00,129,266,9,15,715,633,82,6
15933,2023-10-26 21:00:00,132,287,5,15,760,646,114,5
15934,2023-10-26 22:00:00,144,253,13,12,697,566,131,12
15935,2023-10-26 23:00:00,121,263,7,12,624,534,90,10
15936,2023-10-27 00:00:00,131,278,8,10,776,639,137,6
15937,2023-10-27 01:00:00,132,296,7,19,668,545,123,14
15938,2023-10-27 02:00:00,142,290,13,15,563,468,95,14
15939,2023-10-27 03:00:00,126,253,5,19,571,508,63,8
15940,2023-10-27 04:00:00,136,254,8,18,663,570,93,10
15941,2023-10-27 05:00:00,126,268,12,15,772,663,109,12
15942,2023-10-27 06:00:00,139,295,9,13,712,528,184,6
15943,2023-10-27 07:00:00,141,264,11,10,734,653,81,12
15944,2023-10-27 08:00:00,130,271,12,19,661,463,198,7
15945,2023-10-27 09:00:00,145,266,14,14,669,578,91,11
15946,2023-10-27 10:00:00,144,286,6,14,666,533,133,5
15947,2023-10-27 11:00:00,125,282,9,16,626,506,120,5
15948,2023-10-27 12:00:00,133,251,6,15,667,524,143,9
15949,2023-10-27 13:00:00,142,252,8,14,600,462,138,6
15950,2023-10-27 14:00:00,124,292,7,13,619,494,125,6
15951,2023-10-27 15:00:00,147,264,13,19,706,622,84,8
15952,2023-10-27 16:00:00,140,274,7,10,695,553,142,8
15953,2023-10-27 17:00:00,125,292,9,12,625,473,152,12
15954,2023-10-27 18:00:00,132,256,11,12,506,418,88,5
15955,2023-10-27 19:00:00,140,260,11,11,714,608,106,7
15956,2023-10-27 20:00:00,138,251,11,15,798,637,161,11
15957,2023-10-27 21:00:00,122,250,11,18,566,455,111,6
15958,2023-10-27 22:00:00,127,264,8,11,745,603,142,8
15959,2023-10-27 23:00:00,132,292,10,15,628,541,87,10
15960,2023-10-28 00:00:00,142,257,12,12,596,526,70,10
15961,2023-10-28 01:00:00,143,270,14,14,792,599,193,5
15962,2023-10-28 02:00:00,125,256,6,10,744,627,117,11
15963,2023-10-28 03:00:00,130,297,6,19,652,569,83,8
15964,2023-10-28 04:00:00,133,261,8,14,514,419,95,9
15965,2023-10-28 05:00:00,144,268,10,13,696,594,102,14
15966,2023-10-28 06:00:00,125,295,14,14,531,433,98,8
15967,2023-10-28 07:00:00,121,297,11,12,609,464,145,5
15968,2023-10-28 08:00:00,126,255,6,19,524,432,92,5
15969,2023-10-28 09:00:00,132,276,14,11,602,431,171,11
15970,2023-10-28 10:00:00,138,283,9,19,756,657,99,11
15971,2023-10-28 11:00:00,120,252,11,19,608,446,162,13
15972,2023-10-28 12:00:00,141,253,14,14,776,545,231,13
15973,2023-10-28 13:00:00,137,255,6,12,581,455,126,9
15974,2023-10-28 14:00:00,143,283,6,17,663,475,188,11
15975,2023-10-28 15:00:00,120,261,12,14,597,462,135,5
15976,2023-10-28 16:00:00,143,259,10,19,562,490,72,8
15977,2023-10-28 17:00:00,131,274,11,15,729,595,134,5
15978,2023-10-28 18:00:00,148,295,5,15,734,620,114,7
15979,2023-10-28 19:00:00,138,250,6,16,733,650,83,14
15980,2023-10-28 20:00:00,129,254,8,10,624,511,113,11
15981,2023-10-28 21:00:00,131,288,11,10,670,514,156,5
15982,2023-10-28 22:00:00,129,250,7,15,533,379,154,11
15983,2023-10-28 23:00:00,126,262,8,16,520,418,102,14
15984,2023-10-29 00:00:00,130,264,10,13,540,465,75,14
15985,2023-10-29 01:00:00,141,276,7,17,565,419,146,13
15986,2023-10-29 02:00:00,146,292,12,12,730,553,177,8
15987,2023-10-29 03:00:00,124,253,8,15,626,527,99,9
15988,2023-10-29 04:00:00,142,285,10,11,704,556,148,11
15989,2023-10-29 05:00:00,130,284,5,17,696,488,208,10
15990,2023-10-29 06:00:00,140,252,14,16,680,512,168,5
15991,2023-10-29 07:00:00,127,291,13,18,726,646,80,7
15992,2023-10-29 08:00:00,148,253,12,14,749,607,142,6
15993,2023-10-29 09:00:00,128,287,11,13,631,537,94,8
15994,2023-10-29 10:00:00,126,278,7,12,641,517,124,13
15995,2023-10-29 11:00:00,141,270,13,16,586,439,147,12
15996,2023-10-29 12:00:00,138,287,10,13,517,456,61,8
15997,2023-10-29 13:00:00,121,288,10,17,713,510,203,11
15998,2023-10-29 14:00:00,125,270,10,18,636,470,166,8
15999,2023-10-29 15:00:00,137,268,9,17,765,580,185,13
16000,2023-10-29 16:00:00,147,295,9,13,627,538,89,8
16001,2023-10-29 17:00:00,127,278,10,11,640,482,158,10
16002,2023-10-29 18:00:00,146,276,7,18,634,509,125,11
16003,2023-10-29 19:00:00,143,293,10,12,545,439,106,9
16004,2023-10-29 20:00:00,140,257,9,13,518,395,123,14
16005,2023-10-29 21:00:00,146,279,9,18,703,604,99,14
16006,2023-10-29 22:00:00,123,254,7,19,681,606,75,7
16007,2023-10-29 23:00:00,141,256,12,13,771,591,180,10
16008,2023-10-30 00:00:00,146,271,7,18,767,614,153,11
16009,2023-10-30 01:00:00,142,258,12,11,573,458,115,10
16010,2023-10-30 02:00:00,136,272,12,15,545,486,59,11
16011,2023-10-30 03:00:00,147,290,8,18,785,670,115,6
16012,2023-10-30 04:00:00,134,284,14,14,652,537,115,12
16013,2023-10-30 05:00:00,126,252,10,13,606,427,179,7
16014,2023-10-30 06:00:00,133,271,6,11,743,543,200,5
16015,2023-10-30 07:00:00,142,278,11,11,794,599,195,14
16016,2023-10-30 08:00:00,146,263,13,10,716,523,193,5
16017,2023-10-30 09:00:00,138,285,14,19,519,379,140,9
16018,2023-10-30 10:00:00,142,294,6,13,554,492,62,9
16019,2023-10-30 11:00:00,148,267,9,16,718,603,115,6
16020,2023-10-30 12:00:00,131,257,14,16,708,540,168,14
16021,2023-10-30 13:00:00,140,255,12,17,529,443,86,5
16022,2023-10-30 14:00:00,121,286,7,14,709,512,197,11
16023,2023-10-30 15:00:00,142,286,12,19,740,606,134,13
16024,2023-10-30 16:00:00,148,271,6,10,738,639,99,11
16025,2023-10-30 17:00:00,120,267,9,17,543,422,121,7
16026,2023-10-30 18:00:00,133,265,14,18,772,631,141,5
16027,2023-10-30 19:00:00,122,287,6,10,610,502,108,11
16028,2023-10-30 20:00:00,145,251,11,13,511,373,138,9
16029,2023-10-30 21:00:00,146,296,6,10,514,384,130,11
16030,2023-10-30 22:00:00,134,265,10,19,762,653,109,11
16031,2023-10-30 23:00:00,145,288,14,13,747,546,201,8
16032,2023-10-31 00:00:00,134,274,7,11,795,630,165,12
16033,2023-10-31 01:00:00,132,271,6,15,535,432,103,11
16034,2023-10-31 02:00:00,138,279,9,11,723,636,87,10
16035,2023-10-31 03:00:00,132,299,8,18,505,442,63,6
16036,2023-10-31 04:00:00,136,270,14,15,736,656,80,5
16037,2023-10-31 05:00:00,140,256,13,15,748,570,178,10
16038,2023-10-31 06:00:00,135,254,10,19,547,423,124,6
16039,2023-10-31 07:00:00,149,285,6,18,794,678,116,13
16040,2023-10-31 08:00:00,135,275,6,17,742,545,197,8
16041,2023-10-31 09:00:00,124,254,9,16,728,634,94,12
16042,2023-10-31 10:00:00,135,274,6,14,610,457,153,11
16043,2023-10-31 11:00:00,138,295,11,17,713,535,178,12
16044,2023-10-31 12:00:00,135,279,10,11,642,533,109,13
16045,2023-10-31 13:00:00,140,258,13,14,543,421,122,13
16046,2023-10-31 14:00:00,134,253,8,11,765,649,116,9
16047,2023-10-31 15:00:00,131,275,10,13,513,361,152,9
16048,2023-10-31 16:00:00,148,265,7,17,564,450,114,7
16049,2023-10-31 17:00:00,131,255,13,10,677,574,103,12
16050,2023-10-31 18:00:00,131,270,5,15,604,479,125,9
16051,2023-10-31 19:00:00,120,270,6,16,727,542,185,6
16052,2023-10-31 20:00:00,134,271,7,15,608,536,72,5
16053,2023-10-31 21:00:00,144,284,5,16,627,535,92,13
16054,2023-10-31 22:00:00,130,295,11,11,764,627,137,9
16055,2023-10-31 23:00:00,149,292,10,18,536,451,85,14
16056,2023-11-01 00:00:00,126,262,14,10,643,482,161,13
16057,2023-11-01 01:00:00,130,269,12,14,755,655,100,13
16058,2023-11-01 02:00:00,128,255,8,17,709,593,116,6
16059,2023-11-01 03:00:00,143,262,6,17,748,653,95,11
16060,2023-11-01 04:00:00,131,288,9,16,703,557,146,9
16061,2023-11-01 05:00:00,132,271,9,13,711,499,212,8
16062,2023-11-01 06:00:00,142,264,5,10,709,614,95,12
16063,2023-11-01 07:00:00,135,254,9,13,573,485,88,13
16064,2023-11-01 08:00:00,131,273,14,10,634,533,101,12
16065,2023-11-01 09:00:00,127,256,6,19,568,477,91,8
16066,2023-11-01 10:00:00,136,299,8,10,528,455,73,12
16067,2023-11-01 11:00:00,145,258,7,18,674,489,185,13
16068,2023-11-01 12:00:00,143,257,5,13,606,522,84,7
16069,2023-11-01 13:00:00,122,270,10,10,604,526,78,8
16070,2023-11-01 14:00:00,139,258,5,19,551,425,126,11
16071,2023-11-01 15:00:00,125,262,14,12,652,561,91,7
16072,2023-11-01 16:00:00,136,283,8,19,682,479,203,6
16073,2023-11-01 17:00:00,139,290,13,18,551,495,56,14
16074,2023-11-01 18:00:00,146,289,11,13,776,683,93,14
16075,2023-11-01 19:00:00,134,292,14,15,632,514,118,11
16076,2023-11-01 20:00:00,123,285,9,18,776,603,173,8
16077,2023-11-01 21:00:00,140,269,12,12,674,502,172,12
16078,2023-11-01 22:00:00,149,253,12,12,659,562,97,8
16079,2023-11-01 23:00:00,125,251,13,12,581,465,116,6
16080,2023-11-02 00:00:00,140,270,5,17,594,461,133,9
16081,2023-11-02 01:00:00,133,290,5,13,587,466,121,14
16082,2023-11-02 02:00:00,148,295,13,18,758,553,205,11
16083,2023-11-02 03:00:00,126,252,13,13,772,569,203,9
16084,2023-11-02 04:00:00,140,284,14,16,774,565,209,6
16085,2023-11-02 05:00:00,122,263,8,12,565,466,99,13
16086,2023-11-02 06:00:00,148,284,12,15,590,509,81,9
16087,2023-11-02 07:00:00,149,279,8,18,589,450,139,9
16088,2023-11-02 08:00:00,137,262,9,16,611,530,81,10
16089,2023-11-02 09:00:00,132,270,14,16,711,511,200,5
16090,2023-11-02 10:00:00,149,288,9,12,765,590,175,12
16091,2023-11-02 11:00:00,146,268,13,10,556,466,90,13
16092,2023-11-02 12:00:00,126,277,10,17,717,590,127,10
16093,2023-11-02 13:00:00,141,273,13,14,643,567,76,5
16094,2023-11-02 14:00:00,123,257,7,19,705,551,154,5
16095,2023-11-02 15:00:00,133,258,12,15,636,532,104,10
16096,2023-11-02 16:00:00,140,281,14,11,508,435,73,12
16097,2023-11-02 17:00:00,146,283,8,16,505,426,79,12
16098,2023-11-02 18:00:00,129,274,13,18,573,428,145,9
16099,2023-11-02 19:00:00,131,294,11,18,542,399,143,9
16100,2023-11-02 20:00:00,141,255,13,12,716,536,180,6
16101,2023-11-02 21:00:00,121,251,12,16,587,502,85,9
16102,2023-11-02 22:00:00,141,254,9,11,617,490,127,6
16103,2023-11-02 23:00:00,137,270,8,13,679,556,123,8
16104,2023-11-03 00:00:00,139,278,7,10,768,595,173,12
16105,2023-11-03 01:00:00,120,266,12,13,744,562,182,14
16106,2023-11-03 02:00:00,142,262,13,17,701,582,119,11
16107,2023-11-03 03:00:00,142,263,7,16,617,459,158,13
16108,2023-11-03 04:00:00,122,286,7,11,746,671,75,14
16109,2023-11-03 05:00:00,129,271,5,11,541,456,85,6
16110,2023-11-03 06:00:00,122,267,8,17,751,617,134,7
16111,2023-11-03 07:00:00,143,279,12,16,618,495,123,14
16112,2023-11-03 08:00:00,124,257,14,14,726,643,83,7
16113,2023-11-03 09:00:00,133,251,8,18,642,485,157,5
16114,2023-11-03 10:00:00,148,252,13,10,561,394,167,10
16115,2023-11-03 11:00:00,126,274,7,12,580,502,78,5
16116,2023-11-03 12:00:00,131,289,12,14,793,558,235,10
16117,2023-11-03 13:00:00,123,269,11,14,506,379,127,7
16118,2023-11-03 14:00:00,149,291,9,11,530,452,78,11
16119,2023-11-03 15:00:00,133,290,12,17,566,404,162,13
16120,2023-11-03 16:00:00,143,297,8,12,503,424,79,7
16121,2023-11-03 17:00:00,131,256,11,11,692,551,141,11
16122,2023-11-03 18:00:00,147,289,10,14,646,478,168,14
16123,2023-11-03 19:00:00,133,293,14,13,646,540,106,6
16124,2023-11-03 20:00:00,134,293,13,13,738,546,192,5
16125,2023-11-03 21:00:00,141,256,8,15,508,414,94,8
16126,2023-11-03 22:00:00,127,264,13,12,666,484,182,13
16127,2023-11-03 23:00:00,147,271,14,19,518,395,123,14
16128,2023-11-04 00:00:00,148,270,7,19,683,558,125,12
16129,2023-11-04 01:00:00,132,289,11,11,634,542,92,8
16130,2023-11-04 02:00:00,139,262,5,14,674,588,86,13
16131,2023-11-04 03:00:00,137,251,11,14,611,530,81,11
16132,2023-11-04 04:00:00,142,272,11,17,721,623,98,5
16133,2023-11-04 05:00:00,129,261,7,12,700,542,158,5
16134,2023-11-04 06:00:00,139,276,14,14,786,560,226,14
16135,2023-11-04 07:00:00,140,292,8,12,548,475,73,14
16136,2023-11-04 08:00:00,124,261,10,14,630,516,114,8
16137,2023-11-04 09:00:00,137,280,7,17,571,399,172,8
16138,2023-11-04 10:00:00,130,291,7,10,662,584,78,13
16139,2023-11-04 11:00:00,124,280,9,10,500,384,116,10
16140,2023-11-04 12:00:00,145,286,13,14,586,501,85,7
16141,2023-11-04 13:00:00,130,259,10,17,642,497,145,10
16142,2023-11-04 14:00:00,121,276,9,11,529,451,78,9
16143,2023-11-04 15:00:00,147,273,5,18,765,601,164,7
16144,2023-11-04 16:00:00,122,261,11,17,573,496,77,6
16145,2023-11-04 17:00:00,121,286,5,12,540,409,131,6
16146,2023-11-04 18:00:00,121,269,13,18,740,549,191,9
16147,2023-11-04 19:00:00,123,282,5,13,591,522,69,11
16148,2023-11-04 20:00:00,130,276,14,15,709,630,79,12
16149,2023-11-04 21:00:00,122,258,7,16,697,590,107,13
16150,2023-11-04 22:00:00,149,267,13,13,772,625,147,6
16151,2023-11-04 23:00:00,133,250,13,10,641,556,85,14
16152,2023-11-05 00:00:00,138,263,5,13,644,556,88,7
16153,2023-11-05 01:00:00,143,286,10,12,723,510,213,7
16154,2023-11-05 02:00:00,127,265,6,11,787,594,193,12
16155,2023-11-05 03:00:00,141,260,7,10,739,605,134,8
16156,2023-11-05 04:00:00,147,295,14,15,610,510,100,13
16157,2023-11-05 05:00:00,125,294,5,17,782,648,134,9
16158,2023-11-05 06:00:00,139,273,13,18,644,534,110,10
16159,2023-11-05 07:00:00,139,257,7,18,759,539,220,9
16160,2023-11-05 08:00:00,121,295,12,13,658,561,97,13
16161,2023-11-05 09:00:00,149,277,8,19,691,554,137,5
16162,2023-11-05 10:00:00,143,254,14,16,565,437,128,9
16163,2023-11-05 11:00:00,145,295,10,14,575,455,120,12
16164,2023-11-05 12:00:00,128,252,11,14,603,479,124,11
16165,2023-11-05 13:00:00,139,290,9,13,590,463,127,8
16166,2023-11-05 14:00:00,134,255,10,13,698,504,194,6
16167,2023-11-05 15:00:00,125,260,6,12,542,385,157,9
16168,2023-11-05 16:00:00,129,273,12,13,791,696,95,5
16169,2023-11-05 17:00:00,135,262,6,18,709,575,134,5
16170,2023-11-05 18:00:00,138,279,6,16,547,437,110,9
16171,2023-11-05 19:00:00,144,291,9,11,775,620,155,14
16172,2023-11-05 20:00:00,123,267,6,10,665,535,130,8
16173,2023-11-05 21:00:00,142,250,12,17,709,585,124,5
16174,2023-11-05 22:00:00,124,297,13,19,556,495,61,6
16175,2023-11-05 23:00:00,139,295,10,15,769,595,174,14
16176,2023-11-06 00:00:00,125,251,8,15,561,459,102,12
16177,2023-11-06 01:00:00,145,264,9,10,650,532,118,5
16178,2023-11-06 02:00:00,121,267,10,13,610,450,160,7
16179,2023-11-06 03:00:00,147,277,14,14,563,463,100,11
16180,2023-11-06 04:00:00,122,262,13,19,775,626,149,12
16181,2023-11-06 05:00:00,121,274,5,10,773,659,114,7
16182,2023-11-06 06:00:00,123,250,8,17,702,620,82,12
16183,2023-11-06 07:00:00,143,288,14,19,501,369,132,13
16184,2023-11-06 08:00:00,149,274,9,19,534,409,125,13
16185,2023-11-06 09:00:00,140,280,12,17,669,589,80,10
16186,2023-11-06 10:00:00,130,266,13,16,630,490,140,14
16187,2023-11-06 11:00:00,144,256,14,12,663,522,141,8
16188,2023-11-06 12:00:00,135,275,14,17,710,578,132,12
16189,2023-11-06 13:00:00,139,271,10,10,782,648,134,14
16190,2023-11-06 14:00:00,126,265,11,16,746,542,204,7
16191,2023-11-06 15:00:00,128,273,7,10,587,470,117,5
16192,2023-11-06 16:00:00,142,291,11,16,706,619,87,13
16193,2023-11-06 17:00:00,128,262,8,18,747,594,153,9
16194,2023-11-06 18:00:00,147,278,5,15,585,480,105,10
16195,2023-11-06 19:00:00,122,254,5,13,504,451,53,8
16196,2023-11-06 20:00:00,130,288,9,16,646,565,81,8
16197,2023-11-06 21:00:00,137,252,12,13,533,394,139,5
16198,2023-11-06 22:00:00,144,274,7,11,668,586,82,12
16199,2023-11-06 23:00:00,143,274,11,13,506,442,64,8
16200,2023-11-07 00:00:00,143,270,9,12,699,544,155,6
16201,2023-11-07 01:00:00,144,280,13,18,635,508,127,10
16202,2023-11-07 02:00:00,124,259,6,11,648,455,193,9
16203,2023-11-07 03:00:00,141,291,13,19,534,433,101,9
16204,2023-11-07 04:00:00,132,280,12,13,659,507,152,11
16205,2023-11-07 05:00:00,131,258,13,12,555,461,94,12
16206,2023-11-07 06:00:00,148,273,10,14,704,500,204,10
16207,2023-11-07 07:00:00,129,271,7,12,529,471,58,7
16208,2023-11-07 08:00:00,138,266,10,18,781,695,86,6
16209,2023-11-07 09:00:00,140,293,12,10,544,386,158,6
16210,2023-11-07 10:00:00,149,291,12,14,501,424,77,7
16211,2023-11-07 11:00:00,139,270,11,15,737,591,146,5
16212,2023-11-07 12:00:00,121,294,5,11,753,540,213,11
16213,2023-11-07 13:00:00,140,297,8,12,662,501,161,13
16214,2023-11-07 14:00:00,120,251,14,15,509,457,52,7
16215,2023-11-07 15:00:00,147,290,7,19,633,542,91,14
16216,2023-11-07 16:00:00,141,253,12,12,597,430,167,14
16217,2023-11-07 17:00:00,135,291,6,10,694,491,203,12
16218,2023-11-07 18:00:00,148,297,10,19,736,519,217,6
16219,2023-11-07 19:00:00,147,288,7,18,797,598,199,12
16220,2023-11-07 20:00:00,131,254,7,19,705,535,170,6
16221,2023-11-07 21:00:00,127,264,14,16,765,605,160,12
16222,2023-11-07 22:00:00,121,278,9,12,575,440,135,14
16223,2023-11-07 23:00:00,128,288,11,19,733,646,87,8
16224,2023-11-08 00:00:00,133,263,5,14,760,573,187,13
16225,2023-11-08 01:00:00,125,299,7,16,576,472,104,10
16226,2023-11-08 02:00:00,141,299,12,18,766,630,136,8
16227,2023-11-08 03:00:00,144,290,5,12,795,709,86,10
16228,2023-11-08 04:00:00,139,250,12,13,596,463,133,11
16229,2023-11-08 05:00:00,129,259,10,14,614,444,170,13
16230,2023-11-08 06:00:00,126,283,6,14,682,502,180,5
16231,2023-11-08 07:00:00,125,260,8,18,791,576,215,14
16232,2023-11-08 08:00:00,128,256,9,15,645,507,138,12
16233,2023-11-08 09:00:00,129,297,7,15,659,530,129,9
16234,2023-11-08 10:00:00,133,292,12,13,666,520,146,13
16235,2023-11-08 11:00:00,136,286,10,16,658,541,117,11
16236,2023-11-08 12:00:00,120,290,9,10,692,546,146,14
16237,2023-11-08 13:00:00,145,284,14,18,573,491,82,10
16238,2023-11-08 14:00:00,137,287,14,13,523,394,129,14
16239,2023-11-08 15:00:00,131,257,7,16,540,380,160,14
16240,2023-11-08 16:00:00,137,285,11,16,576,504,72,7
16241,2023-11-08 17:00:00,129,299,13,18,648,522,126,6
16242,2023-11-08 18:00:00,128,280,5,16,505,391,114,10
16243,2023-11-08 19:00:00,147,269,11,17,754,632,122,8
16244,2023-11-08 20:00:00,149,261,9,12,766,674,92,5
16245,2023-11-08 21:00:00,130,255,11,16,685,540,145,6
16246,2023-11-08 22:00:00,136,256,10,14,790,649,141,9
16247,2023-11-08 23:00:00,128,286,8,17,637,533,104,6
16248,2023-11-09 00:00:00,128,250,11,18,771,573,198,14
16249,2023-11-09 01:00:00,149,273,12,18,741,540,201,14
16250,2023-11-09 02:00:00,137,252,13,11,771,540,231,7
16251,2023-11-09 03:00:00,127,288,6,15,631,504,127,10
16252,2023-11-09 04:00:00,148,284,13,12,529,471,58,9
16253,2023-11-09 05:00:00,122,293,6,14,649,490,159,8
16254,2023-11-09 06:00:00,132,268,7,14,725,649,76,8
16255,2023-11-09 07:00:00,128,292,10,19,558,493,65,13
16256,2023-11-09 08:00:00,148,279,8,16,786,638,148,11
16257,2023-11-09 09:00:00,147,289,6,11,579,446,133,9
16258,2023-11-09 10:00:00,144,284,8,13,557,424,133,8
16259,2023-11-09 11:00:00,137,299,13,11,657,514,143,12
16260,2023-11-09 12:00:00,139,272,9,14,767,584,183,7
16261,2023-11-09 13:00:00,130,298,6,18,720,529,191,9
16262,2023-11-09 14:00:00,141,250,9,15,626,485,141,14
16263,2023-11-09 15:00:00,125,272,9,12,758,672,86,6
16264,2023-11-09 16:00:00,129,285,12,18,739,524,215,5
16265,2023-11-09 17:00:00,139,263,9,17,734,571,163,5
16266,2023-11-09 18:00:00,125,295,5,19,611,539,72,12
16267,2023-11-09 19:00:00,123,280,7,13,526,448,78,7
16268,2023-11-09 20:00:00,145,262,6,10,659,542,117,9
16269,2023-11-09 21:00:00,132,289,10,10,770,638,132,6
16270,2023-11-09 22:00:00,128,272,9,12,626,533,93,8
16271,2023-11-09 23:00:00,137,253,14,13,539,484,55,9
16272,2023-11-10 00:00:00,123,265,13,10,509,437,72,14
16273,2023-11-10 01:00:00,137,271,6,15,769,669,100,9
16274,2023-11-10 02:00:00,135,252,7,18,580,429,151,8
16275,2023-11-10 03:00:00,148,260,13,16,587,523,64,8
16276,2023-11-10 04:00:00,148,251,9,19,773,608,165,8
16277,2023-11-10 05:00:00,138,268,6,17,675,513,162,9
16278,2023-11-10 06:00:00,141,250,11,15,565,460,105,6
16279,2023-11-10 07:00:00,121,270,11,13,769,609,160,12
16280,2023-11-10 08:00:00,136,263,6,16,717,503,214,12
16281,2023-11-10 09:00:00,124,255,6,11,579,458,121,11
16282,2023-11-10 10:00:00,125,268,7,16,656,475,181,8
16283,2023-11-10 11:00:00,148,273,13,18,658,479,179,12
16284,2023-11-10 12:00:00,129,285,9,10,639,543,96,9
16285,2023-11-10 13:00:00,149,256,6,14,712,636,76,5
16286,2023-11-10 14:00:00,120,275,7,10,686,512,174,6
16287,2023-11-10 15:00:00,148,262,14,12,654,492,162,9
16288,2023-11-10 16:00:00,148,289,13,16,681,549,132,13
16289,2023-11-10 17:00:00,147,277,12,12,505,385,120,12
16290,2023-11-10 18:00:00,148,289,13,13,551,456,95,10
16291,2023-11-10 19:00:00,122,282,6,13,706,574,132,12
16292,2023-11-10 20:00:00,128,250,11,17,522,434,88,5
16293,2023-11-10 21:00:00,130,295,13,13,539,381,158,13
16294,2023-11-10 22:00:00,131,294,11,10,605,528,77,9
16295,2023-11-10 23:00:00,126,299,8,17,506,441,65,5
16296,2023-11-11 00:00:00,137,252,8,17,754,595,159,11
16297,2023-11-11 01:00:00,136,297,10,14,720,580,140,6
16298,2023-11-11 02:00:00,127,291,8,19,618,522,96,8
16299,2023-11-11 03:00:00,124,273,11,15,702,530,172,7
16300,2023-11-11 04:00:00,121,287,11,16,728,631,97,7
16301,2023-11-11 05:00:00,120,259,5,15,690,549,141,11
16302,2023-11-11 06:00:00,128,299,11,12,796,636,160,14
16303,2023-11-11 07:00:00,129,276,13,13,596,499,97,6
16304,2023-11-11 08:00:00,139,279,10,12,784,689,95,9
16305,2023-11-11 09:00:00,122,278,11,18,636,520,116,11
16306,2023-11-11 10:00:00,124,292,10,18,504,360,144,9
16307,2023-11-11 11:00:00,147,251,14,13,556,471,85,9
16308,2023-11-11 12:00:00,137,255,13,14,517,449,68,14
16309,2023-11-11 13:00:00,140,252,10,16,777,549,228,14
16310,2023-11-11 14:00:00,134,251,12,14,707,514,193,13
16311,2023-11-11 15:00:00,125,291,9,13,794,620,174,5
16312,2023-11-11 16:00:00,132,271,11,17,553,459,94,10
16313,2023-11-11 17:00:00,147,261,14,16,636,526,110,8
16314,2023-11-11 18:00:00,135,290,9,18,754,547,207,10
16315,2023-11-11 19:00:00,126,259,5,17,774,661,113,6
16316,2023-11-11 20:00:00,131,281,6,16,595,497,98,9
16317,2023-11-11 21:00:00,132,265,12,17,715,621,94,11
16318,2023-11-11 22:00:00,121,286,10,19,660,548,112,8
16319,2023-11-11 23:00:00,133,265,14,18,530,377,153,14
16320,2023-11-12 00:00:00,128,263,12,18,630,503,127,9
16321,2023-11-12 01:00:00,131,283,12,15,720,517,203,11
16322,2023-11-12 02:00:00,148,297,12,17,644,454,190,7
16323,2023-11-12 03:00:00,135,254,13,12,621,475,146,5
16324,2023-11-12 04:00:00,120,299,9,14,699,579,120,7
16325,2023-11-12 05:00:00,135,262,14,14,643,539,104,6
16326,2023-11-12 06:00:00,132,273,9,12,747,530,217,8
16327,2023-11-12 07:00:00,123,296,5,14,674,545,129,12
16328,2023-11-12 08:00:00,146,269,5,17,764,607,157,13
16329,2023-11-12 09:00:00,123,260,9,14,515,406,109,6
16330,2023-11-12 10:00:00,139,281,7,12,781,556,225,9
16331,2023-11-12 11:00:00,123,257,5,19,510,415,95,13
16332,2023-11-12 12:00:00,124,263,11,18,516,400,116,13
16333,2023-11-12 13:00:00,147,299,6,15,708,582,126,11
16334,2023-11-12 14:00:00,122,261,5,14,782,622,160,8
16335,2023-11-12 15:00:00,146,286,8,19,596,525,71,14
16336,2023-11-12 16:00:00,134,281,11,15,728,549,179,8
16337,2023-11-12 17:00:00,124,270,10,13,708,636,72,5
16338,2023-11-12 18:00:00,140,296,8,19,645,501,144,5
16339,2023-11-12 19:00:00,121,268,14,18,501,382,119,6
16340,2023-11-12 20:00:00,134,297,8,14,608,545,63,7
16341,2023-11-12 21:00:00,130,276,14,14,713,581,132,9
16342,2023-11-12 22:00:00,144,256,12,11,791,638,153,7
16343,2023-11-12 23:00:00,135,291,7,18,604,472,132,11
16344,2023-11-13 00:00:00,129,259,8,15,648,471,177,13
16345,2023-11-13 01:00:00,143,280,13,13,633,461,172,8
16346,2023-11-13 02:00:00,127,267,11,19,577,506,71,14
16347,2023-11-13 03:00:00,120,299,5,16,781,574,207,6
16348,2023-11-13 04:00:00,122,268,5,19,656,512,144,11
16349,2023-11-13 05:00:00,138,283,7,13,752,546,206,7
16350,2023-11-13 06:00:00,133,284,11,19,707,627,80,8
16351,2023-11-13 07:00:00,139,274,12,15,601,431,170,8
16352,2023-11-13 08:00:00,142,255,5,14,515,392,123,14
16353,2023-11-13 09:00:00,132,260,14,16,633,463,170,12
16354,2023-11-13 10:00:00,146,274,7,10,540,447,93,9
16355,2023-11-13 11:00:00,124,272,8,16,527,435,92,12
16356,2023-11-13 12:00:00,146,295,10,14,687,608,79,8
16357,2023-11-13 13:00:00,126,260,9,12,769,647,122,11
16358,2023-11-13 14:00:00,130,262,9,14,610,461,149,6
16359,2023-11-13 15:00:00,147,299,5,12,711,634,77,14
16360,2023-11-13 16:00:00,148,261,11,16,594,449,145,7
16361,2023-11-13 17:00:00,129,252,14,14,577,489,88,6
16362,2023-11-13 18:00:00,144,252,5,10,534,476,58,5
16363,2023-11-13 19:00:00,129,255,12,12,530,377,153,14
16364,2023-11-13 20:00:00,126,281,10,14,619,540,79,14
16365,2023-11-13 21:00:00,139,283,14,12,616,545,71,10
16366,2023-11-13 22:00:00,123,269,13,19,510,357,153,10
16367,2023-11-13 23:00:00,135,271,13,16,779,639,140,7
16368,2023-11-14 00:00:00,143,284,8,12,719,555,164,7
16369,2023-11-14 01:00:00,137,257,6,16,753,676,77,7
16370,2023-11-14 02:00:00,131,281,11,19,680,526,154,11
16371,2023-11-14 03:00:00,120,256,12,11,597,463,134,11
16372,2023-11-14 04:00:00,138,260,8,12,675,606,69,9
16373,2023-11-14 05:00:00,145,254,6,13,763,541,222,10
16374,2023-11-14 06:00:00,143,266,8,17,501,420,81,12
16375,2023-11-14 07:00:00,129,260,9,17,583,426,157,7
16376,2023-11-14 08:00:00,140,261,5,16,502,393,109,10
16377,2023-11-14 09:00:00,141,277,14,16,575,491,84,14
16378,2023-11-14 10:00:00,143,293,14,12,716,527,189,6
16379,2023-11-14 11:00:00,128,255,11,18,786,646,140,10
16380,2023-11-14 12:00:00,145,280,10,11,564,400,164,6
16381,2023-11-14 13:00:00,148,267,10,10,799,619,180,11
16382,2023-11-14 14:00:00,129,268,6,16,579,472,107,5
16383,2023-11-14 15:00:00,136,288,11,17,735,618,117,9
16384,2023-11-14 16:00:00,148,292,9,18,721,556,165,11
16385,2023-11-14 17:00:00,146,255,7,15,584,502,82,9
16386,2023-11-14 18:00:00,130,279,10,19,723,580,143,8
16387,2023-11-14 19:00:00,128,273,7,10,676,489,187,13
16388,2023-11-14 20:00:00,149,258,8,11,777,693,84,6
16389,2023-11-14 21:00:00,149,261,6,13,689,576,113,13
16390,2023-11-14 22:00:00,131,299,12,10,728,525,203,11
16391,2023-11-14 23:00:00,143,281,5,13,756,627,129,10
16392,2023-11-15 00:00:00,126,258,9,12,791,645,146,12
16393,2023-11-15 01:00:00,124,254,8,18,528,406,122,11
16394,2023-11-15 02:00:00,139,299,8,18,681,600,81,10
16395,2023-11-15 03:00:00,144,265,9,18,685,480,205,12
16396,2023-11-15 04:00:00,125,298,12,12,786,566,220,12
16397,2023-11-15 05:00:00,146,289,9,17,594,466,128,13
16398,2023-11-15 06:00:00,120,289,14,15,652,537,115,5
16399,2023-11-15 07:00:00,122,270,13,15,526,369,157,6
16400,2023-11-15 08:00:00,139,296,13,14,646,529,117,5
16401,2023-11-15 09:00:00,130,273,10,11,787,663,124,13
16402,2023-11-15 10:00:00,126,251,5,19,746,642,104,14
16403,2023-11-15 11:00:00,138,273,13,11,718,506,212,6
16404,2023-11-15 12:00:00,137,260,7,17,564,505,59,5
16405,2023-11-15 13:00:00,139,286,5,14,555,406,149,5
16406,2023-11-15 14:00:00,132,274,14,14,677,596,81,8
16407,2023-11-15 15:00:00,139,289,8,18,700,538,162,10
16408,2023-11-15 16:00:00,135,296,12,16,501,394,107,8
16409,2023-11-15 17:00:00,137,289,9,10,756,657,99,7
16410,2023-11-15 18:00:00,141,260,9,10,560,419,141,10
16411,2023-11-15 19:00:00,146,259,11,16,607,529,78,12
16412,2023-11-15 20:00:00,148,261,14,18,663,581,82,7
16413,2023-11-15 21:00:00,127,284,14,14,546,457,89,9
16414,2023-11-15 22:00:00,126,287,6,16,506,379,127,11
16415,2023-11-15 23:00:00,121,297,9,19,603,519,84,12
16416,2023-11-16 00:00:00,128,262,7,14,534,380,154,7
16417,2023-11-16 01:00:00,146,284,11,13,616,454,162,6
16418,2023-11-16 02:00:00,147,254,13,17,628,442,186,8
16419,2023-11-16 03:00:00,121,296,8,13,601,489,112,14
16420,2023-11-16 04:00:00,141,252,5,17,706,631,75,13
16421,2023-11-16 05:00:00,133,288,8,14,553,487,66,11
16422,2023-11-16 06:00:00,130,277,12,15,666,479,187,10
16423,2023-11-16 07:00:00,129,283,10,14,652,528,124,9
16424,2023-11-16 08:00:00,145,253,12,17,643,547,96,14
16425,2023-11-16 09:00:00,131,286,11,18,783,566,217,14
16426,2023-11-16 10:00:00,136,293,6,16,742,612,130,11
16427,2023-11-16 11:00:00,139,290,5,12,767,629,138,12
16428,2023-11-16 12:00:00,144,269,9,11,672,600,72,13
16429,2023-11-16 13:00:00,141,274,13,16,744,666,78,12
16430,2023-11-16 14:00:00,138,252,10,14,782,667,115,10
16431,2023-11-16 15:00:00,134,266,7,19,529,448,81,11
16432,2023-11-16 16:00:00,122,281,7,18,609,450,159,13
16433,2023-11-16 17:00:00,122,283,5,17,542,463,79,14
16434,2023-11-16 18:00:00,144,298,11,11,594,521,73,13
16435,2023-11-16 19:00:00,147,265,10,13,548,403,145,13
16436,2023-11-16 20:00:00,139,267,7,15,590,510,80,5
16437,2023-11-16 21:00:00,141,273,14,12,785,702,83,9
16438,2023-11-16 22:00:00,139,271,11,18,573,405,168,10
16439,2023-11-16 23:00:00,140,264,11,16,731,604,127,12
16440,2023-11-17 00:00:00,124,278,11,15,767,557,210,13
16441,2023-11-17 01:00:00,139,266,5,16,555,390,165,6
16442,2023-11-17 02:00:00,134,298,13,10,571,450,121,6
16443,2023-11-17 03:00:00,134,269,13,17,533,419,114,7
16444,2023-11-17 04:00:00,133,281,9,13,793,665,128,11
16445,2023-11-17 05:00:00,149,299,5,16,680,601,79,14
16446,2023-11-17 06:00:00,121,272,5,12,603,438,165,10
16447,2023-11-17 07:00:00,142,259,8,19,616,515,101,10
16448,2023-11-17 08:00:00,144,266,14,16,787,644,143,7
16449,2023-11-17 09:00:00,128,259,13,16,655,560,95,8
16450,2023-11-17 10:00:00,142,299,10,11,574,480,94,10
16451,2023-11-17 11:00:00,128,285,11,12,737,631,106,10
16452,2023-11-17 12:00:00,147,269,13,10,636,475,161,7
16453,2023-11-17 13:00:00,123,280,12,10,705,626,79,9
16454,2023-11-17 14:00:00,135,272,12,14,751,526,225,5
16455,2023-11-17 15:00:00,144,292,9,17,798,657,141,6
16456,2023-11-17 16:00:00,144,285,14,16,702,619,83,11
16457,2023-11-17 17:00:00,137,265,7,19,769,558,211,7
16458,2023-11-17 18:00:00,146,284,6,18,696,602,94,14
16459,2023-11-17 19:00:00,123,250,5,18,563,448,115,13
16460,2023-11-17 20:00:00,148,255,5,14,694,540,154,12
16461,2023-11-17 21:00:00,137,271,5,11,562,410,152,7
16462,2023-11-17 22:00:00,139,277,7,13,791,593,198,9
16463,2023-11-17 23:00:00,130,283,8,17,542,467,75,12
16464,2023-11-18 00:00:00,147,258,12,16,672,510,162,12
16465,2023-11-18 01:00:00,123,298,13,10,511,457,54,8
16466,2023-11-18 02:00:00,123,275,12,18,551,460,91,12
16467,2023-11-18 03:00:00,125,284,7,12,671,554,117,5
16468,2023-11-18 04:00:00,123,258,8,10,746,581,165,9
16469,2023-11-18 05:00:00,125,297,9,11,589,438,151,10
16470,2023-11-18 06:00:00,120,290,14,14,535,389,146,8
16471,2023-11-18 07:00:00,131,291,14,17,659,522,137,7
16472,2023-11-18 08:00:00,131,264,5,13,541,472,69,12
16473,2023-11-18 09:00:00,140,275,8,10,774,693,81,8
16474,2023-11-18 10:00:00,145,255,8,12,535,426,109,9
16475,2023-11-18 11:00:00,122,270,12,16,754,566,188,8
16476,2023-11-18 12:00:00,126,290,8,19,715,574,141,6
16477,2023-11-18 13:00:00,133,290,5,16,536,420,116,6
16478,2023-11-18 14:00:00,137,253,8,16,580,448,132,12
16479,2023-11-18 15:00:00,123,265,14,17,655,487,168,8
16480,2023-11-18 16:00:00,147,269,11,17,675,558,117,12
16481,2023-11-18 17:00:00,139,289,6,16,778,603,175,12
16482,2023-11-18 18:00:00,138,272,13,17,570,504,66,8
16483,2023-11-18 19:00:00,143,283,11,16,694,548,146,10
16484,2023-11-18 20:00:00,149,267,8,14,745,564,181,11
16485,2023-11-18 21:00:00,145,285,7,19,561,493,68,8
16486,2023-11-18 22:00:00,139,278,9,17,642,546,96,5
16487,2023-11-18 23:00:00,133,286,12,11,579,513,66,5
16488,2023-11-19 00:00:00,142,265,5,12,727,529,198,12
16489,2023-11-19 01:00:00,120,281,13,11,673,495,178,6
16490,2023-11-19 02:00:00,128,250,11,17,681,493,188,9
16491,2023-11-19 03:00:00,138,275,12,13,533,422,111,5
16492,2023-11-19 04:00:00,129,272,10,11,585,428,157,5
16493,2023-11-19 05:00:00,147,284,11,12,674,543,131,13
16494,2023-11-19 06:00:00,132,281,8,19,567,450,117,6
16495,2023-11-19 07:00:00,136,288,11,12,571,482,89,9
16496,2023-11-19 08:00:00,126,282,10,19,790,691,99,5
16497,2023-11-19 09:00:00,148,283,11,14,796,689,107,8
16498,2023-11-19 10:00:00,142,284,8,14,735,634,101,13
16499,2023-11-19 11:00:00,147,296,13,13,714,635,79,6
16500,2023-11-19 12:00:00,147,291,9,14,533,410,123,13
16501,2023-11-19 13:00:00,126,284,10,17,606,473,133,13
16502,2023-11-19 14:00:00,144,291,7,11,634,477,157,9
16503,2023-11-19 15:00:00,135,275,12,17,573,494,79,9
16504,2023-11-19 16:00:00,128,277,8,11,649,520,129,8
16505,2023-11-19 17:00:00,137,295,9,15,643,464,179,10
16506,2023-11-19 18:00:00,128,254,12,19,502,358,144,10
16507,2023-11-19 19:00:00,148,280,8,16,773,669,104,9
16508,2023-11-19 20:00:00,129,257,10,17,524,467,57,11
16509,2023-11-19 21:00:00,121,291,13,16,687,587,100,11
16510,2023-11-19 22:00:00,121,253,6,13,538,465,73,12
16511,2023-11-19 23:00:00,124,270,12,11,581,443,138,9
16512,2023-11-20 00:00:00,141,261,12,17,583,516,67,9
16513,2023-11-20 01:00:00,123,261,12,12,613,542,71,11
16514,2023-11-20 02:00:00,135,292,7,16,532,468,64,13
16515,2023-11-20 03:00:00,139,284,6,12,754,616,138,5
16516,2023-11-20 04:00:00,143,288,5,14,557,428,129,12
16517,2023-11-20 05:00:00,126,296,14,13,799,627,172,6
16518,2023-11-20 06:00:00,125,290,12,12,787,574,213,9
16519,2023-11-20 07:00:00,139,258,5,17,686,616,70,11
16520,2023-11-20 08:00:00,120,280,5,17,771,594,177,7
16521,2023-11-20 09:00:00,139,250,13,18,516,383,133,11
16522,2023-11-20 10:00:00,140,254,6,16,557,497,60,14
16523,2023-11-20 11:00:00,141,295,9,11,557,399,158,5
16524,2023-11-20 12:00:00,123,250,9,18,790,591,199,12
16525,2023-11-20 13:00:00,146,263,12,13,645,522,123,11
16526,2023-11-20 14:00:00,132,254,8,11,641,549,92,14
16527,2023-11-20 15:00:00,122,250,6,14,546,426,120,8
16528,2023-11-20 16:00:00,142,273,8,16,670,576,94,13
16529,2023-11-20 17:00:00,126,266,11,16,642,536,106,12
16530,2023-11-20 18:00:00,146,280,9,13,530,446,84,11
16531,2023-11-20 19:00:00,122,298,10,17,549,491,58,8
16532,2023-11-20 20:00:00,147,257,10,15,661,554,107,5
16533,2023-11-20 21:00:00,138,273,14,15,618,466,152,5
16534,2023-11-20 22:00:00,130,261,8,18,552,401,151,8
16535,2023-11-20 23:00:00,134,252,5,19,749,621,128,5
16536,2023-11-21 00:00:00,146,289,9,14,684,603,81,6
16537,2023-11-21 01:00:00,122,257,7,18,663,478,185,10
16538,2023-11-21 02:00:00,122,274,14,17,609,520,89,14
16539,2023-11-21 03:00:00,130,260,8,11,663,518,145,9
16540,2023-11-21 04:00:00,147,255,10,10,704,623,81,10
16541,2023-11-21 05:00:00,123,278,10,10,694,490,204,12
16542,2023-11-21 06:00:00,123,297,11,17,754,563,191,8
16543,2023-11-21 07:00:00,149,279,13,18,663,586,77,6
16544,2023-11-21 08:00:00,120,275,12,18,594,450,144,13
16545,2023-11-21 09:00:00,147,291,8,17,704,535,169,11
16546,2023-11-21 10:00:00,149,266,7,13,554,412,142,5
16547,2023-11-21 11:00:00,148,273,14,12,690,620,70,9
16548,2023-11-21 12:00:00,149,270,13,15,630,503,127,12
16549,2023-11-21 13:00:00,128,256,6,13,706,599,107,7
16550,2023-11-21 14:00:00,122,278,12,15,640,480,160,13
16551,2023-11-21 15:00:00,144,285,6,19,734,642,92,5
16552,2023-11-21 16:00:00,131,273,12,15,684,541,143,6
16553,2023-11-21 17:00:00,132,274,12,12,700,608,92,11
16554,2023-11-21 18:00:00,140,253,12,13,517,457,60,9
16555,2023-11-21 19:00:00,139,292,13,11,577,487,90,6
16556,2023-11-21 20:00:00,125,290,8,18,690,484,206,9
16557,2023-11-21 21:00:00,129,281,6,17,664,515,149,5
16558,2023-11-21 22:00:00,121,289,9,14,580,441,139,8
16559,2023-11-21 23:00:00,125,295,7,14,712,635,77,12
16560,2023-11-22 00:00:00,148,280,13,19,613,521,92,7
16561,2023-11-22 01:00:00,126,264,11,16,685,579,106,14
16562,2023-11-22 02:00:00,137,272,7,16,742,575,167,10
16563,2023-11-22 03:00:00,144,251,7,12,592,424,168,10
16564,2023-11-22 04:00:00,133,266,5,13,597,477,120,14
16565,2023-11-22 05:00:00,120,258,5,18,502,387,115,8
16566,2023-11-22 06:00:00,121,283,11,19,521,422,99,8
16567,2023-11-22 07:00:00,125,269,14,14,635,478,157,9
16568,2023-11-22 08:00:00,133,294,10,17,593,433,160,7
16569,2023-11-22 09:00:00,141,268,11,17,796,673,123,6
16570,2023-11-22 10:00:00,149,294,11,19,746,609,137,8
16571,2023-11-22 11:00:00,145,298,12,13,518,421,97,5
16572,2023-11-22 12:00:00,136,270,8,15,758,598,160,10
16573,2023-11-22 13:00:00,140,271,13,11,770,612,158,5
16574,2023-11-22 14:00:00,123,289,12,19,576,408,168,7
16575,2023-11-22 15:00:00,147,279,11,13,649,502,147,14
16576,2023-11-22 16:00:00,136,279,11,11,643,564,79,5
16577,2023-11-22 17:00:00,126,295,5,13,510,421,89,12
16578,2023-11-22 18:00:00,147,280,8,12,585,525,60,13
16579,2023-11-22 19:00:00,135,291,13,10,691,592,99,8
16580,2023-11-22 20:00:00,141,288,13,11,602,478,124,14
16581,2023-11-22 21:00:00,121,297,7,19,686,557,129,7
16582,2023-11-22 22:00:00,139,265,7,12,664,553,111,6
16583,2023-11-22 23:00:00,120,255,13,11,733,544,189,10
16584,2023-11-23 00:00:00,138,268,6,18,705,511,194,11
16585,2023-11-23 01:00:00,148,261,7,13,526,414,112,10
16586,2023-11-23 02:00:00,131,297,8,16,562,455,107,10
16587,2023-11-23 03:00:00,128,280,13,10,692,493,199,11
16588,2023-11-23 04:00:00,138,254,7,10,610,432,178,10
16589,2023-11-23 05:00:00,146,266,11,12,550,466,84,8
16590,2023-11-23 06:00:00,123,291,5,14,776,581,195,11
16591,2023-11-23 07:00:00,130,264,9,17,605,476,129,8
16592,2023-11-23 08:00:00,147,271,5,10,631,512,119,9
16593,2023-11-23 09:00:00,145,288,9,16,743,647,96,8
16594,2023-11-23 10:00:00,121,275,7,15,520,423,97,14
16595,2023-11-23 11:00:00,136,296,14,11,535,380,155,13
16596,2023-11-23 12:00:00,138,295,10,19,714,640,74,11
16597,2023-11-23 13:00:00,142,279,5,13,546,472,74,8
16598,2023-11-23 14:00:00,127,297,13,19,566,410,156,9
16599,2023-11-23 15:00:00,141,280,9,14,697,557,140,9
16600,2023-11-23 16:00:00,120,299,11,16,664,583,81,13
16601,2023-11-23 17:00:00,131,267,9,16,766,613,153,9
16602,2023-11-23 18:00:00,141,291,5,15,718,580,138,10
16603,2023-11-23 19:00:00,149,286,13,17,539,397,142,14
16604,2023-11-23 20:00:00,124,257,6,18,734,549,185,8
16605,2023-11-23 21:00:00,124,263,12,16,513,452,61,7
16606,2023-11-23 22:00:00,132,280,12,19,736,631,105,10
16607,2023-11-23 23:00:00,126,273,7,12,585,498,87,14
16608,2023-11-24 00:00:00,128,267,6,14,555,388,167,14
16609,2023-11-24 01:00:00,131,255,7,11,723,581,142,12
16610,2023-11-24 02:00:00,123,264,13,14,688,508,180,8
16611,2023-11-24 03:00:00,131,267,11,19,548,455,93,6
16612,2023-11-24 04:00:00,145,255,6,13,552,496,56,12
16613,2023-11-24 05:00:00,129,295,9,14,561,404,157,8
16614,2023-11-24 06:00:00,127,278,6,17,610,509,101,6
16615,2023-11-24 07:00:00,128,264,14,13,613,449,164,6
16616,2023-11-24 08:00:00,128,259,9,13,739,567,172,7
16617,2023-11-24 09:00:00,146,273,13,18,557,439,118,8
16618,2023-11-24 10:00:00,145,285,6,10,552,454,98,14
16619,2023-11-24 11:00:00,124,250,11,17,799,561,238,13
16620,2023-11-24 12:00:00,134,257,6,17,773,653,120,7
16621,2023-11-24 13:00:00,126,268,5,18,559,442,117,12
16622,2023-11-24 14:00:00,129,289,6,10,686,587,99,6
16623,2023-11-24 15:00:00,142,269,13,16,609,498,111,13
16624,2023-11-24 16:00:00,137,261,8,16,705,601,104,11
16625,2023-11-24 17:00:00,147,263,8,14,583,473,110,5
16626,2023-11-24 18:00:00,137,291,13,18,731,540,191,5
16627,2023-11-24 19:00:00,147,268,14,10,670,521,149,7
16628,2023-11-24 20:00:00,125,299,9,15,759,547,212,14
16629,2023-11-24 21:00:00,123,261,8,19,550,472,78,14
16630,2023-11-24 22:00:00,144,253,9,12,700,623,77,9
16631,2023-11-24 23:00:00,122,267,7,16,737,610,127,7
16632,2023-11-25 00:00:00,131,293,13,18,688,504,184,9
16633,2023-11-25 01:00:00,146,261,14,10,505,390,115,11
16634,2023-11-25 02:00:00,126,259,5,14,735,621,114,5
16635,2023-11-25 03:00:00,129,263,9,15,699,548,151,5
16636,2023-11-25 04:00:00,136,290,7,17,682,484,198,12
16637,2023-11-25 05:00:00,128,297,14,16,618,492,126,5
16638,2023-11-25 06:00:00,144,264,5,15,724,632,92,6
16639,2023-11-25 07:00:00,137,265,13,16,796,631,165,8
16640,2023-11-25 08:00:00,135,279,14,17,645,460,185,5
16641,2023-11-25 09:00:00,149,269,6,14,766,650,116,12
16642,2023-11-25 10:00:00,121,297,14,19,523,390,133,11
16643,2023-11-25 11:00:00,136,274,9,17,648,516,132,12
16644,2023-11-25 12:00:00,138,262,13,12,649,583,66,12
16645,2023-11-25 13:00:00,143,254,11,17,635,460,175,6
16646,2023-11-25 14:00:00,138,270,11,11,767,608,159,9
16647,2023-11-25 15:00:00,122,299,14,15,511,399,112,10
16648,2023-11-25 16:00:00,125,285,5,11,542,380,162,5
16649,2023-11-25 17:00:00,125,296,13,16,551,455,96,8
16650,2023-11-25 18:00:00,121,265,13,12,632,535,97,12
16651,2023-11-25 19:00:00,144,282,12,13,588,433,155,9
16652,2023-11-25 20:00:00,145,275,11,11,513,418,95,8
16653,2023-11-25 21:00:00,129,255,8,10,670,547,123,6
16654,2023-11-25 22:00:00,140,292,5,17,516,399,117,6
16655,2023-11-25 23:00:00,121,281,14,18,782,573,209,8
16656,2023-11-26 00:00:00,126,283,5,16,747,568,179,7
16657,2023-11-26 01:00:00,128,295,5,13,551,446,105,5
16658,2023-11-26 02:00:00,136,284,11,15,614,542,72,7
16659,2023-11-26 03:00:00,129,277,13,10,627,537,90,9
16660,2023-11-26 04:00:00,132,276,6,15,735,642,93,10
16661,2023-11-26 05:00:00,135,290,7,14,636,521,115,11
16662,2023-11-26 06:00:00,125,268,8,14,703,534,169,6
16663,2023-11-26 07:00:00,149,254,14,19,726,617,109,12
16664,2023-11-26 08:00:00,134,299,10,19,566,421,145,10
16665,2023-11-26 09:00:00,124,276,14,16,510,360,150,13
16666,2023-11-26 10:00:00,135,299,8,12,721,630,91,12
16667,2023-11-26 11:00:00,133,293,13,18,677,580,97,12
16668,2023-11-26 12:00:00,149,260,7,12,538,405,133,14
16669,2023-11-26 13:00:00,132,291,13,17,558,436,122,9
16670,2023-11-26 14:00:00,120,278,6,19,568,464,104,12
16671,2023-11-26 15:00:00,132,257,10,11,582,434,148,8
16672,2023-11-26 16:00:00,121,288,5,11,592,420,172,14
16673,2023-11-26 17:00:00,130,299,11,12,585,486,99,14
16674,2023-11-26 18:00:00,144,252,9,10,627,470,157,5
16675,2023-11-26 19:00:00,136,299,9,17,652,480,172,12
16676,2023-11-26 20:00:00,131,293,7,12,724,621,103,5
16677,2023-11-26 21:00:00,132,261,12,11,630,475,155,10
16678,2023-11-26 22:00:00,134,288,7,13,659,529,130,12
16679,2023-11-26 23:00:00,142,275,6,13,603,476,127,8
16680,2023-11-27 00:00:00,129,274,7,12,746,667,79,14
16681,2023-11-27 01:00:00,146,251,6,13,716,610,106,11
16682,2023-11-27 02:00:00,130,256,11,14,677,478,199,12
16683,2023-11-27 03:00:00,145,259,6,12,736,656,80,8
16684,2023-11-27 04:00:00,131,257,10,16,630,496,134,5
16685,2023-11-27 05:00:00,128,279,14,17,568,426,142,7
16686,2023-11-27 06:00:00,146,273,14,17,517,458,59,8
16687,2023-11-27 07:00:00,124,284,7,11,750,553,197,13
16688,2023-11-27 08:00:00,146,267,8,18,688,483,205,9
16689,2023-11-27 09:00:00,126,268,5,13,674,575,99,5
16690,2023-11-27 10:00:00,139,276,12,15,610,536,74,9
16691,2023-11-27 11:00:00,124,275,7,18,639,510,129,6
16692,2023-11-27 12:00:00,136,289,10,16,572,491,81,5
16693,2023-11-27 13:00:00,142,281,6,19,749,575,174,14
16694,2023-11-27 14:00:00,137,271,10,12,605,430,175,13
16695,2023-11-27 15:00:00,128,259,11,11,647,534,113,9
16696,2023-11-27 16:00:00,141,278,8,11,605,477,128,14
16697,2023-11-27 17:00:00,129,284,11,19,506,370,136,12
16698,2023-11-27 18:00:00,137,261,7,16,692,611,81,11
16699,2023-11-27 19:00:00,124,293,11,13,701,617,84,11
16700,2023-11-27 20:00:00,131,277,7,17,548,404,144,13
16701,2023-11-27 21:00:00,127,294,5,12,615,540,75,6
16702,2023-11-27 22:00:00,127,253,11,10,662,479,183,8
16703,2023-11-27 23:00:00,136,287,11,18,708,604,104,14
16704,2023-11-28 00:00:00,122,292,14,16,545,426,119,5
16705,2023-11-28 01:00:00,121,263,10,12,799,575,224,13
16706,2023-11-28 02:00:00,134,276,11,15,772,676,96,9
16707,2023-11-28 03:00:00,149,255,5,10,716,507,209,5
16708,2023-11-28 04:00:00,120,280,14,18,712,534,178,6
16709,2023-11-28 05:00:00,133,273,10,14,641,509,132,5
16710,2023-11-28 06:00:00,126,252,6,15,651,548,103,13
16711,2023-11-28 07:00:00,136,256,7,17,710,580,130,14
16712,2023-11-28 08:00:00,144,255,11,15,734,526,208,12
16713,2023-11-28 09:00:00,132,295,14,15,557,427,130,13
16714,2023-11-28 10:00:00,132,272,11,14,513,380,133,13
16715,2023-11-28 11:00:00,125,294,9,18,656,547,109,8
16716,2023-11-28 12:00:00,149,253,8,14,633,482,151,8
16717,2023-11-28 13:00:00,128,252,11,10,560,486,74,14
16718,2023-11-28 14:00:00,122,288,7,15,725,605,120,7
16719,2023-11-28 15:00:00,130,270,10,15,747,566,181,6
16720,2023-11-28 16:00:00,136,262,12,12,655,483,172,5
16721,2023-11-28 17:00:00,147,271,5,13,605,501,104,13
16722,2023-11-28 18:00:00,122,279,12,11,694,493,201,14
16723,2023-11-28 19:00:00,149,281,12,12,695,586,109,8
16724,2023-11-28 20:00:00,147,292,13,13,687,496,191,10
16725,2023-11-28 21:00:00,143,288,11,16,635,564,71,13
16726,2023-11-28 22:00:00,128,292,10,13,575,516,59,7
16727,2023-11-28 23:00:00,143,258,8,16,591,448,143,9
16728,2023-11-29 00:00:00,142,263,8,18,677,562,115,5
16729,2023-11-29 01:00:00,122,283,10,17,773,645,128,5
16730,2023-11-29 02:00:00,124,269,9,19,737,554,183,14
16731,2023-11-29 03:00:00,141,268,12,19,503,403,100,10
16732,2023-11-29 04:00:00,127,285,6,18,618,485,133,14
16733,2023-11-29 05:00:00,124,257,5,13,626,546,80,10
16734,2023-11-29 06:00:00,146,258,14,15,774,600,174,14
16735,2023-11-29 07:00:00,129,266,7,11,515,444,71,8
16736,2023-11-29 08:00:00,141,259,10,16,721,648,73,12
16737,2023-11-29 09:00:00,136,269,9,11,535,478,57,10
16738,2023-11-29 10:00:00,136,280,6,13,714,541,173,7
16739,2023-11-29 11:00:00,141,250,7,16,795,667,128,9
16740,2023-11-29 12:00:00,136,254,9,12,530,463,67,12
16741,2023-11-29 13:00:00,140,264,7,13,584,522,62,11
16742,2023-11-29 14:00:00,139,285,6,16,799,675,124,12
16743,2023-11-29 15:00:00,128,282,7,17,590,497,93,6
16744,2023-11-29 16:00:00,146,299,10,19,564,481,83,11
16745,2023-11-29 17:00:00,137,280,10,11,702,515,187,9
16746,2023-11-29 18:00:00,140,275,7,17,673,541,132,13
16747,2023-11-29 19:00:00,126,272,11,10,758,672,86,14
16748,2023-11-29 20:00:00,136,284,13,16,672,552,120,9
16749,2023-11-29 21:00:00,142,264,6,16,545,472,73,14
16750,2023-11-29 22:00:00,130,267,7,16,742,565,177,6
16751,2023-11-29 23:00:00,132,265,7,13,696,508,188,6
16752,2023-11-30 00:00:00,128,287,5,14,739,567,172,14
16753,2023-11-30 01:00:00,122,252,11,18,737,647,90,6
16754,2023-11-30 02:00:00,122,266,10,16,745,548,197,10
16755,2023-11-30 03:00:00,148,292,11,17,702,579,123,13
16756,2023-11-30 04:00:00,130,292,11,12,632,516,116,13
16757,2023-11-30 05:00:00,133,258,9,17,666,467,199,11
16758,2023-11-30 06:00:00,149,297,8,18,721,627,94,7
16759,2023-11-30 07:00:00,148,257,13,12,586,424,162,7
16760,2023-11-30 08:00:00,146,269,14,17,766,611,155,5
16761,2023-11-30 09:00:00,148,290,13,13,744,534,210,12
16762,2023-11-30 10:00:00,137,294,13,16,559,401,158,9
16763,2023-11-30 11:00:00,123,250,7,17,692,568,124,5
16764,2023-11-30 12:00:00,148,273,13,16,531,429,102,6
16765,2023-11-30 13:00:00,120,251,12,12,503,442,61,13
16766,2023-11-30 14:00:00,149,265,6,19,522,406,116,10
16767,2023-11-30 15:00:00,131,267,5,17,562,480,82,5
16768,2023-11-30 16:00:00,125,260,5,17,600,537,63,13
16769,2023-11-30 17:00:00,121,298,13,19,663,479,184,14
16770,2023-11-30 18:00:00,144,256,6,13,622,437,185,8
16771,2023-11-30 19:00:00,126,269,8,10,546,451,95,14
16772,2023-11-30 20:00:00,129,274,8,17,614,499,115,11
16773,2023-11-30 21:00:00,127,266,10,19,620,548,72,11
16774,2023-11-30 22:00:00,123,294,13,19,606,539,67,14
16775,2023-11-30 23:00:00,125,287,5,15,624,469,155,11
16776,2023-12-01 00:00:00,126,278,13,18,690,490,200,5
16777,2023-12-01 01:00:00,125,285,13,18,700,620,80,11
16778,2023-12-01 02:00:00,132,285,14,15,615,507,108,5
16779,2023-12-01 03:00:00,122,296,12,14,503,426,77,14
16780,2023-12-01 04:00:00,126,259,8,16,542,456,86,5
16781,2023-12-01 05:00:00,131,291,13,12,543,414,129,11
16782,2023-12-01 06:00:00,142,290,12,13,545,400,145,6
16783,2023-12-01 07:00:00,137,253,7,19,779,691,88,10
16784,2023-12-01 08:00:00,130,272,9,19,799,716,83,7
16785,2023-12-01 09:00:00,142,267,9,18,744,532,212,11
16786,2023-12-01 10:00:00,134,271,5,15,761,632,129,9
16787,2023-12-01 11:00:00,127,251,8,18,558,424,134,10
16788,2023-12-01 12:00:00,132,255,12,15,613,470,143,10
16789,2023-12-01 13:00:00,122,269,12,12,587,482,105,12
16790,2023-12-01 14:00:00,138,290,5,14,666,548,118,6
16791,2023-12-01 15:00:00,145,265,12,10,510,390,120,11
16792,2023-12-01 16:00:00,133,253,13,14,742,567,175,9
16793,2023-12-01 17:00:00,132,260,11,15,533,394,139,5
16794,2023-12-01 18:00:00,147,262,9,11,662,581,81,9
16795,2023-12-01 19:00:00,122,265,13,12,633,522,111,14
16796,2023-12-01 20:00:00,126,289,10,12,752,638,114,13
16797,2023-12-01 21:00:00,139,291,6,18,687,483,204,11
16798,2023-12-01 22:00:00,132,289,6,11,799,671,128,5
16799,2023-12-01 23:00:00,135,266,10,13,520,467,53,13
16800,2023-12-02 00:00:00,126,256,5,13,655,492,163,9
16801,2023-12-02 01:00:00,140,279,9,19,580,491,89,10
16802,2023-12-02 02:00:00,132,269,13,13,683,545,138,10
16803,2023-12-02 03:00:00,131,278,6,10,749,662,87,7
16804,2023-12-02 04:00:00,121,251,6,13,791,661,130,10
16805,2023-12-02 05:00:00,147,257,6,13,638,573,65,8
16806,2023-12-02 06:00:00,134,274,10,11,761,641,120,13
16807,2023-12-02 07:00:00,130,256,6,13,607,497,110,6
16808,2023-12-02 08:00:00,133,267,8,13,742,622,120,13
16809,2023-12-02 09:00:00,136,268,8,11,567,433,134,9
16810,2023-12-02 10:00:00,132,263,5,14,594,522,72,13
16811,2023-12-02 11:00:00,127,296,13,11,649,494,155,11
16812,2023-12-02 12:00:00,134,277,13,17,719,518,201,5
16813,2023-12-02 13:00:00,135,294,12,11,571,501,70,6
16814,2023-12-02 14:00:00,120,279,14,10,653,491,162,11
16815,2023-12-02 15:00:00,133,292,5,19,781,548,233,11
16816,2023-12-02 16:00:00,121,274,5,15,675,477,198,12
16817,2023-12-02 17:00:00,134,255,10,14,589,478,111,14
16818,2023-12-02 18:00:00,126,265,9,12,741,578,163,8
16819,2023-12-02 19:00:00,122,266,7,10,777,587,190,10
16820,2023-12-02 20:00:00,144,276,8,18,774,589,185,5
16821,2023-12-02 21:00:00,133,286,5,14,506,424,82,10
16822,2023-12-02 22:00:00,133,295,11,16,695,582,113,5
16823,2023-12-02 23:00:00,138,269,13,10,668,522,146,9
16824,2023-12-03 00:00:00,140,262,6,12,680,509,171,8
16825,2023-12-03 01:00:00,122,299,13,15,525,438,87,13
16826,2023-12-03 02:00:00,149,295,9,19,567,401,166,14
16827,2023-12-03 03:00:00,120,252,5,16,556,488,68,11
16828,2023-12-03 04:00:00,134,252,12,11,513,394,119,9
16829,2023-12-03 05:00:00,132,298,11,12,541,428,113,9
16830,2023-12-03 06:00:00,129,278,14,12,506,382,124,5
16831,2023-12-03 07:00:00,128,258,8,10,645,494,151,12
16832,2023-12-03 08:00:00,123,282,14,13,728,654,74,11
16833,2023-12-03 09:00:00,149,280,6,15,534,467,67,6
16834,2023-12-03 10:00:00,142,299,13,12,607,433,174,11
16835,2023-12-03 11:00:00,133,278,13,17,728,529,199,10
16836,2023-12-03 12:00:00,131,286,11,19,666,478,188,9
16837,2023-12-03 13:00:00,131,283,11,12,546,430,116,10
16838,2023-12-03 14:00:00,136,275,11,15,696,532,164,14
16839,2023-12-03 15:00:00,132,277,5,15,794,562,232,10
16840,2023-12-03 16:00:00,120,261,8,11,651,491,160,12
16841,2023-12-03 17:00:00,138,252,13,15,773,667,106,8
16842,2023-12-03 18:00:00,140,265,8,17,709,625,84,10
16843,2023-12-03 19:00:00,127,288,14,13,557,414,143,14
16844,2023-12-03 20:00:00,131,267,14,17,671,476,195,5
16845,2023-12-03 21:00:00,122,297,8,18,731,537,194,14
16846,2023-12-03 22:00:00,122,267,10,13,505,430,75,8
16847,2023-12-03 23:00:00,133,286,10,17,777,601,176,12
16848,2023-12-04 00:00:00,122,277,14,18,663,482,181,11
16849,2023-12-04 01:00:00,139,281,14,16,577,516,61,9
16850,2023-12-04 02:00:00,147,294,9,13,673,483,190,5
16851,2023-12-04 03:00:00,149,280,13,16,792,697,95,5
16852,2023-12-04 04:00:00,139,298,5,10,507,402,105,5
16853,2023-12-04 05:00:00,149,296,10,14,680,506,174,14
16854,2023-12-04 06:00:00,131,296,9,15,631,448,183,11
16855,2023-12-04 07:00:00,123,261,9,12,504,359,145,10
16856,2023-12-04 08:00:00,131,263,13,17,667,527,140,11
16857,2023-12-04 09:00:00,145,275,9,18,742,601,141,13
16858,2023-12-04 10:00:00,146,257,8,12,668,475,193,6
16859,2023-12-04 11:00:00,127,250,10,16,619,466,153,12
16860,2023-12-04 12:00:00,145,291,14,18,510,395,115,14
16861,2023-12-04 13:00:00,144,281,14,14,710,608,102,13
16862,2023-12-04 14:00:00,136,272,6,16,570,412,158,9
16863,2023-12-04 15:00:00,130,253,12,14,585,510,75,13
16864,2023-12-04 16:00:00,145,293,5,18,774,639,135,12
16865,2023-12-04 17:00:00,143,289,13,18,708,509,199,5
16866,2023-12-04 18:00:00,136,251,13,15,621,554,67,9
16867,2023-12-04 19:00:00,126,260,10,13,754,651,103,13
16868,2023-12-04 20:00:00,128,264,10,14,667,508,159,10
16869,2023-12-04 21:00:00,137,265,11,15,747,570,177,9
16870,2023-12-04 22:00:00,132,266,14,11,780,669,111,10
16871,2023-12-04 23:00:00,125,257,13,13,561,494,67,9
16872,2023-12-05 00:00:00,125,250,7,11,668,560,108,6
16873,2023-12-05 01:00:00,146,297,6,16,562,448,114,12
16874,2023-12-05 02:00:00,145,272,10,13,752,647,105,12
16875,2023-12-05 03:00:00,136,260,11,14,741,599,142,11
16876,2023-12-05 04:00:00,140,271,11,17,505,370,135,12
16877,2023-12-05 05:00:00,129,299,6,14,509,454,55,13
16878,2023-12-05 06:00:00,126,284,8,10,793,695,98,14
16879,2023-12-05 07:00:00,131,282,5,19,637,523,114,7
16880,2023-12-05 08:00:00,127,266,9,12,768,687,81,11
16881,2023-12-05 09:00:00,134,296,12,12,641,539,102,10
16882,2023-12-05 10:00:00,123,280,12,18,781,578,203,8
16883,2023-12-05 11:00:00,144,259,9,18,727,599,128,13
16884,2023-12-05 12:00:00,142,289,6,16,613,436,177,14
16885,2023-12-05 13:00:00,130,250,11,17,534,432,102,5
16886,2023-12-05 14:00:00,121,261,5,18,796,642,154,12
16887,2023-12-05 15:00:00,149,259,7,13,576,486,90,5
16888,2023-12-05 16:00:00,133,259,6,11,622,558,64,5
16889,2023-12-05 17:00:00,137,292,11,14,582,428,154,5
16890,2023-12-05 18:00:00,120,253,7,14,764,636,128,9
16891,2023-12-05 19:00:00,148,251,9,13,554,447,107,5
16892,2023-12-05 20:00:00,129,281,7,12,504,449,55,10
16893,2023-12-05 21:00:00,123,291,8,12,510,396,114,5
16894,2023-12-05 22:00:00,148,284,10,12,586,454,132,8
16895,2023-12-05 23:00:00,127,262,14,17,500,413,87,12
16896,2023-12-06 00:00:00,131,276,11,15,730,514,216,14
16897,2023-12-06 01:00:00,142,298,10,17,513,425,88,13
16898,2023-12-06 02:00:00,125,262,10,10,619,521,98,11
16899,2023-12-06 03:00:00,148,268,6,11,588,451,137,12
16900,2023-12-06 04:00:00,120,253,9,18,728,518,210,5
16901,2023-12-06 05:00:00,133,260,14,19,589,472,117,7
16902,2023-12-06 06:00:00,124,257,10,11,738,594,144,7
16903,2023-12-06 07:00:00,137,262,11,13,629,464,165,12
16904,2023-12-06 08:00:00,125,273,14,15,781,635,146,14
16905,2023-12-06 09:00:00,128,294,8,17,552,490,62,12
16906,2023-12-06 10:00:00,149,285,12,13,575,405,170,10
16907,2023-12-06 11:00:00,149,263,11,15,560,445,115,8
16908,2023-12-06 12:00:00,121,254,13,12,643,568,75,10
16909,2023-12-06 13:00:00,133,289,14,10,750,640,110,5
16910,2023-12-06 14:00:00,125,277,12,11,600,465,135,9
16911,2023-12-06 15:00:00,137,270,10,10,686,590,96,9
16912,2023-12-06 16:00:00,132,263,9,12,527,379,148,14
16913,2023-12-06 17:00:00,141,272,9,14,777,664,113,11
16914,2023-12-06 18:00:00,141,266,14,13,502,386,116,12
16915,2023-12-06 19:00:00,127,263,11,12,777,543,234,9
16916,2023-12-06 20:00:00,145,278,10,10,786,625,161,6
16917,2023-12-06 21:00:00,130,259,11,12,590,488,102,7
16918,2023-12-06 22:00:00,149,299,14,17,580,418,162,13
16919,2023-12-06 23:00:00,141,272,11,11,581,448,133,6
16920,2023-12-07 00:00:00,145,298,13,14,549,468,81,8
16921,2023-12-07 01:00:00,120,250,13,19,777,545,232,6
16922,2023-12-07 02:00:00,139,268,10,18,784,600,184,12
16923,2023-12-07 03:00:00,121,280,5,18,727,646,81,11
16924,2023-12-07 04:00:00,149,272,9,15,742,659,83,13
16925,2023-12-07 05:00:00,120,255,11,14,567,437,130,11
16926,2023-12-07 06:00:00,148,293,13,13,620,465,155,10
16927,2023-12-07 07:00:00,125,275,11,17,700,582,118,8
16928,2023-12-07 08:00:00,148,282,9,19,589,454,135,7
16929,2023-12-07 09:00:00,144,266,14,10,521,448,73,10
16930,2023-12-07 10:00:00,126,285,8,12,570,481,89,5
16931,2023-12-07 11:00:00,126,263,10,11,772,692,80,14
16932,2023-12-07 12:00:00,128,294,14,16,667,517,150,10
16933,2023-12-07 13:00:00,142,283,6,19,588,515,73,5
16934,2023-12-07 14:00:00,137,255,11,19,644,483,161,6
16935,2023-12-07 15:00:00,120,270,13,11,656,546,110,9
16936,2023-12-07 16:00:00,128,282,7,15,676,571,105,8
16937,2023-12-07 17:00:00,128,288,6,11,567,423,144,7
16938,2023-12-07 18:00:00,124,280,8,15,506,363,143,9
16939,2023-12-07 19:00:00,143,288,14,15,564,462,102,5
16940,2023-12-07 20:00:00,132,254,6,17,646,477,169,7
16941,2023-12-07 21:00:00,135,292,8,19,799,663,136,6
16942,2023-12-07 22:00:00,144,264,12,18,678,524,154,6
16943,2023-12-07 23:00:00,120,261,12,16,523,454,69,9
16944,2023-12-08 00:00:00,126,261,8,16,618,545,73,8
16945,2023-12-08 01:00:00,121,257,11,17,529,397,132,14
16946,2023-12-08 02:00:00,122,282,12,15,587,473,114,13
16947,2023-12-08 03:00:00,137,277,5,14,735,564,171,11
16948,2023-12-08 04:00:00,140,264,5,15,668,560,108,7
16949,2023-12-08 05:00:00,134,257,14,19,754,601,153,10
16950,2023-12-08 06:00:00,120,280,9,19,569,419,150,6
16951,2023-12-08 07:00:00,143,266,8,15,670,548,122,14
16952,2023-12-08 08:00:00,126,284,11,15,608,459,149,14
16953,2023-12-08 09:00:00,144,291,8,15,778,691,87,7
16954,2023-12-08 10:00:00,120,273,14,19,548,390,158,11
16955,2023-12-08 11:00:00,141,262,7,18,510,430,80,8
16956,2023-12-08 12:00:00,128,281,6,13,664,483,181,9
16957,2023-12-08 13:00:00,122,253,7,18,780,631,149,6
16958,2023-12-08 14:00:00,123,261,6,13,648,485,163,12
16959,2023-12-08 15:00:00,141,284,14,17,526,438,88,7
16960,2023-12-08 16:00:00,126,254,8,12,654,528,126,14
16961,2023-12-08 17:00:00,131,275,13,10,623,465,158,12
16962,2023-12-08 18:00:00,146,288,5,13,570,406,164,12
16963,2023-12-08 19:00:00,124,268,12,16,571,405,166,12
16964,2023-12-08 20:00:00,135,278,14,10,750,641,109,13
16965,2023-12-08 21:00:00,144,287,9,13,706,527,179,11
16966,2023-12-08 22:00:00,143,255,7,15,769,661,108,5
16967,2023-12-08 23:00:00,140,288,9,12,686,593,93,13
16968,2023-12-09 00:00:00,120,274,11,11,796,579,217,11
16969,2023-12-09 01:00:00,148,265,11,14,535,376,159,12
16970,2023-12-09 02:00:00,132,288,9,17,646,529,117,10
16971,2023-12-09 03:00:00,142,298,11,17,518,426,92,9
16972,2023-12-09 04:00:00,130,292,11,19,670,549,121,12
16973,2023-12-09 05:00:00,122,257,7,15,664,488,176,7
16974,2023-12-09 06:00:00,145,292,7,18,754,672,82,12
16975,2023-12-09 07:00:00,138,269,9,18,566,454,112,5
16976,2023-12-09 08:00:00,127,256,12,19,599,500,99,9
16977,2023-12-09 09:00:00,130,287,9,13,556,425,131,11
16978,2023-12-09 10:00:00,128,267,12,16,509,450,59,10
16979,2023-12-09 11:00:00,142,278,14,10,732,650,82,9
16980,2023-12-09 12:00:00,121,283,7,11,779,585,194,6
16981,2023-12-09 13:00:00,128,294,8,13,647,482,165,14
16982,2023-12-09 14:00:00,144,269,6,16,698,539,159,12
16983,2023-12-09 15:00:00,124,269,10,17,694,537,157,5
16984,2023-12-09 16:00:00,141,282,5,14,769,579,190,9
16985,2023-12-09 17:00:00,125,291,12,15,738,630,108,8
16986,2023-12-09 18:00:00,121,297,9,11,724,591,133,13
16987,2023-12-09 19:00:00,141,294,8,11,699,625,74,9
16988,2023-12-09 20:00:00,136,273,10,15,665,492,173,5
16989,2023-12-09 21:00:00,138,293,11,10,614,534,80,5
16990,2023-12-09 22:00:00,130,265,8,14,718,633,85,12
16991,2023-12-09 23:00:00,144,292,8,18,644,531,113,13
16992,2023-12-10 00:00:00,140,295,11,10,549,415,134,7
16993,2023-12-10 01:00:00,124,252,13,11,616,482,134,7
16994,2023-12-10 02:00:00,143,290,7,14,608,477,131,12
16995,2023-12-10 03:00:00,122,250,5,13,687,557,130,10
16996,2023-12-10 04:00:00,145,278,7,13,798,559,239,5
16997,2023-12-10 05:00:00,129,270,5,19,689,581,108,14
16998,2023-12-10 06:00:00,133,268,12,18,567,489,78,11
16999,2023-12-10 07:00:00,147,280,6,19,676,591,85,7
17000,2023-12-10 08:00:00,143,294,8,18,737,657,80,9
17001,2023-12-10 09:00:00,147,279,12,13,535,418,117,6
17002,2023-12-10 10:00:00,149,263,6,12,602,428,174,11
17003,2023-12-10 11:00:00,144,264,7,15,532,383,149,5
17004,2023-12-10 12:00:00,124,296,5,13,543,421,122,10
17005,2023-12-10 13:00:00,120,295,5,17,641,547,94,6
17006,2023-12-10 14:00:00,149,280,7,15,647,520,127,9
17007,2023-12-10 15:00:00,142,281,10,10,598,482,116,11
17008,2023-12-10 16:00:00,133,285,5,13,655,490,165,8
17009,2023-12-10 17:00:00,123,287,13,13,538,398,140,8
17010,2023-12-10 18:00:00,123,298,8,14,541,437,104,10
17011,2023-12-10 19:00:00,146,278,10,19,705,505,200,12
17012,2023-12-10 20:00:00,120,261,5,12,777,558,219,7
17013,2023-12-10 21:00:00,140,294,12,10,774,618,156,14
17014,2023-12-10 22:00:00,136,256,6,11,524,396,128,8
17015,2023-12-10 23:00:00,137,291,13,16,694,601,93,8
17016,2023-12-11 00:00:00,120,288,5,13,676,503,173,13
17017,2023-12-11 01:00:00,149,282,9,17,585,445,140,14
17018,2023-12-11 02:00:00,120,271,12,11,790,704,86,13
17019,2023-12-11 03:00:00,139,299,12,13,729,604,125,6
17020,2023-12-11 04:00:00,134,260,11,11,672,568,104,14
17021,2023-12-11 05:00:00,121,297,7,15,718,571,147,7
17022,2023-12-11 06:00:00,123,254,10,15,605,508,97,10
17023,2023-12-11 07:00:00,124,269,6,10,761,634,127,7
17024,2023-12-11 08:00:00,128,261,5,10,574,482,92,12
17025,2023-12-11 09:00:00,125,274,11,17,710,500,210,8
17026,2023-12-11 10:00:00,137,253,9,17,687,578,109,13
17027,2023-12-11 11:00:00,140,269,12,16,680,561,119,6
17028,2023-12-11 12:00:00,125,296,13,17,560,503,57,14
17029,2023-12-11 13:00:00,138,288,13,18,653,484,169,13
17030,2023-12-11 14:00:00,143,272,6,13,767,546,221,11
17031,2023-12-11 15:00:00,120,290,8,14,630,488,142,6
17032,2023-12-11 16:00:00,127,299,13,19,795,652,143,12
17033,2023-12-11 17:00:00,127,281,14,16,567,412,155,12
17034,2023-12-11 18:00:00,135,276,8,19,663,527,136,13
17035,2023-12-11 19:00:00,142,268,10,15,706,565,141,8
17036,2023-12-11 20:00:00,134,276,12,19,739,588,151,10
17037,2023-12-11 21:00:00,129,284,5,10,608,441,167,12
17038,2023-12-11 22:00:00,139,270,13,14,672,516,156,8
17039,2023-12-11 23:00:00,132,256,7,15,709,511,198,5
17040,2023-12-12 00:00:00,140,291,6,13,522,441,81,12
17041,2023-12-12 01:00:00,128,279,9,18,629,557,72,5
17042,2023-12-12 02:00:00,141,261,10,18,629,531,98,11
17043,2023-12-12 03:00:00,122,263,13,18,757,533,224,13
17044,2023-12-12 04:00:00,141,250,14,11,720,513,207,7
17045,2023-12-12 05:00:00,124,262,10,14,574,505,69,13
17046,2023-12-12 06:00:00,124,257,10,10,646,577,69,9
17047,2023-12-12 07:00:00,133,253,12,18,794,601,193,13
17048,2023-12-12 08:00:00,139,258,13,17,528,413,115,10
17049,2023-12-12 09:00:00,132,290,6,11,770,616,154,7
17050,2023-12-12 10:00:00,131,294,12,15,622,537,85,9
17051,2023-12-12 11:00:00,136,293,13,14,543,412,131,5
17052,2023-12-12 12:00:00,143,265,13,13,605,475,130,9
17053,2023-12-12 13:00:00,143,294,12,12,685,524,161,5
17054,2023-12-12 14:00:00,133,261,5,16,599,521,78,13
17055,2023-12-12 15:00:00,124,280,7,15,520,450,70,6
17056,2023-12-12 16:00:00,147,287,13,10,691,592,99,7
17057,2023-12-12 17:00:00,130,285,14,12,704,576,128,9
17058,2023-12-12 18:00:00,145,266,14,17,604,476,128,10
17059,2023-12-12 19:00:00,147,253,12,10,717,602,115,10
17060,2023-12-12 20:00:00,136,259,8,11,784,639,145,5
17061,2023-12-12 21:00:00,139,271,14,10,511,407,104,6
17062,2023-12-12 22:00:00,122,289,9,15,537,380,157,8
17063,2023-12-12 23:00:00,146,289,5,16,732,595,137,9
17064,2023-12-13 00:00:00,122,271,11,13,786,635,151,14
17065,2023-12-13 01:00:00,147,278,7,19,791,674,117,14
17066,2023-12-13 02:00:00,147,279,6,11,657,537,120,7
17067,2023-12-13 03:00:00,149,257,9,17,502,411,91,7
17068,2023-12-13 04:00:00,138,288,7,10,574,514,60,9
17069,2023-12-13 05:00:00,148,277,11,11,541,432,109,6
17070,2023-12-13 06:00:00,148,279,11,13,570,412,158,10
17071,2023-12-13 07:00:00,146,264,6,18,730,585,145,14
17072,2023-12-13 08:00:00,148,272,11,14,621,435,186,11
17073,2023-12-13 09:00:00,149,269,9,15,580,446,134,6
17074,2023-12-13 10:00:00,132,275,12,12,542,448,94,7
17075,2023-12-13 11:00:00,135,292,11,14,669,525,144,10
17076,2023-12-13 12:00:00,140,279,12,12,613,448,165,12
17077,2023-12-13 13:00:00,144,299,11,17,713,565,148,9
17078,2023-12-13 14:00:00,130,287,10,14,781,692,89,12
17079,2023-12-13 15:00:00,125,281,12,16,689,511,178,5
17080,2023-12-13 16:00:00,140,273,10,11,717,641,76,5
17081,2023-12-13 17:00:00,140,291,10,19,656,465,191,11
17082,2023-12-13 18:00:00,143,298,13,10,764,641,123,11
17083,2023-12-13 19:00:00,128,296,5,10,554,487,67,13
17084,2023-12-13 20:00:00,140,290,10,12,592,434,158,14
17085,2023-12-13 21:00:00,147,282,14,14,688,593,95,6
17086,2023-12-13 22:00:00,128,250,9,13,721,546,175,8
17087,2023-12-13 23:00:00,135,256,8,19,618,497,121,10
17088,2023-12-14 00:00:00,129,282,14,10,693,568,125,9
17089,2023-12-14 01:00:00,128,284,11,11,786,605,181,11
17090,2023-12-14 02:00:00,136,290,13,17,577,408,169,11
17091,2023-12-14 03:00:00,147,295,7,10,515,445,70,14
17092,2023-12-14 04:00:00,120,291,7,10,762,591,171,12
17093,2023-12-14 05:00:00,139,295,10,19,729,548,181,13
17094,2023-12-14 06:00:00,122,262,13,15,734,518,216,11
17095,2023-12-14 07:00:00,147,298,14,10,624,510,114,6
17096,2023-12-14 08:00:00,124,251,9,14,585,462,123,13
17097,2023-12-14 09:00:00,143,266,8,13,517,464,53,9
17098,2023-12-14 10:00:00,149,294,5,11,629,497,132,14
17099,2023-12-14 11:00:00,148,250,6,11,756,646,110,13
17100,2023-12-14 12:00:00,136,299,7,18,674,581,93,12
17101,2023-12-14 13:00:00,134,273,5,14,685,488,197,7
17102,2023-12-14 14:00:00,137,291,11,11,638,523,115,9
17103,2023-12-14 15:00:00,132,284,13,14,709,627,82,5
17104,2023-12-14 16:00:00,123,276,7,19,580,494,86,8
17105,2023-12-14 17:00:00,146,294,14,11,680,603,77,10
17106,2023-12-14 18:00:00,120,293,10,11,613,509,104,8
17107,2023-12-14 19:00:00,148,295,5,14,644,460,184,14
17108,2023-12-14 20:00:00,125,283,8,18,536,422,114,14
17109,2023-12-14 21:00:00,142,282,12,18,700,569,131,10
17110,2023-12-14 22:00:00,139,266,8,18,648,549,99,9
17111,2023-12-14 23:00:00,124,277,14,19,789,631,158,11
17112,2023-12-15 00:00:00,125,293,13,18,618,449,169,14
17113,2023-12-15 01:00:00,130,252,12,14,774,547,227,6
17114,2023-12-15 02:00:00,127,292,14,12,666,589,77,13
17115,2023-12-15 03:00:00,146,285,7,17,648,467,181,8
17116,2023-12-15 04:00:00,149,267,6,18,509,375,134,14
17117,2023-12-15 05:00:00,122,293,11,15,789,705,84,6
17118,2023-12-15 06:00:00,126,275,9,14,587,525,62,12
17119,2023-12-15 07:00:00,145,268,9,19,701,555,146,10
17120,2023-12-15 08:00:00,136,276,12,14,536,393,143,7
17121,2023-12-15 09:00:00,135,256,6,17,632,492,140,14
17122,2023-12-15 10:00:00,143,297,10,17,516,409,107,8
17123,2023-12-15 11:00:00,132,267,13,14,659,469,190,14
17124,2023-12-15 12:00:00,123,281,13,15,780,610,170,14
17125,2023-12-15 13:00:00,121,262,7,11,695,496,199,12
17126,2023-12-15 14:00:00,129,256,14,16,640,477,163,7
17127,2023-12-15 15:00:00,140,286,11,10,601,526,75,7
17128,2023-12-15 16:00:00,125,278,7,16,759,591,168,12
17129,2023-12-15 17:00:00,141,252,11,13,754,664,90,9
17130,2023-12-15 18:00:00,134,259,13,10,563,456,107,12
17131,2023-12-15 19:00:00,149,296,8,16,602,503,99,13
17132,2023-12-15 20:00:00,149,256,10,19,700,524,176,7
17133,2023-12-15 21:00:00,130,286,9,12,752,653,99,9
17134,2023-12-15 22:00:00,142,261,13,12,697,533,164,6
17135,2023-12-15 23:00:00,144,279,8,13,732,544,188,13
17136,2023-12-16 00:00:00,139,256,5,11,714,594,120,13
17137,2023-12-16 01:00:00,145,252,11,19,668,518,150,8
17138,2023-12-16 02:00:00,148,252,13,16,719,619,100,6
17139,2023-12-16 03:00:00,136,296,10,12,564,502,62,6
17140,2023-12-16 04:00:00,142,279,7,12,701,552,149,10
17141,2023-12-16 05:00:00,134,265,13,18,695,606,89,10
17142,2023-12-16 06:00:00,146,295,5,11,624,534,90,5
17143,2023-12-16 07:00:00,148,274,13,14,523,373,150,10
17144,2023-12-16 08:00:00,145,258,10,17,634,555,79,14
17145,2023-12-16 09:00:00,135,291,8,18,588,417,171,12
17146,2023-12-16 10:00:00,142,278,9,14,669,505,164,7
17147,2023-12-16 11:00:00,148,253,5,16,772,588,184,8
17148,2023-12-16 12:00:00,131,251,5,11,560,402,158,11
17149,2023-12-16 13:00:00,131,253,12,12,519,390,129,5
17150,2023-12-16 14:00:00,146,269,13,15,777,684,93,11
17151,2023-12-16 15:00:00,142,251,9,11,649,456,193,7
17152,2023-12-16 16:00:00,140,268,7,15,640,482,158,5
17153,2023-12-16 17:00:00,138,276,14,13,507,367,140,5
17154,2023-12-16 18:00:00,132,268,8,16,661,484,177,6
17155,2023-12-16 19:00:00,146,271,11,17,777,635,142,10
17156,2023-12-16 20:00:00,120,262,8,19,741,635,106,11
17157,2023-12-16 21:00:00,120,256,13,12,576,503,73,8
17158,2023-12-16 22:00:00,148,277,12,13,580,414,166,13
17159,2023-12-16 23:00:00,123,297,6,11,789,584,205,14
17160,2023-12-17 00:00:00,142,272,5,14,774,559,215,6
17161,2023-12-17 01:00:00,134,285,12,17,533,459,74,8
17162,2023-12-17 02:00:00,145,256,8,10,619,441,178,6
17163,2023-12-17 03:00:00,120,269,5,17,783,560,223,5
17164,2023-12-17 04:00:00,127,253,12,10,618,452,166,8
17165,2023-12-17 05:00:00,136,266,5,16,660,500,160,13
17166,2023-12-17 06:00:00,144,268,12,13,787,662,125,9
17167,2023-12-17 07:00:00,120,264,7,19,585,513,72,11
17168,2023-12-17 08:00:00,123,264,8,15,759,654,105,13
17169,2023-12-17 09:00:00,126,282,7,13,741,575,166,14
17170,2023-12-17 10:00:00,129,271,13,16,575,475,100,9
17171,2023-12-17 11:00:00,132,251,7,18,773,565,208,13
17172,2023-12-17 12:00:00,126,283,6,12,763,623,140,8
17173,2023-12-17 13:00:00,132,265,11,12,617,537,80,9
17174,2023-12-17 14:00:00,149,277,14,14,598,519,79,6
17175,2023-12-17 15:00:00,128,252,10,13,739,596,143,6
17176,2023-12-17 16:00:00,121,259,10,11,540,444,96,6
17177,2023-12-17 17:00:00,134,265,10,19,686,486,200,13
17178,2023-12-17 18:00:00,122,287,8,13,749,543,206,13
17179,2023-12-17 19:00:00,140,261,5,17,520,459,61,11
17180,2023-12-17 20:00:00,149,275,11,17,634,447,187,5
17181,2023-12-17 21:00:00,122,278,12,15,756,617,139,14
17182,2023-12-17 22:00:00,142,267,11,19,569,482,87,5
17183,2023-12-17 23:00:00,138,271,11,12,502,390,112,13
17184,2023-12-18 00:00:00,135,289,7,17,525,426,99,6
17185,2023-12-18 01:00:00,129,268,6,15,732,617,115,6
17186,2023-12-18 02:00:00,127,293,11,15,549,439,110,7
17187,2023-12-18 03:00:00,140,295,14,15,647,458,189,10
17188,2023-12-18 04:00:00,148,255,9,15,656,479,177,5
17189,2023-12-18 05:00:00,125,259,5,17,580,483,97,12
17190,2023-12-18 06:00:00,141,296,7,13,608,484,124,12
17191,2023-12-18 07:00:00,149,259,7,10,522,385,137,6
17192,2023-12-18 08:00:00,144,268,6,11,561,400,161,14
17193,2023-12-18 09:00:00,135,263,13,13,584,466,118,10
17194,2023-12-18 10:00:00,140,271,9,10,558,481,77,7
17195,2023-12-18 11:00:00,143,259,7,18,670,581,89,8
17196,2023-12-18 12:00:00,135,292,13,13,786,552,234,11
17197,2023-12-18 13:00:00,125,298,12,17,795,633,162,11
17198,2023-12-18 14:00:00,148,293,8,13,508,432,76,5
17199,2023-12-18 15:00:00,147,298,14,17,689,554,135,10
17200,2023-12-18 16:00:00,124,251,13,12,532,471,61,7
17201,2023-12-18 17:00:00,128,280,5,10,721,573,148,7
17202,2023-12-18 18:00:00,120,278,10,15,665,538,127,5
17203,2023-12-18 19:00:00,148,266,13,18,653,482,171,13
17204,2023-12-18 20:00:00,146,257,12,14,502,386,116,8
17205,2023-12-18 21:00:00,122,298,11,13,622,555,67,9
17206,2023-12-18 22:00:00,141,263,13,12,734,613,121,12
17207,2023-12-18 23:00:00,138,285,11,19,553,396,157,9
17208,2023-12-19 00:00:00,148,284,13,12,782,637,145,6
17209,2023-12-19 01:00:00,148,269,10,17,755,654,101,13
17210,2023-12-19 02:00:00,138,284,13,15,776,617,159,8
17211,2023-12-19 03:00:00,144,290,10,18,689,603,86,7
17212,2023-12-19 04:00:00,129,269,7,13,522,415,107,8
17213,2023-12-19 05:00:00,123,291,10,15,676,481,195,9
17214,2023-12-19 06:00:00,146,265,11,10,681,573,108,8
17215,2023-12-19 07:00:00,135,263,14,14,758,587,171,12
17216,2023-12-19 08:00:00,136,292,12,13,652,543,109,13
17217,2023-12-19 09:00:00,123,268,11,17,543,402,141,11
17218,2023-12-19 10:00:00,148,275,14,14,603,471,132,11
17219,2023-12-19 11:00:00,145,280,14,18,643,491,152,9
17220,2023-12-19 12:00:00,145,265,14,14,575,408,167,12
17221,2023-12-19 13:00:00,144,258,5,15,794,704,90,10
17222,2023-12-19 14:00:00,140,290,5,19,564,429,135,14
17223,2023-12-19 15:00:00,138,254,14,12,794,613,181,9
17224,2023-12-19 16:00:00,125,265,14,16,733,533,200,8
17225,2023-12-19 17:00:00,132,273,11,14,577,458,119,6
17226,2023-12-19 18:00:00,139,259,9,15,525,461,64,6
17227,2023-12-19 19:00:00,125,280,6,19,675,487,188,6
17228,2023-12-19 20:00:00,141,272,7,16,625,513,112,14
17229,2023-12-19 21:00:00,140,272,8,19,753,672,81,6
17230,2023-12-19 22:00:00,136,250,13,10,741,613,128,11
17231,2023-12-19 23:00:00,136,273,9,11,637,508,129,10
17232,2023-12-20 00:00:00,148,296,5,10,743,635,108,11
17233,2023-12-20 01:00:00,148,279,9,11,744,597,147,8
17234,2023-12-20 02:00:00,128,269,9,17,693,593,100,6
17235,2023-12-20 03:00:00,141,279,13,12,728,611,117,14
17236,2023-12-20 04:00:00,135,296,11,11,506,407,99,6
17237,2023-12-20 05:00:00,133,290,6,11,650,513,137,9
17238,2023-12-20 06:00:00,140,253,7,14,534,466,68,11
17239,2023-12-20 07:00:00,130,281,7,16,658,530,128,5
17240,2023-12-20 08:00:00,129,299,5,12,728,524,204,8
17241,2023-12-20 09:00:00,137,265,9,19,543,450,93,9
17242,2023-12-20 10:00:00,139,282,13,13,704,552,152,5
17243,2023-12-20 11:00:00,147,259,10,18,544,422,122,11
17244,2023-12-20 12:00:00,146,262,6,14,771,553,218,8
17245,2023-12-20 13:00:00,122,270,12,17,733,633,100,10
17246,2023-12-20 14:00:00,142,271,12,12,577,508,69,10
17247,2023-12-20 15:00:00,123,298,7,13,718,562,156,5
17248,2023-12-20 16:00:00,128,281,8,12,633,542,91,8
17249,2023-12-20 17:00:00,140,296,7,15,560,488,72,13
17250,2023-12-20 18:00:00,135,267,11,11,506,375,131,13
17251,2023-12-20 19:00:00,129,286,12,18,632,484,148,6
17252,2023-12-20 20:00:00,147,291,12,19,501,363,138,5
17253,2023-12-20 21:00:00,147,260,12,18,668,506,162,5
17254,2023-12-20 22:00:00,139,290,11,16,514,371,143,13
17255,2023-12-20 23:00:00,133,282,6,19,522,444,78,13
17256,2023-12-21 00:00:00,136,254,12,17,787,604,183,14
17257,2023-12-21 01:00:00,143,287,10,10,565,413,152,8
17258,2023-12-21 02:00:00,144,257,7,11,503,428,75,8
17259,2023-12-21 03:00:00,125,266,10,17,513,421,92,14
17260,2023-12-21 04:00:00,130,251,6,14,674,548,126,9
17261,2023-12-21 05:00:00,134,281,10,12,656,576,80,12
17262,2023-12-21 06:00:00,145,273,11,13,779,638,141,11
17263,2023-12-21 07:00:00,125,285,14,11,570,498,72,12
17264,2023-12-21 08:00:00,138,273,8,13,684,533,151,12
17265,2023-12-21 09:00:00,137,277,6,16,644,555,89,6
17266,2023-12-21 10:00:00,147,269,12,15,503,361,142,7
17267,2023-12-21 11:00:00,142,282,5,12,651,584,67,13
17268,2023-12-21 12:00:00,141,292,11,18,574,456,118,13
17269,2023-12-21 13:00:00,127,265,7,15,687,593,94,7
17270,2023-12-21 14:00:00,128,261,9,10,536,479,57,12
17271,2023-12-21 15:00:00,148,284,12,15,755,634,121,14
17272,2023-12-21 16:00:00,130,272,13,18,689,561,128,8
17273,2023-12-21 17:00:00,120,256,13,15,545,448,97,12
17274,2023-12-21 18:00:00,149,269,6,19,764,537,227,8
17275,2023-12-21 19:00:00,124,280,6,11,716,612,104,11
17276,2023-12-21 20:00:00,125,287,12,17,712,558,154,13
17277,2023-12-21 21:00:00,131,252,8,11,592,507,85,8
17278,2023-12-21 22:00:00,141,261,10,17,658,484,174,7
17279,2023-12-21 23:00:00,133,259,9,13,598,426,172,8
17280,2023-12-22 00:00:00,122,295,9,17,632,527,105,6
17281,2023-12-22 01:00:00,135,286,5,12,648,455,193,9
17282,2023-12-22 02:00:00,142,255,9,15,797,612,185,12
17283,2023-12-22 03:00:00,135,292,13,10,583,437,146,5
17284,2023-12-22 04:00:00,121,263,12,10,693,493,200,14
17285,2023-12-22 05:00:00,148,260,5,16,542,403,139,10
17286,2023-12-22 06:00:00,131,288,9,12,593,520,73,6
17287,2023-12-22 07:00:00,140,272,14,17,736,636,100,9
17288,2023-12-22 08:00:00,129,271,6,19,717,559,158,10
17289,2023-12-22 09:00:00,133,258,12,12,520,441,79,7
17290,2023-12-22 10:00:00,145,292,13,11,794,617,177,10
17291,2023-12-22 11:00:00,137,264,8,13,609,500,109,8
17292,2023-12-22 12:00:00,133,296,10,17,562,456,106,6
17293,2023-12-22 13:00:00,148,288,12,10,591,508,83,11
17294,2023-12-22 14:00:00,135,284,9,19,741,641,100,6
17295,2023-12-22 15:00:00,141,251,13,16,508,420,88,6
17296,2023-12-22 16:00:00,135,251,5,19,642,560,82,13
17297,2023-12-22 17:00:00,130,293,12,12,655,466,189,11
17298,2023-12-22 18:00:00,146,260,5,18,508,451,57,12
17299,2023-12-22 19:00:00,123,278,9,16,589,461,128,8
17300,2023-12-22 20:00:00,141,267,9,15,788,626,162,8
17301,2023-12-22 21:00:00,124,261,14,17,611,502,109,12
17302,2023-12-22 22:00:00,122,292,8,16,778,682,96,12
17303,2023-12-22 23:00:00,123,254,14,14,529,387,142,10
17304,2023-12-23 00:00:00,121,258,10,14,583,485,98,7
17305,2023-12-23 01:00:00,127,266,7,18,785,630,155,8
17306,2023-12-23 02:00:00,129,258,5,11,769,622,147,9
17307,2023-12-23 03:00:00,142,278,6,12,763,674,89,8
17308,2023-12-23 04:00:00,127,278,5,14,703,515,188,8
17309,2023-12-23 05:00:00,121,265,13,17,605,528,77,9
17310,2023-12-23 06:00:00,133,255,10,17,757,585,172,6
17311,2023-12-23 07:00:00,131,283,6,14,526,371,155,5
17312,2023-12-23 08:00:00,142,276,9,11,507,373,134,5
17313,2023-12-23 09:00:00,130,257,10,11,600,526,74,8
17314,2023-12-23 10:00:00,137,266,8,18,505,368,137,7
17315,2023-12-23 11:00:00,128,253,8,11,639,550,89,11
17316,2023-12-23 12:00:00,148,298,14,13,722,613,109,12
17317,2023-12-23 13:00:00,136,268,9,15,505,411,94,6
17318,2023-12-23 14:00:00,138,297,11,14,533,422,111,11
17319,2023-12-23 15:00:00,143,267,11,14,598,497,101,14
17320,2023-12-23 16:00:00,134,257,13,12,557,491,66,12
17321,2023-12-23 17:00:00,132,266,9,14,674,594,80,10
17322,2023-12-23 18:00:00,133,295,14,16,542,428,114,7
17323,2023-12-23 19:00:00,130,266,6,16,516,393,123,7
17324,2023-12-23 20:00:00,129,250,7,13,779,586,193,5
17325,2023-12-23 21:00:00,127,267,11,12,533,454,79,5
17326,2023-12-23 22:00:00,124,289,9,13,634,470,164,8
17327,2023-12-23 23:00:00,127,253,8,17,664,591,73,10
17328,2023-12-24 00:00:00,148,270,10,15,630,527,103,7
17329,2023-12-24 01:00:00,130,262,8,11,665,558,107,5
17330,2023-12-24 02:00:00,123,291,7,10,547,465,82,11
17331,2023-12-24 03:00:00,135,293,11,11,509,393,116,5
17332,2023-12-24 04:00:00,134,268,5,18,566,425,141,12
17333,2023-12-24 05:00:00,131,265,8,17,643,516,127,11
17334,2023-12-24 06:00:00,127,299,6,17,701,562,139,11
17335,2023-12-24 07:00:00,135,278,12,10,590,529,61,7
17336,2023-12-24 08:00:00,138,284,13,19,692,571,121,6
17337,2023-12-24 09:00:00,127,263,14,13,599,511,88,9
17338,2023-12-24 10:00:00,146,273,9,14,610,490,120,8
17339,2023-12-24 11:00:00,130,272,8,10,506,424,82,5
17340,2023-12-24 12:00:00,149,299,8,18,798,690,108,9
17341,2023-12-24 13:00:00,125,283,7,18,751,634,117,14
17342,2023-12-24 14:00:00,141,261,7,17,520,366,154,10
17343,2023-12-24 15:00:00,131,281,9,12,637,536,101,12
17344,2023-12-24 16:00:00,143,270,6,18,703,606,97,8
17345,2023-12-24 17:00:00,141,272,12,12,551,399,152,10
17346,2023-12-24 18:00:00,139,277,11,13,723,554,169,12
17347,2023-12-24 19:00:00,126,281,14,13,627,468,159,12
17348,2023-12-24 20:00:00,146,253,13,17,623,462,161,11
17349,2023-12-24 21:00:00,140,263,9,18,581,411,170,12
17350,2023-12-24 22:00:00,130,257,8,12,716,580,136,10
17351,2023-12-24 23:00:00,122,279,10,19,616,529,87,13
17352,2023-12-25 00:00:00,143,286,10,12,751,577,174,9
17353,2023-12-25 01:00:00,124,281,11,11,752,613,139,12
17354,2023-12-25 02:00:00,131,255,8,19,741,647,94,11
17355,2023-12-25 03:00:00,126,295,10,17,510,405,105,11
17356,2023-12-25 04:00:00,129,298,5,18,616,494,122,6
17357,2023-12-25 05:00:00,144,254,10,12,792,704,88,9
17358,2023-12-25 06:00:00,137,251,14,15,603,471,132,6
17359,2023-12-25 07:00:00,134,292,5,18,629,492,137,8
17360,2023-12-25 08:00:00,126,260,7,14,797,634,163,13
17361,2023-12-25 09:00:00,121,283,14,11,728,617,111,11
17362,2023-12-25 10:00:00,131,284,7,14,523,422,101,10
17363,2023-12-25 11:00:00,146,281,11,15,769,623,146,8
17364,2023-12-25 12:00:00,146,265,8,11,782,566,216,6
17365,2023-12-25 13:00:00,126,280,11,17,502,383,119,12
17366,2023-12-25 14:00:00,123,266,6,17,514,364,150,6
17367,2023-12-25 15:00:00,141,285,5,11,666,562,104,8
17368,2023-12-25 16:00:00,145,293,9,17,729,653,76,12
17369,2023-12-25 17:00:00,143,283,5,11,747,598,149,8
17370,2023-12-25 18:00:00,139,276,13,11,756,558,198,8
17371,2023-12-25 19:00:00,126,251,8,15,542,402,140,8
17372,2023-12-25 20:00:00,140,263,8,15,531,435,96,9
17373,2023-12-25 21:00:00,122,269,9,10,698,620,78,14
17374,2023-12-25 22:00:00,126,252,13,10,742,521,221,10
17375,2023-12-25 23:00:00,146,279,14,16,672,584,88,10
17376,2023-12-26 00:00:00,144,296,7,19,554,440,114,12
17377,2023-12-26 01:00:00,123,266,14,19,772,692,80,11
17378,2023-12-26 02:00:00,126,258,9,12,629,505,124,7
17379,2023-12-26 03:00:00,126,291,8,18,616,482,134,14
17380,2023-12-26 04:00:00,145,282,11,18,789,673,116,12
17381,2023-12-26 05:00:00,147,250,7,12,524,384,140,10
17382,2023-12-26 06:00:00,136,254,13,19,699,532,167,14
17383,2023-12-26 07:00:00,144,282,9,15,670,553,117,11
17384,2023-12-26 08:00:00,132,278,9,17,582,490,92,8
17385,2023-12-26 09:00:00,120,285,14,16,633,493,140,9
17386,2023-12-26 10:00:00,129,268,7,15,595,509,86,5
17387,2023-12-26 11:00:00,136,256,13,18,514,400,114,8
17388,2023-12-26 12:00:00,131,270,8,13,742,597,145,8
17389,2023-12-26 13:00:00,139,258,11,12,595,509,86,14
17390,2023-12-26 14:00:00,122,271,11,12,744,581,163,8
17391,2023-12-26 15:00:00,143,292,10,15,766,679,87,9
17392,2023-12-26 16:00:00,140,260,14,15,727,632,95,7
17393,2023-12-26 17:00:00,140,273,9,14,566,503,63,5
17394,2023-12-26 18:00:00,126,284,12,19,671,575,96,14
17395,2023-12-26 19:00:00,140,253,11,11,583,452,131,14
17396,2023-12-26 20:00:00,141,257,10,10,522,421,101,7
17397,2023-12-26 21:00:00,142,280,11,19,671,474,197,9
17398,2023-12-26 22:00:00,129,280,9,12,799,658,141,11
17399,2023-12-26 23:00:00,124,279,14,15,644,481,163,7
17400,2023-12-27 00:00:00,139,280,13,19,749,660,89,12
17401,2023-12-27 01:00:00,133,279,14,16,546,435,111,9
17402,2023-12-27 02:00:00,137,295,7,16,541,460,81,5
17403,2023-12-27 03:00:00,138,280,11,11,780,572,208,5
17404,2023-12-27 04:00:00,128,288,11,19,516,396,120,10
17405,2023-12-27 05:00:00,141,284,8,10,700,583,117,12
17406,2023-12-27 06:00:00,136,296,14,16,724,609,115,13
17407,2023-12-27 07:00:00,140,276,11,13,744,567,177,9
17408,2023-12-27 08:00:00,137,271,12,10,718,617,101,7
17409,2023-12-27 09:00:00,133,263,13,14,548,419,129,14
17410,2023-12-27 10:00:00,133,253,9,12,729,650,79,12
17411,2023-12-27 11:00:00,136,271,9,18,701,568,133,12
17412,2023-12-27 12:00:00,141,278,12,12,514,420,94,9
17413,2023-12-27 13:00:00,126,268,8,12,505,371,134,12
17414,2023-12-27 14:00:00,130,296,10,16,574,409,165,8
17415,2023-12-27 15:00:00,147,276,13,13,687,553,134,5
17416,2023-12-27 16:00:00,132,265,10,18,588,516,72,14
17417,2023-12-27 17:00:00,139,257,6,19,671,538,133,5
17418,2023-12-27 18:00:00,136,298,6,11,768,595,173,7
17419,2023-12-27 19:00:00,130,265,14,14,587,491,96,11
17420,2023-12-27 20:00:00,134,282,12,19,707,559,148,12
17421,2023-12-27 21:00:00,141,291,10,14,653,479,174,6
17422,2023-12-27 22:00:00,139,299,8,18,759,543,216,5
17423,2023-12-27 23:00:00,134,280,14,12,519,399,120,13
17424,2023-12-28 00:00:00,130,260,9,10,550,403,147,6
17425,2023-12-28 01:00:00,139,281,13,14,785,556,229,5
17426,2023-12-28 02:00:00,130,254,8,12,746,584,162,10
17427,2023-12-28 03:00:00,139,291,7,13,664,498,166,6
17428,2023-12-28 04:00:00,120,255,14,10,524,468,56,10
17429,2023-12-28 05:00:00,130,291,9,17,514,431,83,10
17430,2023-12-28 06:00:00,142,283,10,16,601,476,125,10
17431,2023-12-28 07:00:00,122,289,9,10,738,523,215,5
17432,2023-12-28 08:00:00,137,257,10,12,526,377,149,12
17433,2023-12-28 09:00:00,122,266,13,18,684,513,171,5
17434,2023-12-28 10:00:00,138,270,11,13,707,604,103,8
17435,2023-12-28 11:00:00,146,294,5,19,763,600,163,8
17436,2023-12-28 12:00:00,124,294,10,12,577,442,135,10
17437,2023-12-28 13:00:00,141,286,7,14,528,434,94,13
17438,2023-12-28 14:00:00,130,250,9,14,656,545,111,14
17439,2023-12-28 15:00:00,131,273,13,12,671,509,162,6
17440,2023-12-28 16:00:00,134,262,13,15,767,543,224,14
17441,2023-12-28 17:00:00,128,275,5,13,654,549,105,6
17442,2023-12-28 18:00:00,124,265,10,16,597,448,149,13
17443,2023-12-28 19:00:00,120,257,11,15,587,454,133,5
17444,2023-12-28 20:00:00,129,256,7,10,566,504,62,6
17445,2023-12-28 21:00:00,149,288,6,18,587,460,127,11
17446,2023-12-28 22:00:00,143,272,12,11,569,404,165,9
17447,2023-12-28 23:00:00,125,287,7,16,646,514,132,12
17448,2023-12-29 00:00:00,135,299,7,19,521,420,101,14
17449,2023-12-29 01:00:00,148,261,6,15,589,430,159,14
17450,2023-12-29 02:00:00,138,254,5,18,613,541,72,7
17451,2023-12-29 03:00:00,148,285,13,16,603,481,122,11
17452,2023-12-29 04:00:00,131,281,5,16,670,584,86,11
17453,2023-12-29 05:00:00,121,273,5,17,741,584,157,11
17454,2023-12-29 06:00:00,120,298,10,14,725,594,131,5
17455,2023-12-29 07:00:00,123,293,7,16,661,476,185,5
17456,2023-12-29 08:00:00,125,271,5,10,605,532,73,5
17457,2023-12-29 09:00:00,132,279,14,15,595,520,75,14
17458,2023-12-29 10:00:00,120,297,8,16,777,629,148,6
17459,2023-12-29 11:00:00,131,270,6,19,519,454,65,9
17460,2023-12-29 12:00:00,143,255,12,11,594,423,171,13
17461,2023-12-29 13:00:00,135,260,12,15,506,365,141,9
17462,2023-12-29 14:00:00,143,269,9,11,700,594,106,7
17463,2023-12-29 15:00:00,132,251,9,12,530,402,128,5
17464,2023-12-29 16:00:00,147,283,7,18,776,595,181,11
17465,2023-12-29 17:00:00,124,276,14,19,545,402,143,8
17466,2023-12-29 18:00:00,143,250,13,13,599,499,100,7
17467,2023-12-29 19:00:00,148,268,13,18,564,492,72,11
17468,2023-12-29 20:00:00,146,269,6,17,583,480,103,10
17469,2023-12-29 21:00:00,138,291,6,12,501,449,52,6
17470,2023-12-29 22:00:00,131,251,12,13,636,507,129,9
17471,2023-12-29 23:00:00,127,263,10,16,784,661,123,9
17472,2023-12-30 00:00:00,131,295,8,15,671,510,161,7
17473,2023-12-30 01:00:00,143,264,8,11,559,497,62,14
17474,2023-12-30 02:00:00,149,283,9,13,794,572,222,11
17475,2023-12-30 03:00:00,120,253,10,19,589,514,75,9
17476,2023-12-30 04:00:00,143,255,13,10,568,403,165,11
17477,2023-12-30 05:00:00,143,276,10,18,739,651,88,5
17478,2023-12-30 06:00:00,146,272,13,13,637,539,98,12
17479,2023-12-30 07:00:00,129,253,12,10,723,507,216,7
17480,2023-12-30 08:00:00,131,275,11,11,780,551,229,13
17481,2023-12-30 09:00:00,128,271,6,18,682,566,116,11
17482,2023-12-30 10:00:00,144,268,7,15,759,665,94,9
17483,2023-12-30 11:00:00,142,284,10,13,797,673,124,6
17484,2023-12-30 12:00:00,133,256,14,15,671,554,117,9
17485,2023-12-30 13:00:00,120,292,14,11,521,403,118,10
17486,2023-12-30 14:00:00,131,254,5,10,546,420,126,5
17487,2023-12-30 15:00:00,129,288,6,19,731,579,152,10
17488,2023-12-30 16:00:00,131,294,11,14,655,538,117,6
17489,2023-12-30 17:00:00,128,274,6,19,564,470,94,12
17490,2023-12-30 18:00:00,132,299,11,17,634,554,80,11
17491,2023-12-30 19:00:00,147,298,8,14,749,624,125,13
17492,2023-12-30 20:00:00,138,296,5,11,651,575,76,8
17493,2023-12-30 21:00:00,120,253,6,11,656,508,148,6
17494,2023-12-30 22:00:00,146,293,5,18,644,551,93,11
17495,2023-12-30 23:00:00,134,294,7,16,624,551,73,5
17496,2023-12-31 00:00:00,132,281,13,19,658,494,164,13
17497,2023-12-31 01:00:00,146,283,6,12,797,642,155,12
17498,2023-12-31 02:00:00,134,260,11,11,679,501,178,10
17499,2023-12-31 03:00:00,134,295,5,15,790,582,208,12
17500,2023-12-31 04:00:00,132,298,5,15,512,402,110,13
17501,2023-12-31 05:00:00,135,266,5,11,745,601,144,9
17502,2023-12-31 06:00:00,143,296,12,19,713,636,77,14
17503,2023-12-31 07:00:00,140,254,12,16,508,438,70,6
17504,2023-12-31 08:00:00,148,278,8,18,625,452,173,13
17505,2023-12-31 09:00:00,138,285,10,14,531,467,64,5
17506,2023-12-31 10:00:00,137,294,14,10,508,383,125,13
17507,2023-12-31 11:00:00,126,278,5,19,662,501,161,12
17508,2023-12-31 12:00:00,123,287,7,16,672,478,194,9
17509,2023-12-31 13:00:00,123,265,12,15,584,442,142,12
17510,2023-12-31 14:00:00,121,275,12,18,617,459,158,14
17511,2023-12-31 15:00:00,129,267,9,10,524,420,104,9
17512,2023-12-31 16:00:00,122,289,12,14,726,511,215,12
17513,2023-12-31 17:00:00,126,281,5,16,583,520,63,6
17514,2023-12-31 18:00:00,128,274,13,12,544,397,147,12
17515,2023-12-31 19:00:00,121,279,8,12,717,621,96,5
17516,2023-12-31 20:00:00,141,252,5,18,528,392,136,7
17517,2023-12-31 21:00:00,140,259,12,18,672,512,160,6
17518,2023-12-31 22:00:00,149,254,12,17,718,511,207,11
17519,2023-12-31 23:00:00,144,266,8,13,694,509,185,6
