,Date Time,Doctors (count),Nurses(Count),Doctors on-call (Count),Nurses on-call (Count),Total Hospital Beds (Count),Hospital Beds Open (Count),Hospital Beds Occupied (Count),Ambulances On Duty (Count)
0,2022-01-01 00:00:00,94,147,10,10,680,550,130,14
1,2022-01-01 01:00:00,120,188,6,16,743,591,152,6
2,2022-01-01 02:00:00,59,248,8,10,749,640,109,5
3,2022-01-01 03:00:00,82,293,14,19,783,629,154,9
4,2022-01-01 04:00:00,84,228,5,14,685,563,122,9
5,2022-01-01 05:00:00,108,131,13,11,709,504,205,8
6,2022-01-01 06:00:00,132,191,5,13,609,495,114,9
7,2022-01-01 07:00:00,53,200,9,18,624,496,128,12
8,2022-01-01 08:00:00,119,269,8,10,698,490,208,6
9,2022-01-01 09:00:00,143,231,7,10,681,577,104,5
10,2022-01-01 10:00:00,112,263,8,12,669,584,85,7
11,2022-01-01 11:00:00,93,204,7,13,694,602,92,11
12,2022-01-01 12:00:00,80,124,7,13,711,538,173,5
13,2022-01-01 13:00:00,116,280,8,10,753,632,121,11
14,2022-01-01 14:00:00,130,288,14,16,659,491,168,13
15,2022-01-01 15:00:00,81,113,12,18,615,522,93,13
16,2022-01-01 16:00:00,51,218,13,18,629,553,76,11
17,2022-01-01 17:00:00,93,132,13,14,714,642,72,13
18,2022-01-01 18:00:00,103,129,8,13,509,456,53,12
19,2022-01-01 19:00:00,81,109,12,17,783,665,118,7
20,2022-01-01 20:00:00,86,100,7,15,762,677,85,13
21,2022-01-01 21:00:00,141,268,9,14,797,600,197,8
22,2022-01-01 22:00:00,67,184,7,15,565,459,106,7
23,2022-01-01 23:00:00,72,258,6,16,764,683,81,8
24,2022-01-02 00:00:00,123,189,7,10,703,577,126,6
25,2022-01-02 01:00:00,86,194,13,14,764,672,92,13
26,2022-01-02 02:00:00,137,113,6,18,785,657,128,9
27,2022-01-02 03:00:00,149,222,8,17,627,485,142,5
28,2022-01-02 04:00:00,89,192,9,11,711,563,148,7
29,2022-01-02 05:00:00,95,187,6,16,565,480,85,5
30,2022-01-02 06:00:00,94,113,14,16,778,648,130,13
31,2022-01-02 07:00:00,58,106,6,17,681,506,175,5
32,2022-01-02 08:00:00,74,104,9,11,712,569,143,9
33,2022-01-02 09:00:00,57,205,6,19,580,453,127,9
34,2022-01-02 10:00:00,92,165,9,14,758,678,80,13
35,2022-01-02 11:00:00,85,183,7,11,504,406,98,8
36,2022-01-02 12:00:00,74,286,9,13,725,627,98,14
37,2022-01-02 13:00:00,146,209,8,19,637,512,125,13
38,2022-01-02 14:00:00,135,208,8,16,698,517,181,5
39,2022-01-02 15:00:00,142,236,5,18,777,655,122,8
40,2022-01-02 16:00:00,76,132,8,16,693,490,203,7
41,2022-01-02 17:00:00,70,273,14,17,547,397,150,6
42,2022-01-02 18:00:00,123,283,11,16,627,498,129,8
43,2022-01-02 19:00:00,50,238,12,16,651,579,72,14
44,2022-01-02 20:00:00,57,165,14,12,797,571,226,11
45,2022-01-02 21:00:00,83,112,5,19,592,428,164,5
46,2022-01-02 22:00:00,119,188,7,13,529,380,149,8
47,2022-01-02 23:00:00,56,166,11,15,520,390,130,9
48,2022-01-03 00:00:00,58,125,10,15,593,513,80,12
49,2022-01-03 01:00:00,62,190,11,18,614,507,107,8
50,2022-01-03 02:00:00,132,297,9,11,608,473,135,8
51,2022-01-03 03:00:00,105,252,6,12,709,623,86,10
52,2022-01-03 04:00:00,79,112,11,16,517,437,80,14
53,2022-01-03 05:00:00,114,176,11,19,551,435,116,5
54,2022-01-03 06:00:00,132,279,6,17,664,533,131,8
55,2022-01-03 07:00:00,78,254,12,14,701,553,148,7
56,2022-01-03 08:00:00,118,205,13,11,677,595,82,6
57,2022-01-03 09:00:00,75,252,12,18,507,418,89,11
58,2022-01-03 10:00:00,149,285,11,13,531,408,123,9
59,2022-01-03 11:00:00,116,240,11,11,664,501,163,6
60,2022-01-03 12:00:00,125,214,10,12,667,515,152,14
61,2022-01-03 13:00:00,115,143,10,18,708,590,118,14
62,2022-01-03 14:00:00,90,254,10,15,708,610,98,5
63,2022-01-03 15:00:00,62,193,5,17,708,508,200,8
64,2022-01-03 16:00:00,133,240,11,17,794,694,100,12
65,2022-01-03 17:00:00,123,184,9,15,534,385,149,5
66,2022-01-03 18:00:00,112,179,11,11,633,558,75,12
67,2022-01-03 19:00:00,130,255,7,17,642,473,169,7
68,2022-01-03 20:00:00,109,212,10,14,500,409,91,13
69,2022-01-03 21:00:00,51,257,10,10,777,591,186,8
70,2022-01-03 22:00:00,117,160,10,19,540,388,152,13
71,2022-01-03 23:00:00,89,257,6,17,792,695,97,14
72,2022-01-04 00:00:00,91,245,5,10,656,560,96,8
73,2022-01-04 01:00:00,98,299,11,10,767,656,111,7
74,2022-01-04 02:00:00,115,217,9,15,674,504,170,6
75,2022-01-04 03:00:00,99,124,7,13,793,622,171,9
76,2022-01-04 04:00:00,71,248,14,11,603,508,95,12
77,2022-01-04 05:00:00,61,197,8,10,774,645,129,11
78,2022-01-04 06:00:00,140,103,7,15,525,437,88,8
79,2022-01-04 07:00:00,101,257,12,11,787,676,111,12
80,2022-01-04 08:00:00,107,193,11,12,525,390,135,12
81,2022-01-04 09:00:00,103,128,5,15,546,403,143,10
82,2022-01-04 10:00:00,138,128,10,11,761,634,127,7
83,2022-01-04 11:00:00,83,133,11,18,539,398,141,7
84,2022-01-04 12:00:00,72,164,10,13,791,554,237,9
85,2022-01-04 13:00:00,114,229,7,10,590,477,113,14
86,2022-01-04 14:00:00,68,178,9,17,637,502,135,12
87,2022-01-04 15:00:00,99,187,14,10,549,485,64,6
88,2022-01-04 16:00:00,72,179,7,18,628,545,83,10
89,2022-01-04 17:00:00,77,148,9,11,573,469,104,11
90,2022-01-04 18:00:00,114,245,13,13,622,482,140,5
91,2022-01-04 19:00:00,123,129,8,17,730,563,167,9
92,2022-01-04 20:00:00,101,178,11,18,703,512,191,7
93,2022-01-04 21:00:00,57,240,5,14,602,508,94,5
94,2022-01-04 22:00:00,100,168,14,17,714,559,155,9
95,2022-01-04 23:00:00,85,276,5,11,672,527,145,5
96,2022-01-05 00:00:00,86,130,7,13,713,524,189,8
97,2022-01-05 01:00:00,77,231,6,15,708,510,198,13
98,2022-01-05 02:00:00,79,257,13,12,607,510,97,6
99,2022-01-05 03:00:00,89,177,6,13,586,477,109,9
100,2022-01-05 04:00:00,133,147,6,14,513,392,121,7
101,2022-01-05 05:00:00,67,135,13,13,625,538,87,13
102,2022-01-05 06:00:00,94,138,10,18,697,588,109,11
103,2022-01-05 07:00:00,138,243,8,17,610,468,142,12
104,2022-01-05 08:00:00,66,280,13,10,511,436,75,12
105,2022-01-05 09:00:00,95,181,12,10,779,700,79,12
106,2022-01-05 10:00:00,115,168,10,18,719,643,76,8
107,2022-01-05 11:00:00,149,171,6,11,595,532,63,7
108,2022-01-05 12:00:00,130,212,14,13,566,466,100,9
109,2022-01-05 13:00:00,55,185,13,12,647,462,185,8
110,2022-01-05 14:00:00,64,121,10,11,660,500,160,12
111,2022-01-05 15:00:00,85,148,6,10,677,568,109,10
112,2022-01-05 16:00:00,112,122,6,16,568,455,113,12
113,2022-01-05 17:00:00,64,209,10,11,776,600,176,10
114,2022-01-05 18:00:00,109,258,8,10,532,402,130,13
115,2022-01-05 19:00:00,102,132,12,12,569,454,115,9
116,2022-01-05 20:00:00,67,296,13,10,762,568,194,9
117,2022-01-05 21:00:00,111,187,5,18,604,453,151,13
118,2022-01-05 22:00:00,65,295,10,10,597,453,144,11
119,2022-01-05 23:00:00,139,126,8,13,645,484,161,9
120,2022-01-06 00:00:00,68,151,6,11,568,475,93,12
121,2022-01-06 01:00:00,115,188,5,15,545,381,164,9
122,2022-01-06 02:00:00,64,238,11,14,668,565,103,14
123,2022-01-06 03:00:00,50,195,13,16,547,468,79,14
124,2022-01-06 04:00:00,139,129,9,14,795,681,114,7
125,2022-01-06 05:00:00,72,192,6,15,612,506,106,11
126,2022-01-06 06:00:00,132,202,14,11,755,673,82,8
127,2022-01-06 07:00:00,134,226,8,15,708,554,154,14
128,2022-01-06 08:00:00,72,231,13,19,620,442,178,7
129,2022-01-06 09:00:00,108,105,14,18,651,501,150,9
130,2022-01-06 10:00:00,122,105,12,19,796,698,98,8
131,2022-01-06 11:00:00,149,214,6,17,739,653,86,12
132,2022-01-06 12:00:00,99,201,11,15,678,574,104,10
133,2022-01-06 13:00:00,90,206,12,18,694,614,80,6
134,2022-01-06 14:00:00,126,172,7,18,668,556,112,9
135,2022-01-06 15:00:00,73,161,10,15,758,629,129,12
136,2022-01-06 16:00:00,132,189,10,18,515,425,90,13
137,2022-01-06 17:00:00,145,148,7,11,573,453,120,14
138,2022-01-06 18:00:00,53,116,5,16,687,485,202,5
139,2022-01-06 19:00:00,110,230,13,18,789,576,213,13
140,2022-01-06 20:00:00,57,250,11,19,618,550,68,8
141,2022-01-06 21:00:00,138,279,13,15,727,575,152,12
142,2022-01-06 22:00:00,93,115,9,15,510,435,75,11
143,2022-01-06 23:00:00,93,282,11,14,568,423,145,9
144,2022-01-07 00:00:00,120,106,5,19,611,470,141,10
145,2022-01-07 01:00:00,78,164,7,15,545,490,55,8
146,2022-01-07 02:00:00,78,135,10,11,575,477,98,8
147,2022-01-07 03:00:00,72,226,14,15,665,536,129,8
148,2022-01-07 04:00:00,122,141,9,11,591,479,112,5
149,2022-01-07 05:00:00,79,116,8,16,571,430,141,12
150,2022-01-07 06:00:00,130,291,10,16,624,522,102,9
151,2022-01-07 07:00:00,72,121,14,14,522,373,149,11
152,2022-01-07 08:00:00,147,186,7,17,721,642,79,12
153,2022-01-07 09:00:00,53,216,9,11,544,463,81,14
154,2022-01-07 10:00:00,95,267,6,11,659,523,136,13
155,2022-01-07 11:00:00,78,252,8,12,729,555,174,12
156,2022-01-07 12:00:00,130,239,7,16,535,377,158,10
157,2022-01-07 13:00:00,80,198,8,10,731,588,143,8
158,2022-01-07 14:00:00,109,121,13,15,788,671,117,14
159,2022-01-07 15:00:00,127,214,7,19,783,619,164,9
160,2022-01-07 16:00:00,58,118,7,15,565,430,135,6
161,2022-01-07 17:00:00,61,157,7,19,653,465,188,12
162,2022-01-07 18:00:00,129,145,6,17,736,559,177,5
163,2022-01-07 19:00:00,147,138,11,19,542,456,86,11
164,2022-01-07 20:00:00,99,216,8,18,612,471,141,6
165,2022-01-07 21:00:00,142,147,5,17,558,403,155,12
166,2022-01-07 22:00:00,105,274,11,11,791,571,220,5
167,2022-01-07 23:00:00,102,299,10,12,731,572,159,12
168,2022-01-08 00:00:00,137,298,13,14,722,616,106,7
169,2022-01-08 01:00:00,71,178,13,13,522,416,106,14
170,2022-01-08 02:00:00,76,117,9,19,604,525,79,12
171,2022-01-08 03:00:00,143,277,9,17,793,655,138,12
172,2022-01-08 04:00:00,117,258,10,18,630,479,151,5
173,2022-01-08 05:00:00,81,259,9,17,505,357,148,9
174,2022-01-08 06:00:00,125,154,9,12,769,628,141,5
175,2022-01-08 07:00:00,142,253,10,19,686,517,169,6
176,2022-01-08 08:00:00,57,253,8,18,797,589,208,10
177,2022-01-08 09:00:00,88,270,6,14,625,485,140,14
178,2022-01-08 10:00:00,53,116,10,18,548,459,89,10
179,2022-01-08 11:00:00,120,234,13,11,698,606,92,6
180,2022-01-08 12:00:00,63,119,14,13,701,603,98,7
181,2022-01-08 13:00:00,50,149,10,15,744,622,122,10
182,2022-01-08 14:00:00,68,194,5,15,572,429,143,8
183,2022-01-08 15:00:00,111,197,9,16,620,520,100,5
184,2022-01-08 16:00:00,134,258,10,11,745,613,132,7
185,2022-01-08 17:00:00,99,125,9,16,777,549,228,13
186,2022-01-08 18:00:00,110,106,5,16,532,432,100,6
187,2022-01-08 19:00:00,70,184,12,12,593,476,117,9
188,2022-01-08 20:00:00,109,143,13,19,623,541,82,7
189,2022-01-08 21:00:00,56,158,10,13,778,562,216,8
190,2022-01-08 22:00:00,110,199,14,13,597,468,129,10
191,2022-01-08 23:00:00,72,192,11,11,728,639,89,7
192,2022-01-09 00:00:00,129,151,12,12,504,417,87,9
193,2022-01-09 01:00:00,108,241,13,19,686,515,171,14
194,2022-01-09 02:00:00,104,260,5,12,589,459,130,14
195,2022-01-09 03:00:00,141,207,12,13,579,447,132,14
196,2022-01-09 04:00:00,100,244,5,17,517,445,72,14
197,2022-01-09 05:00:00,148,187,11,16,683,557,126,10
198,2022-01-09 06:00:00,59,103,14,14,705,632,73,11
199,2022-01-09 07:00:00,96,187,10,12,579,429,150,6
200,2022-01-09 08:00:00,85,109,14,15,630,474,156,10
201,2022-01-09 09:00:00,135,100,8,11,772,569,203,8
202,2022-01-09 10:00:00,77,214,14,13,613,491,122,6
203,2022-01-09 11:00:00,88,142,8,12,633,560,73,7
204,2022-01-09 12:00:00,131,233,8,17,524,417,107,7
205,2022-01-09 13:00:00,59,154,13,19,795,630,165,5
206,2022-01-09 14:00:00,87,109,13,15,737,656,81,6
207,2022-01-09 15:00:00,62,100,10,16,576,479,97,6
208,2022-01-09 16:00:00,88,207,9,19,516,444,72,11
209,2022-01-09 17:00:00,90,140,9,12,664,558,106,5
210,2022-01-09 18:00:00,62,184,13,12,577,471,106,6
211,2022-01-09 19:00:00,50,123,13,14,635,529,106,13
212,2022-01-09 20:00:00,76,194,14,10,727,580,147,13
213,2022-01-09 21:00:00,124,243,11,18,783,573,210,9
214,2022-01-09 22:00:00,122,299,14,13,714,570,144,12
215,2022-01-09 23:00:00,134,263,5,12,568,411,157,7
216,2022-01-10 00:00:00,115,193,9,15,545,399,146,6
217,2022-01-10 01:00:00,91,103,12,14,716,601,115,5
218,2022-01-10 02:00:00,55,169,14,12,612,472,140,14
219,2022-01-10 03:00:00,108,221,5,19,546,389,157,10
220,2022-01-10 04:00:00,62,212,7,15,752,551,201,12
221,2022-01-10 05:00:00,118,124,5,10,638,539,99,6
222,2022-01-10 06:00:00,85,279,8,18,708,542,166,14
223,2022-01-10 07:00:00,78,267,6,19,693,543,150,9
224,2022-01-10 08:00:00,118,126,6,10,519,405,114,7
225,2022-01-10 09:00:00,147,266,9,14,572,482,90,14
226,2022-01-10 10:00:00,52,146,5,17,540,428,112,14
227,2022-01-10 11:00:00,112,211,9,16,731,569,162,8
228,2022-01-10 12:00:00,70,233,13,13,524,453,71,12
229,2022-01-10 13:00:00,62,104,5,15,672,569,103,11
230,2022-01-10 14:00:00,73,292,12,12,676,503,173,5
231,2022-01-10 15:00:00,53,298,11,14,750,559,191,9
232,2022-01-10 16:00:00,119,179,14,15,606,505,101,5
233,2022-01-10 17:00:00,99,241,6,14,711,589,122,9
234,2022-01-10 18:00:00,143,125,8,17,599,537,62,11
235,2022-01-10 19:00:00,67,103,13,13,717,531,186,7
236,2022-01-10 20:00:00,78,287,6,19,567,493,74,14
237,2022-01-10 21:00:00,132,235,13,18,510,417,93,12
238,2022-01-10 22:00:00,87,295,13,19,749,650,99,9
239,2022-01-10 23:00:00,108,191,13,19,606,543,63,10
240,2022-01-11 00:00:00,68,263,14,11,505,411,94,14
241,2022-01-11 01:00:00,93,272,7,11,689,614,75,5
242,2022-01-11 02:00:00,51,260,13,11,659,565,94,11
243,2022-01-11 03:00:00,85,209,8,18,787,585,202,14
244,2022-01-11 04:00:00,54,257,7,15,533,402,131,13
245,2022-01-11 05:00:00,110,146,5,16,788,585,203,12
246,2022-01-11 06:00:00,91,154,14,16,746,660,86,10
247,2022-01-11 07:00:00,73,129,8,11,521,365,156,5
248,2022-01-11 08:00:00,106,243,5,18,690,493,197,11
249,2022-01-11 09:00:00,120,231,9,14,662,557,105,5
250,2022-01-11 10:00:00,54,243,5,17,671,589,82,14
251,2022-01-11 11:00:00,100,235,13,18,655,497,158,10
252,2022-01-11 12:00:00,120,248,11,14,704,530,174,12
253,2022-01-11 13:00:00,102,153,8,14,709,580,129,7
254,2022-01-11 14:00:00,103,246,6,14,511,397,114,7
255,2022-01-11 15:00:00,91,106,6,12,638,513,125,5
256,2022-01-11 16:00:00,52,183,7,10,557,500,57,9
257,2022-01-11 17:00:00,60,150,8,12,525,384,141,9
258,2022-01-11 18:00:00,95,295,8,16,628,439,189,8
259,2022-01-11 19:00:00,121,110,5,19,634,472,162,9
260,2022-01-11 20:00:00,124,235,9,12,798,595,203,7
261,2022-01-11 21:00:00,146,191,13,18,783,662,121,10
262,2022-01-11 22:00:00,143,114,14,16,583,444,139,9
263,2022-01-11 23:00:00,63,209,13,12,735,602,133,13
264,2022-01-12 00:00:00,140,113,10,11,788,555,233,12
265,2022-01-12 01:00:00,67,212,9,14,622,440,182,14
266,2022-01-12 02:00:00,142,179,11,16,632,546,86,7
267,2022-01-12 03:00:00,82,152,12,13,575,465,110,11
268,2022-01-12 04:00:00,142,276,7,11,770,690,80,9
269,2022-01-12 05:00:00,51,169,7,16,680,582,98,7
270,2022-01-12 06:00:00,117,154,10,15,529,421,108,5
271,2022-01-12 07:00:00,67,237,8,16,763,629,134,6
272,2022-01-12 08:00:00,101,266,10,17,660,465,195,11
273,2022-01-12 09:00:00,121,102,14,15,774,606,168,13
274,2022-01-12 10:00:00,106,103,11,14,740,573,167,8
275,2022-01-12 11:00:00,114,167,10,17,755,564,191,13
276,2022-01-12 12:00:00,84,216,13,12,727,615,112,11
277,2022-01-12 13:00:00,70,190,8,13,659,587,72,9
278,2022-01-12 14:00:00,99,251,14,10,581,433,148,12
279,2022-01-12 15:00:00,59,171,10,10,681,566,115,8
280,2022-01-12 16:00:00,149,109,14,19,657,523,134,14
281,2022-01-12 17:00:00,83,292,14,11,629,523,106,7
282,2022-01-12 18:00:00,51,100,8,15,786,602,184,7
283,2022-01-12 19:00:00,74,168,9,16,588,451,137,5
284,2022-01-12 20:00:00,80,205,7,19,616,485,131,10
285,2022-01-12 21:00:00,58,149,9,10,596,458,138,12
286,2022-01-12 22:00:00,73,177,13,11,719,613,106,5
287,2022-01-12 23:00:00,138,137,9,10,781,650,131,5
288,2022-01-13 00:00:00,87,103,13,13,667,511,156,5
289,2022-01-13 01:00:00,137,299,6,12,798,689,109,6
290,2022-01-13 02:00:00,74,134,12,18,636,490,146,10
291,2022-01-13 03:00:00,88,228,14,14,547,427,120,7
292,2022-01-13 04:00:00,129,128,11,14,591,477,114,11
293,2022-01-13 05:00:00,67,298,9,10,503,452,51,12
294,2022-01-13 06:00:00,59,175,9,11,595,489,106,14
295,2022-01-13 07:00:00,125,139,5,11,515,412,103,13
296,2022-01-13 08:00:00,130,271,5,12,561,456,105,8
297,2022-01-13 09:00:00,134,108,14,12,781,579,202,13
298,2022-01-13 10:00:00,57,156,10,16,537,437,100,5
299,2022-01-13 11:00:00,61,271,8,10,781,566,215,6
300,2022-01-13 12:00:00,93,151,10,12,799,660,139,13
301,2022-01-13 13:00:00,70,116,10,15,703,509,194,13
302,2022-01-13 14:00:00,111,231,8,12,534,434,100,10
303,2022-01-13 15:00:00,57,141,5,12,568,511,57,10
304,2022-01-13 16:00:00,80,134,9,13,630,557,73,7
305,2022-01-13 17:00:00,132,141,11,15,529,373,156,14
306,2022-01-13 18:00:00,128,217,13,14,773,561,212,11
307,2022-01-13 19:00:00,83,140,13,13,737,661,76,14
308,2022-01-13 20:00:00,69,234,10,14,527,448,79,5
309,2022-01-13 21:00:00,128,151,12,18,635,499,136,5
310,2022-01-13 22:00:00,94,200,7,16,579,516,63,12
311,2022-01-13 23:00:00,131,270,9,16,647,483,164,12
312,2022-01-14 00:00:00,84,225,6,10,764,652,112,14
313,2022-01-14 01:00:00,143,101,12,17,505,419,86,6
314,2022-01-14 02:00:00,147,131,11,14,636,517,119,9
315,2022-01-14 03:00:00,101,142,10,15,551,437,114,14
316,2022-01-14 04:00:00,61,206,12,10,752,539,213,13
317,2022-01-14 05:00:00,112,161,8,16,564,426,138,9
318,2022-01-14 06:00:00,126,184,12,16,740,523,217,6
319,2022-01-14 07:00:00,77,286,7,16,740,536,204,7
320,2022-01-14 08:00:00,57,251,6,18,683,573,110,10
321,2022-01-14 09:00:00,121,265,9,11,614,509,105,7
322,2022-01-14 10:00:00,52,278,6,18,674,605,69,10
323,2022-01-14 11:00:00,132,171,10,18,610,457,153,9
324,2022-01-14 12:00:00,97,220,9,10,796,563,233,9
325,2022-01-14 13:00:00,129,183,12,10,647,479,168,10
326,2022-01-14 14:00:00,102,113,10,13,699,623,76,12
327,2022-01-14 15:00:00,133,140,8,15,507,363,144,6
328,2022-01-14 16:00:00,107,255,8,15,540,469,71,8
329,2022-01-14 17:00:00,122,107,8,17,745,588,157,13
330,2022-01-14 18:00:00,50,245,12,14,507,433,74,9
331,2022-01-14 19:00:00,110,235,12,14,741,643,98,14
332,2022-01-14 20:00:00,114,261,8,19,755,651,104,7
333,2022-01-14 21:00:00,91,266,11,18,753,541,212,10
334,2022-01-14 22:00:00,111,222,12,12,643,575,68,14
335,2022-01-14 23:00:00,121,260,11,10,565,412,153,13
336,2022-01-15 00:00:00,117,133,9,10,549,434,115,12
337,2022-01-15 01:00:00,53,158,11,17,675,582,93,7
338,2022-01-15 02:00:00,63,125,10,19,796,711,85,10
339,2022-01-15 03:00:00,108,152,5,19,701,511,190,12
340,2022-01-15 04:00:00,54,116,5,19,511,396,115,11
341,2022-01-15 05:00:00,78,122,14,11,585,467,118,7
342,2022-01-15 06:00:00,101,234,5,18,543,433,110,10
343,2022-01-15 07:00:00,87,182,8,12,744,572,172,5
344,2022-01-15 08:00:00,53,233,6,12,581,489,92,11
345,2022-01-15 09:00:00,104,288,12,10,632,482,150,9
346,2022-01-15 10:00:00,130,262,5,10,637,452,185,6
347,2022-01-15 11:00:00,60,260,13,15,746,635,111,14
348,2022-01-15 12:00:00,54,148,13,11,671,541,130,6
349,2022-01-15 13:00:00,145,108,6,16,672,510,162,5
350,2022-01-15 14:00:00,95,248,5,17,593,471,122,7
351,2022-01-15 15:00:00,139,249,11,13,667,574,93,11
352,2022-01-15 16:00:00,76,274,9,10,597,418,179,8
353,2022-01-15 17:00:00,127,289,14,14,572,468,104,11
354,2022-01-15 18:00:00,78,257,13,12,628,533,95,7
355,2022-01-15 19:00:00,55,242,13,12,673,508,165,5
356,2022-01-15 20:00:00,54,200,8,15,728,519,209,9
357,2022-01-15 21:00:00,141,283,12,11,642,526,116,13
358,2022-01-15 22:00:00,132,210,13,17,719,515,204,14
359,2022-01-15 23:00:00,81,234,6,13,502,426,76,12
360,2022-01-16 00:00:00,77,266,12,19,731,544,187,13
361,2022-01-16 01:00:00,110,252,10,18,786,557,229,6
362,2022-01-16 02:00:00,96,129,12,10,501,426,75,6
363,2022-01-16 03:00:00,117,269,11,14,592,497,95,9
364,2022-01-16 04:00:00,76,102,11,13,676,600,76,8
365,2022-01-16 05:00:00,53,111,5,18,584,420,164,9
366,2022-01-16 06:00:00,58,137,13,12,600,528,72,5
367,2022-01-16 07:00:00,124,149,7,14,503,376,127,8
368,2022-01-16 08:00:00,125,161,7,11,796,654,142,7
369,2022-01-16 09:00:00,76,120,14,14,579,477,102,8
370,2022-01-16 10:00:00,77,252,12,18,779,657,122,7
371,2022-01-16 11:00:00,114,116,10,18,508,365,143,5
372,2022-01-16 12:00:00,54,238,6,16,668,601,67,5
373,2022-01-16 13:00:00,127,203,13,19,790,602,188,7
374,2022-01-16 14:00:00,61,179,10,14,794,671,123,14
375,2022-01-16 15:00:00,149,269,13,13,641,558,83,12
376,2022-01-16 16:00:00,100,243,9,10,731,552,179,11
377,2022-01-16 17:00:00,142,167,12,19,591,515,76,6
378,2022-01-16 18:00:00,126,131,8,13,586,477,109,10
379,2022-01-16 19:00:00,53,292,11,14,740,531,209,10
380,2022-01-16 20:00:00,111,181,5,12,635,498,137,9
381,2022-01-16 21:00:00,114,229,7,15,766,606,160,14
382,2022-01-16 22:00:00,93,260,12,18,507,439,68,7
383,2022-01-16 23:00:00,147,216,6,13,588,520,68,5
384,2022-01-17 00:00:00,145,236,8,17,571,505,66,9
385,2022-01-17 01:00:00,102,198,12,13,792,575,217,6
386,2022-01-17 02:00:00,144,203,12,18,715,618,97,7
387,2022-01-17 03:00:00,67,251,8,19,610,493,117,9
388,2022-01-17 04:00:00,139,202,12,19,772,576,196,9
389,2022-01-17 05:00:00,117,235,13,14,575,426,149,10
390,2022-01-17 06:00:00,130,241,13,11,715,601,114,12
391,2022-01-17 07:00:00,141,123,12,14,507,398,109,10
392,2022-01-17 08:00:00,50,131,7,15,551,473,78,13
393,2022-01-17 09:00:00,113,207,5,16,706,601,105,6
394,2022-01-17 10:00:00,138,188,7,19,748,640,108,6
395,2022-01-17 11:00:00,129,239,11,18,592,426,166,14
396,2022-01-17 12:00:00,103,140,13,10,697,617,80,14
397,2022-01-17 13:00:00,112,154,6,17,689,499,190,14
398,2022-01-17 14:00:00,88,165,6,15,788,705,83,10
399,2022-01-17 15:00:00,84,179,6,19,623,533,90,5
400,2022-01-17 16:00:00,85,284,14,12,601,435,166,8
401,2022-01-17 17:00:00,130,184,6,13,745,665,80,13
402,2022-01-17 18:00:00,127,196,10,15,634,553,81,5
403,2022-01-17 19:00:00,98,211,8,11,752,672,80,11
404,2022-01-17 20:00:00,104,110,14,11,776,622,154,11
405,2022-01-17 21:00:00,114,186,12,16,571,430,141,13
406,2022-01-17 22:00:00,52,191,10,19,733,627,106,10
407,2022-01-17 23:00:00,77,109,5,16,653,540,113,6
408,2022-01-18 00:00:00,109,228,6,18,670,497,173,9
409,2022-01-18 01:00:00,121,172,5,16,568,425,143,5
410,2022-01-18 02:00:00,98,239,13,19,603,541,62,8
411,2022-01-18 03:00:00,125,146,13,16,527,429,98,6
412,2022-01-18 04:00:00,111,212,8,19,598,468,130,13
413,2022-01-18 05:00:00,79,174,6,13,678,498,180,6
414,2022-01-18 06:00:00,147,211,14,10,507,450,57,7
415,2022-01-18 07:00:00,90,165,11,10,583,423,160,5
416,2022-01-18 08:00:00,93,168,7,11,597,536,61,7
417,2022-01-18 09:00:00,121,256,5,11,603,499,104,12
418,2022-01-18 10:00:00,116,257,13,17,563,451,112,5
419,2022-01-18 11:00:00,59,170,10,11,683,494,189,10
420,2022-01-18 12:00:00,143,219,10,12,573,505,68,5
421,2022-01-18 13:00:00,54,225,12,13,567,509,58,7
422,2022-01-18 14:00:00,94,113,5,16,589,417,172,9
423,2022-01-18 15:00:00,53,288,8,13,760,583,177,13
424,2022-01-18 16:00:00,60,144,8,16,622,459,163,13
425,2022-01-18 17:00:00,90,121,11,17,566,493,73,14
426,2022-01-18 18:00:00,86,108,14,13,747,638,109,14
427,2022-01-18 19:00:00,120,203,7,11,588,481,107,14
428,2022-01-18 20:00:00,67,226,9,10,624,550,74,10
429,2022-01-18 21:00:00,111,105,6,12,664,527,137,6
430,2022-01-18 22:00:00,147,117,12,10,743,556,187,12
431,2022-01-18 23:00:00,118,230,6,19,790,605,185,9
432,2022-01-19 00:00:00,121,204,9,11,516,408,108,9
433,2022-01-19 01:00:00,70,136,13,10,752,568,184,13
434,2022-01-19 02:00:00,123,191,13,17,744,634,110,11
435,2022-01-19 03:00:00,138,183,12,16,697,560,137,10
436,2022-01-19 04:00:00,75,137,12,16,600,481,119,14
437,2022-01-19 05:00:00,61,298,7,17,659,500,159,8
438,2022-01-19 06:00:00,85,227,6,10,688,538,150,8
439,2022-01-19 07:00:00,53,263,12,16,747,612,135,13
440,2022-01-19 08:00:00,143,287,5,19,548,442,106,8
441,2022-01-19 09:00:00,116,111,7,18,663,589,74,13
442,2022-01-19 10:00:00,100,225,14,15,667,477,190,6
443,2022-01-19 11:00:00,99,232,8,13,615,460,155,14
444,2022-01-19 12:00:00,111,289,7,19,592,449,143,14
445,2022-01-19 13:00:00,131,284,7,18,558,413,145,11
446,2022-01-19 14:00:00,134,223,12,10,583,433,150,12
447,2022-01-19 15:00:00,112,150,7,17,768,590,178,11
448,2022-01-19 16:00:00,127,279,5,18,651,486,165,7
449,2022-01-19 17:00:00,148,225,11,10,572,509,63,5
450,2022-01-19 18:00:00,116,215,6,19,676,490,186,6
451,2022-01-19 19:00:00,73,265,14,11,694,551,143,13
452,2022-01-19 20:00:00,147,207,5,10,722,539,183,7
453,2022-01-19 21:00:00,68,287,12,18,503,366,137,6
454,2022-01-19 22:00:00,89,170,6,18,525,430,95,13
455,2022-01-19 23:00:00,52,132,11,18,641,527,114,8
456,2022-01-20 00:00:00,146,140,9,18,580,412,168,8
457,2022-01-20 01:00:00,142,297,6,11,633,558,75,9
458,2022-01-20 02:00:00,119,203,9,13,701,588,113,13
459,2022-01-20 03:00:00,126,170,5,14,629,549,80,6
460,2022-01-20 04:00:00,113,162,13,13,504,439,65,8
461,2022-01-20 05:00:00,73,226,12,19,646,568,78,14
462,2022-01-20 06:00:00,122,253,13,11,649,497,152,13
463,2022-01-20 07:00:00,87,122,5,16,757,590,167,6
464,2022-01-20 08:00:00,93,226,12,18,585,518,67,12
465,2022-01-20 09:00:00,50,237,9,15,669,588,81,8
466,2022-01-20 10:00:00,139,180,9,11,714,573,141,11
467,2022-01-20 11:00:00,96,129,11,14,627,482,145,6
468,2022-01-20 12:00:00,67,245,6,17,791,647,144,8
469,2022-01-20 13:00:00,134,193,6,16,669,473,196,13
470,2022-01-20 14:00:00,99,124,10,19,669,560,109,10
471,2022-01-20 15:00:00,56,242,10,10,724,541,183,13
472,2022-01-20 16:00:00,91,267,5,10,789,606,183,10
473,2022-01-20 17:00:00,131,161,7,12,728,646,82,10
474,2022-01-20 18:00:00,140,263,6,17,752,648,104,13
475,2022-01-20 19:00:00,92,243,6,17,672,480,192,6
476,2022-01-20 20:00:00,73,210,8,11,578,511,67,11
477,2022-01-20 21:00:00,71,113,12,12,564,485,79,6
478,2022-01-20 22:00:00,95,250,11,11,619,500,119,12
479,2022-01-20 23:00:00,81,247,14,18,794,650,144,12
480,2022-01-21 00:00:00,61,136,8,18,704,581,123,14
481,2022-01-21 01:00:00,130,152,8,10,634,484,150,10
482,2022-01-21 02:00:00,113,152,7,19,698,628,70,14
483,2022-01-21 03:00:00,81,132,6,17,726,586,140,14
484,2022-01-21 04:00:00,91,259,13,18,623,538,85,6
485,2022-01-21 05:00:00,143,287,14,15,623,528,95,7
486,2022-01-21 06:00:00,122,183,14,13,609,427,182,9
487,2022-01-21 07:00:00,106,168,6,15,782,550,232,13
488,2022-01-21 08:00:00,80,132,10,13,660,513,147,6
489,2022-01-21 09:00:00,93,291,7,13,707,617,90,14
490,2022-01-21 10:00:00,61,172,6,17,623,503,120,9
491,2022-01-21 11:00:00,51,212,7,11,690,487,203,11
492,2022-01-21 12:00:00,55,160,13,11,514,433,81,11
493,2022-01-21 13:00:00,57,191,5,13,597,478,119,8
494,2022-01-21 14:00:00,73,286,8,18,551,474,77,8
495,2022-01-21 15:00:00,83,188,10,12,788,674,114,14
496,2022-01-21 16:00:00,133,131,14,14,700,614,86,7
497,2022-01-21 17:00:00,124,155,14,13,569,417,152,12
498,2022-01-21 18:00:00,51,115,5,19,681,536,145,11
499,2022-01-21 19:00:00,141,254,14,14,654,561,93,14
500,2022-01-21 20:00:00,64,168,14,10,672,507,165,9
501,2022-01-21 21:00:00,144,282,10,13,535,480,55,5
502,2022-01-21 22:00:00,55,283,14,11,683,564,119,7
503,2022-01-21 23:00:00,101,192,10,10,525,392,133,9
504,2022-01-22 00:00:00,65,174,7,18,531,371,160,11
505,2022-01-22 01:00:00,53,217,14,18,669,501,168,10
506,2022-01-22 02:00:00,88,164,14,15,664,520,144,5
507,2022-01-22 03:00:00,51,235,13,14,590,496,94,13
508,2022-01-22 04:00:00,145,284,5,13,627,554,73,6
509,2022-01-22 05:00:00,100,221,14,19,731,642,89,12
510,2022-01-22 06:00:00,120,156,5,14,500,383,117,5
511,2022-01-22 07:00:00,62,253,5,15,714,601,113,9
512,2022-01-22 08:00:00,100,255,13,14,723,577,146,14
513,2022-01-22 09:00:00,112,268,9,15,781,680,101,13
514,2022-01-22 10:00:00,112,290,9,14,500,351,149,10
515,2022-01-22 11:00:00,141,137,9,12,516,460,56,12
516,2022-01-22 12:00:00,77,251,8,11,501,414,87,14
517,2022-01-22 13:00:00,145,126,8,19,641,573,68,10
518,2022-01-22 14:00:00,71,102,5,14,546,429,117,10
519,2022-01-22 15:00:00,108,273,11,18,558,481,77,13
520,2022-01-22 16:00:00,110,189,14,19,504,453,51,7
521,2022-01-22 17:00:00,84,230,9,10,560,461,99,6
522,2022-01-22 18:00:00,70,212,10,17,607,432,175,13
523,2022-01-22 19:00:00,115,195,11,10,738,641,97,8
524,2022-01-22 20:00:00,103,283,12,18,793,557,236,11
525,2022-01-22 21:00:00,102,287,9,11,548,429,119,11
526,2022-01-22 22:00:00,67,245,6,18,557,490,67,8
527,2022-01-22 23:00:00,95,254,9,18,583,464,119,13
528,2022-01-23 00:00:00,58,117,11,10,550,444,106,7
529,2022-01-23 01:00:00,74,296,14,12,615,547,68,9
530,2022-01-23 02:00:00,113,189,13,11,678,522,156,13
531,2022-01-23 03:00:00,125,204,14,19,590,476,114,9
532,2022-01-23 04:00:00,88,293,6,19,600,535,65,6
533,2022-01-23 05:00:00,73,181,12,10,553,412,141,5
534,2022-01-23 06:00:00,87,296,13,13,527,397,130,8
535,2022-01-23 07:00:00,131,261,13,18,696,530,166,8
536,2022-01-23 08:00:00,57,297,13,10,763,546,217,13
537,2022-01-23 09:00:00,60,122,11,13,619,493,126,8
538,2022-01-23 10:00:00,130,197,9,17,775,605,170,5
539,2022-01-23 11:00:00,145,185,5,16,682,502,180,11
540,2022-01-23 12:00:00,83,185,10,10,791,648,143,11
541,2022-01-23 13:00:00,93,249,13,19,548,454,94,10
542,2022-01-23 14:00:00,62,230,9,16,641,500,141,8
543,2022-01-23 15:00:00,110,215,8,19,552,496,56,11
544,2022-01-23 16:00:00,144,279,14,14,523,468,55,8
545,2022-01-23 17:00:00,90,197,10,13,604,458,146,5
546,2022-01-23 18:00:00,85,297,6,10,743,651,92,9
547,2022-01-23 19:00:00,77,189,6,19,560,489,71,9
548,2022-01-23 20:00:00,116,293,13,13,602,505,97,10
549,2022-01-23 21:00:00,132,206,5,19,663,539,124,11
550,2022-01-23 22:00:00,93,131,6,18,797,662,135,6
551,2022-01-23 23:00:00,116,145,6,14,721,607,114,11
552,2022-01-24 00:00:00,114,224,9,14,536,378,158,8
553,2022-01-24 01:00:00,83,217,9,18,722,644,78,13
554,2022-01-24 02:00:00,61,202,8,11,626,525,101,8
555,2022-01-24 03:00:00,81,247,14,15,570,416,154,6
556,2022-01-24 04:00:00,136,229,5,19,589,420,169,9
557,2022-01-24 05:00:00,83,143,5,19,586,447,139,13
558,2022-01-24 06:00:00,55,111,12,18,745,629,116,8
559,2022-01-24 07:00:00,89,245,9,14,707,506,201,10
560,2022-01-24 08:00:00,59,237,7,16,731,540,191,6
561,2022-01-24 09:00:00,86,219,14,16,768,588,180,14
562,2022-01-24 10:00:00,128,154,7,15,710,594,116,13
563,2022-01-24 11:00:00,119,190,7,11,609,519,90,7
564,2022-01-24 12:00:00,121,263,6,18,640,569,71,14
565,2022-01-24 13:00:00,133,125,12,16,750,662,88,9
566,2022-01-24 14:00:00,83,219,11,19,687,572,115,13
567,2022-01-24 15:00:00,75,288,10,17,611,524,87,11
568,2022-01-24 16:00:00,86,108,10,13,594,475,119,13
569,2022-01-24 17:00:00,130,119,9,15,513,403,110,11
570,2022-01-24 18:00:00,59,173,6,15,679,599,80,10
571,2022-01-24 19:00:00,108,132,6,17,733,620,113,11
572,2022-01-24 20:00:00,70,285,10,16,504,409,95,10
573,2022-01-24 21:00:00,67,117,10,13,574,408,166,5
574,2022-01-24 22:00:00,99,275,10,16,606,436,170,9
575,2022-01-24 23:00:00,81,245,5,12,721,508,213,7
576,2022-01-25 00:00:00,109,224,8,14,707,578,129,11
577,2022-01-25 01:00:00,56,224,5,15,644,496,148,13
578,2022-01-25 02:00:00,84,233,13,18,660,537,123,9
579,2022-01-25 03:00:00,143,266,8,12,517,463,54,7
580,2022-01-25 04:00:00,125,154,13,15,567,468,99,13
581,2022-01-25 05:00:00,93,129,7,11,742,666,76,12
582,2022-01-25 06:00:00,117,249,9,15,647,579,68,12
583,2022-01-25 07:00:00,149,246,8,19,561,393,168,14
584,2022-01-25 08:00:00,135,173,14,12,506,375,131,9
585,2022-01-25 09:00:00,70,294,11,10,623,493,130,10
586,2022-01-25 10:00:00,57,183,7,17,686,567,119,5
587,2022-01-25 11:00:00,106,256,7,11,549,491,58,13
588,2022-01-25 12:00:00,93,158,9,19,537,454,83,7
589,2022-01-25 13:00:00,104,252,10,18,683,495,188,11
590,2022-01-25 14:00:00,57,229,5,11,727,597,130,6
591,2022-01-25 15:00:00,65,154,12,18,654,504,150,11
592,2022-01-25 16:00:00,142,159,10,19,678,496,182,6
593,2022-01-25 17:00:00,81,298,10,14,743,638,105,5
594,2022-01-25 18:00:00,137,206,7,19,748,595,153,10
595,2022-01-25 19:00:00,123,170,8,15,736,555,181,14
596,2022-01-25 20:00:00,68,196,8,13,519,435,84,10
597,2022-01-25 21:00:00,111,121,9,12,776,576,200,12
598,2022-01-25 22:00:00,83,148,14,15,725,637,88,8
599,2022-01-25 23:00:00,67,206,11,17,704,531,173,8
600,2022-01-26 00:00:00,129,194,5,10,795,623,172,12
601,2022-01-26 01:00:00,85,149,6,16,538,378,160,9
602,2022-01-26 02:00:00,106,229,11,13,613,545,68,14
603,2022-01-26 03:00:00,138,119,10,13,585,492,93,13
604,2022-01-26 04:00:00,53,189,14,13,745,554,191,12
605,2022-01-26 05:00:00,59,258,5,17,501,442,59,7
606,2022-01-26 06:00:00,126,185,7,18,606,489,117,8
607,2022-01-26 07:00:00,53,210,6,19,527,412,115,5
608,2022-01-26 08:00:00,82,136,14,13,525,415,110,6
609,2022-01-26 09:00:00,111,209,14,11,637,570,67,10
610,2022-01-26 10:00:00,109,204,14,16,714,621,93,5
611,2022-01-26 11:00:00,131,144,6,18,612,434,178,9
612,2022-01-26 12:00:00,71,204,14,19,763,561,202,12
613,2022-01-26 13:00:00,92,133,8,16,682,569,113,11
614,2022-01-26 14:00:00,80,112,7,12,523,458,65,13
615,2022-01-26 15:00:00,105,294,7,10,514,447,67,14
616,2022-01-26 16:00:00,70,167,8,10,702,577,125,9
617,2022-01-26 17:00:00,70,225,7,19,650,572,78,5
618,2022-01-26 18:00:00,95,148,6,17,716,616,100,6
619,2022-01-26 19:00:00,54,215,10,14,715,509,206,6
620,2022-01-26 20:00:00,54,263,13,12,789,661,128,8
621,2022-01-26 21:00:00,51,245,14,12,760,532,228,5
622,2022-01-26 22:00:00,77,217,7,18,535,446,89,10
623,2022-01-26 23:00:00,67,137,7,13,509,362,147,5
624,2022-01-27 00:00:00,122,141,6,19,680,583,97,6
625,2022-01-27 01:00:00,126,166,14,10,792,574,218,8
626,2022-01-27 02:00:00,72,128,11,19,536,480,56,14
627,2022-01-27 03:00:00,69,234,14,14,562,490,72,14
628,2022-01-27 04:00:00,126,259,8,16,782,581,201,8
629,2022-01-27 05:00:00,125,232,12,11,613,548,65,12
630,2022-01-27 06:00:00,85,153,13,12,780,698,82,5
631,2022-01-27 07:00:00,90,237,12,10,635,557,78,6
632,2022-01-27 08:00:00,55,124,10,17,649,530,119,10
633,2022-01-27 09:00:00,50,275,11,11,503,396,107,12
634,2022-01-27 10:00:00,64,166,5,13,637,449,188,12
635,2022-01-27 11:00:00,107,263,5,11,726,558,168,14
636,2022-01-27 12:00:00,91,230,13,10,558,498,60,5
637,2022-01-27 13:00:00,90,148,7,15,770,618,152,12
638,2022-01-27 14:00:00,76,299,9,13,545,421,124,12
639,2022-01-27 15:00:00,78,113,14,11,641,569,72,12
640,2022-01-27 16:00:00,116,156,9,10,633,539,94,9
641,2022-01-27 17:00:00,101,204,14,14,753,598,155,9
642,2022-01-27 18:00:00,97,161,9,14,751,617,134,10
643,2022-01-27 19:00:00,91,266,14,10,553,470,83,10
644,2022-01-27 20:00:00,105,121,7,18,706,585,121,12
645,2022-01-27 21:00:00,134,255,7,12,773,645,128,6
646,2022-01-27 22:00:00,138,227,8,17,616,479,137,11
647,2022-01-27 23:00:00,57,115,7,18,708,585,123,8
648,2022-01-28 00:00:00,93,196,7,10,726,512,214,10
649,2022-01-28 01:00:00,105,131,9,18,605,442,163,8
650,2022-01-28 02:00:00,142,250,14,19,570,457,113,13
651,2022-01-28 03:00:00,134,284,7,19,694,581,113,9
652,2022-01-28 04:00:00,132,110,5,10,587,427,160,7
653,2022-01-28 05:00:00,70,255,5,13,798,689,109,10
654,2022-01-28 06:00:00,149,149,9,18,570,465,105,12
655,2022-01-28 07:00:00,138,137,11,15,685,506,179,5
656,2022-01-28 08:00:00,116,274,6,17,676,580,96,5
657,2022-01-28 09:00:00,61,128,12,10,790,565,225,10
658,2022-01-28 10:00:00,119,173,12,14,566,445,121,7
659,2022-01-28 11:00:00,93,198,7,10,522,387,135,8
660,2022-01-28 12:00:00,117,266,5,11,664,560,104,12
661,2022-01-28 13:00:00,86,105,13,12,531,402,129,8
662,2022-01-28 14:00:00,102,203,6,13,546,392,154,8
663,2022-01-28 15:00:00,136,282,6,11,515,363,152,11
664,2022-01-28 16:00:00,126,284,7,18,570,412,158,9
665,2022-01-28 17:00:00,60,221,8,12,658,544,114,14
666,2022-01-28 18:00:00,111,283,11,17,573,409,164,14
667,2022-01-28 19:00:00,115,203,7,12,690,572,118,8
668,2022-01-28 20:00:00,62,184,14,14,562,402,160,14
669,2022-01-28 21:00:00,135,135,6,16,501,407,94,6
670,2022-01-28 22:00:00,101,251,11,14,745,610,135,13
671,2022-01-28 23:00:00,60,285,11,12,632,549,83,10
672,2022-01-29 00:00:00,91,188,12,11,694,608,86,13
673,2022-01-29 01:00:00,76,114,13,13,554,413,141,10
674,2022-01-29 02:00:00,64,102,14,14,551,429,122,6
675,2022-01-29 03:00:00,86,164,7,13,571,457,114,13
676,2022-01-29 04:00:00,62,143,11,10,717,555,162,10
677,2022-01-29 05:00:00,107,290,13,14,534,413,121,9
678,2022-01-29 06:00:00,57,274,13,19,558,484,74,7
679,2022-01-29 07:00:00,97,147,11,10,674,539,135,10
680,2022-01-29 08:00:00,119,141,7,19,542,480,62,5
681,2022-01-29 09:00:00,59,276,10,14,680,597,83,9
682,2022-01-29 10:00:00,99,188,14,16,761,632,129,14
683,2022-01-29 11:00:00,69,160,9,19,555,483,72,8
684,2022-01-29 12:00:00,104,155,13,12,664,574,90,9
685,2022-01-29 13:00:00,83,240,6,17,766,558,208,10
686,2022-01-29 14:00:00,62,188,6,17,619,485,134,10
687,2022-01-29 15:00:00,76,239,12,19,764,585,179,7
688,2022-01-29 16:00:00,50,111,6,15,562,440,122,9
689,2022-01-29 17:00:00,137,200,7,12,509,402,107,6
690,2022-01-29 18:00:00,84,267,8,12,773,613,160,9
691,2022-01-29 19:00:00,53,209,7,11,792,678,114,10
692,2022-01-29 20:00:00,58,257,8,19,729,606,123,8
693,2022-01-29 21:00:00,141,239,9,12,623,477,146,7
694,2022-01-29 22:00:00,79,281,13,12,723,557,166,5
695,2022-01-29 23:00:00,100,288,9,11,661,519,142,14
696,2022-01-30 00:00:00,77,278,6,16,741,635,106,12
697,2022-01-30 01:00:00,79,294,5,10,668,583,85,9
698,2022-01-30 02:00:00,110,157,7,15,670,521,149,6
699,2022-01-30 03:00:00,66,280,8,17,641,462,179,7
700,2022-01-30 04:00:00,131,228,6,14,547,420,127,5
701,2022-01-30 05:00:00,54,269,6,14,752,605,147,9
702,2022-01-30 06:00:00,135,285,7,19,721,611,110,13
703,2022-01-30 07:00:00,131,115,14,19,661,558,103,7
704,2022-01-30 08:00:00,149,250,5,15,672,515,157,8
705,2022-01-30 09:00:00,69,217,11,10,614,453,161,14
706,2022-01-30 10:00:00,80,197,5,17,731,616,115,7
707,2022-01-30 11:00:00,128,138,7,12,584,488,96,7
708,2022-01-30 12:00:00,122,128,5,18,563,410,153,9
709,2022-01-30 13:00:00,64,242,8,12,690,547,143,10
710,2022-01-30 14:00:00,66,180,6,14,794,619,175,6
711,2022-01-30 15:00:00,143,167,10,18,708,548,160,8
712,2022-01-30 16:00:00,50,207,5,10,668,540,128,14
713,2022-01-30 17:00:00,89,243,7,14,693,585,108,14
714,2022-01-30 18:00:00,142,167,14,16,703,584,119,14
715,2022-01-30 19:00:00,107,232,6,19,568,455,113,10
716,2022-01-30 20:00:00,134,134,13,19,774,593,181,11
717,2022-01-30 21:00:00,60,174,14,19,590,530,60,13
718,2022-01-30 22:00:00,61,137,5,17,693,543,150,5
719,2022-01-30 23:00:00,55,296,8,19,703,603,100,10
720,2022-01-31 00:00:00,75,145,8,13,733,524,209,7
721,2022-01-31 01:00:00,118,140,5,18,689,528,161,8
722,2022-01-31 02:00:00,103,228,10,14,693,519,174,14
723,2022-01-31 03:00:00,88,294,7,16,537,434,103,10
724,2022-01-31 04:00:00,91,106,10,13,707,602,105,11
725,2022-01-31 05:00:00,117,102,6,10,696,611,85,6
726,2022-01-31 06:00:00,145,138,10,18,553,446,107,13
727,2022-01-31 07:00:00,100,132,13,17,798,583,215,14
728,2022-01-31 08:00:00,116,117,7,18,532,454,78,14
729,2022-01-31 09:00:00,134,275,10,15,589,440,149,12
730,2022-01-31 10:00:00,129,212,12,10,553,413,140,11
731,2022-01-31 11:00:00,149,117,11,14,562,449,113,11
732,2022-01-31 12:00:00,149,256,14,17,728,556,172,14
733,2022-01-31 13:00:00,62,293,9,14,706,606,100,6
734,2022-01-31 14:00:00,97,100,10,17,608,453,155,7
735,2022-01-31 15:00:00,52,179,9,17,621,455,166,11
736,2022-01-31 16:00:00,148,222,12,17,797,585,212,7
737,2022-01-31 17:00:00,136,245,6,19,647,494,153,8
738,2022-01-31 18:00:00,122,230,10,11,554,400,154,6
739,2022-01-31 19:00:00,102,104,9,19,676,498,178,14
740,2022-01-31 20:00:00,132,131,6,16,542,441,101,6
741,2022-01-31 21:00:00,103,169,12,18,641,481,160,13
742,2022-01-31 22:00:00,80,114,10,10,593,508,85,12
743,2022-01-31 23:00:00,92,255,13,15,713,621,92,7
744,2022-02-01 00:00:00,74,234,14,13,571,450,121,6
745,2022-02-01 01:00:00,53,163,12,15,513,385,128,6
746,2022-02-01 02:00:00,110,162,8,12,507,444,63,13
747,2022-02-01 03:00:00,114,143,13,17,591,523,68,5
748,2022-02-01 04:00:00,93,237,6,19,509,429,80,10
749,2022-02-01 05:00:00,87,215,6,16,711,626,85,10
750,2022-02-01 06:00:00,77,175,10,18,677,508,169,9
751,2022-02-01 07:00:00,56,180,12,14,631,491,140,10
752,2022-02-01 08:00:00,51,251,6,11,560,401,159,9
753,2022-02-01 09:00:00,114,145,12,12,682,581,101,11
754,2022-02-01 10:00:00,92,273,6,18,521,395,126,11
755,2022-02-01 11:00:00,132,163,6,16,757,623,134,9
756,2022-02-01 12:00:00,94,240,8,12,593,487,106,10
757,2022-02-01 13:00:00,82,222,11,11,772,616,156,14
758,2022-02-01 14:00:00,51,203,7,11,752,657,95,8
759,2022-02-01 15:00:00,121,113,13,13,792,647,145,11
760,2022-02-01 16:00:00,72,200,8,14,642,556,86,14
761,2022-02-01 17:00:00,76,115,7,17,638,525,113,12
762,2022-02-01 18:00:00,129,207,5,12,671,545,126,11
763,2022-02-01 19:00:00,105,179,8,18,581,482,99,9
764,2022-02-01 20:00:00,84,293,5,10,636,454,182,10
765,2022-02-01 21:00:00,145,178,13,13,697,589,108,8
766,2022-02-01 22:00:00,114,201,9,18,638,537,101,5
767,2022-02-01 23:00:00,149,153,7,14,664,585,79,12
768,2022-02-02 00:00:00,112,283,5,14,513,390,123,13
769,2022-02-02 01:00:00,70,201,9,12,673,531,142,14
770,2022-02-02 02:00:00,83,223,13,13,626,478,148,7
771,2022-02-02 03:00:00,111,253,14,14,533,462,71,12
772,2022-02-02 04:00:00,104,258,9,18,567,475,92,11
773,2022-02-02 05:00:00,83,156,14,15,703,563,140,5
774,2022-02-02 06:00:00,56,197,12,15,592,479,113,13
775,2022-02-02 07:00:00,103,271,7,16,634,504,130,10
776,2022-02-02 08:00:00,69,147,10,12,529,426,103,12
777,2022-02-02 09:00:00,58,108,8,10,727,614,113,12
778,2022-02-02 10:00:00,81,246,9,19,756,555,201,7
779,2022-02-02 11:00:00,139,145,10,16,655,571,84,5
780,2022-02-02 12:00:00,127,126,8,17,737,660,77,9
781,2022-02-02 13:00:00,135,123,10,15,672,479,193,6
782,2022-02-02 14:00:00,79,226,10,19,538,435,103,14
783,2022-02-02 15:00:00,50,261,7,11,616,459,157,6
784,2022-02-02 16:00:00,125,203,14,16,535,445,90,6
785,2022-02-02 17:00:00,133,277,9,12,718,627,91,10
786,2022-02-02 18:00:00,88,205,14,14,724,535,189,6
787,2022-02-02 19:00:00,135,146,8,18,721,575,146,14
788,2022-02-02 20:00:00,85,176,11,14,535,403,132,10
789,2022-02-02 21:00:00,136,261,9,15,537,387,150,8
790,2022-02-02 22:00:00,81,115,6,19,546,403,143,10
791,2022-02-02 23:00:00,109,279,6,15,588,418,170,9
792,2022-02-03 00:00:00,98,230,9,18,606,454,152,7
793,2022-02-03 01:00:00,97,114,13,18,543,396,147,14
794,2022-02-03 02:00:00,115,109,6,18,583,496,87,6
795,2022-02-03 03:00:00,128,137,7,14,692,548,144,13
796,2022-02-03 04:00:00,130,233,11,15,509,364,145,6
797,2022-02-03 05:00:00,130,262,14,19,593,440,153,8
798,2022-02-03 06:00:00,77,281,9,11,612,484,128,12
799,2022-02-03 07:00:00,107,189,7,16,583,514,69,13
800,2022-02-03 08:00:00,103,253,13,19,684,607,77,8
801,2022-02-03 09:00:00,148,268,8,10,509,455,54,12
802,2022-02-03 10:00:00,72,128,13,16,651,564,87,8
803,2022-02-03 11:00:00,107,278,12,16,752,642,110,7
804,2022-02-03 12:00:00,63,255,9,12,607,510,97,7
805,2022-02-03 13:00:00,146,173,5,12,678,544,134,8
806,2022-02-03 14:00:00,90,146,14,16,749,555,194,9
807,2022-02-03 15:00:00,72,275,7,12,625,551,74,10
808,2022-02-03 16:00:00,145,121,12,19,631,537,94,6
809,2022-02-03 17:00:00,73,187,12,19,617,490,127,8
810,2022-02-03 18:00:00,78,195,11,19,798,636,162,10
811,2022-02-03 19:00:00,144,260,14,18,690,533,157,7
812,2022-02-03 20:00:00,120,205,14,13,701,584,117,11
813,2022-02-03 21:00:00,67,162,13,19,690,570,120,6
814,2022-02-03 22:00:00,77,198,11,18,600,497,103,10
815,2022-02-03 23:00:00,116,158,14,15,705,609,96,8
816,2022-02-04 00:00:00,64,188,14,16,713,617,96,8
817,2022-02-04 01:00:00,130,271,12,15,596,440,156,14
818,2022-02-04 02:00:00,72,155,9,15,630,518,112,6
819,2022-02-04 03:00:00,85,211,11,19,657,578,79,14
820,2022-02-04 04:00:00,57,247,14,13,525,409,116,10
821,2022-02-04 05:00:00,80,220,10,12,727,522,205,6
822,2022-02-04 06:00:00,101,126,13,12,755,678,77,13
823,2022-02-04 07:00:00,56,181,14,11,600,480,120,10
824,2022-02-04 08:00:00,143,221,11,18,720,584,136,8
825,2022-02-04 09:00:00,118,220,8,10,528,429,99,12
826,2022-02-04 10:00:00,61,241,5,10,706,620,86,14
827,2022-02-04 11:00:00,59,273,8,12,757,627,130,10
828,2022-02-04 12:00:00,51,193,9,19,737,516,221,12
829,2022-02-04 13:00:00,138,252,6,12,583,422,161,6
830,2022-02-04 14:00:00,135,213,13,11,559,467,92,13
831,2022-02-04 15:00:00,128,131,14,17,614,497,117,11
832,2022-02-04 16:00:00,50,119,11,15,547,390,157,6
833,2022-02-04 17:00:00,61,282,14,17,715,546,169,5
834,2022-02-04 18:00:00,112,115,10,13,778,623,155,14
835,2022-02-04 19:00:00,67,144,10,14,637,563,74,12
836,2022-02-04 20:00:00,133,145,11,13,661,492,169,10
837,2022-02-04 21:00:00,57,240,9,10,794,636,158,9
838,2022-02-04 22:00:00,73,201,5,19,655,476,179,8
839,2022-02-04 23:00:00,128,153,6,16,756,560,196,6
840,2022-02-05 00:00:00,115,289,11,13,732,610,122,11
841,2022-02-05 01:00:00,147,135,13,12,557,465,92,13
842,2022-02-05 02:00:00,103,108,7,15,746,552,194,11
843,2022-02-05 03:00:00,58,193,8,17,524,381,143,11
844,2022-02-05 04:00:00,128,252,8,15,758,569,189,5
845,2022-02-05 05:00:00,144,103,11,13,737,631,106,11
846,2022-02-05 06:00:00,84,293,7,12,722,521,201,7
847,2022-02-05 07:00:00,99,297,9,10,769,680,89,13
848,2022-02-05 08:00:00,52,118,8,10,756,663,93,6
849,2022-02-05 09:00:00,128,230,10,11,647,575,72,12
850,2022-02-05 10:00:00,139,106,9,12,561,438,123,5
851,2022-02-05 11:00:00,75,270,12,15,753,541,212,7
852,2022-02-05 12:00:00,147,199,7,15,619,536,83,13
853,2022-02-05 13:00:00,55,222,13,16,623,504,119,6
854,2022-02-05 14:00:00,142,106,8,15,716,597,119,6
855,2022-02-05 15:00:00,100,266,14,17,631,520,111,6
856,2022-02-05 16:00:00,97,195,13,15,716,611,105,9
857,2022-02-05 17:00:00,139,111,12,17,501,436,65,8
858,2022-02-05 18:00:00,130,176,13,19,774,596,178,8
859,2022-02-05 19:00:00,89,295,5,15,685,493,192,7
860,2022-02-05 20:00:00,56,230,12,13,584,477,107,12
861,2022-02-05 21:00:00,116,270,13,10,681,529,152,5
862,2022-02-05 22:00:00,76,178,13,12,679,546,133,5
863,2022-02-05 23:00:00,112,237,10,11,660,528,132,12
864,2022-02-06 00:00:00,94,135,7,18,501,416,85,5
865,2022-02-06 01:00:00,144,140,13,18,706,541,165,14
866,2022-02-06 02:00:00,130,258,7,12,774,590,184,13
867,2022-02-06 03:00:00,53,279,14,13,645,496,149,13
868,2022-02-06 04:00:00,138,107,13,13,566,478,88,11
869,2022-02-06 05:00:00,88,224,9,17,706,620,86,9
870,2022-02-06 06:00:00,94,214,13,14,772,552,220,8
871,2022-02-06 07:00:00,108,295,9,10,784,612,172,10
872,2022-02-06 08:00:00,121,202,11,12,661,502,159,13
873,2022-02-06 09:00:00,80,130,11,11,674,544,130,10
874,2022-02-06 10:00:00,82,178,14,18,685,614,71,13
875,2022-02-06 11:00:00,141,136,8,17,681,559,122,7
876,2022-02-06 12:00:00,80,123,6,16,608,441,167,6
877,2022-02-06 13:00:00,94,110,8,12,782,628,154,7
878,2022-02-06 14:00:00,145,228,11,16,616,534,82,14
879,2022-02-06 15:00:00,140,269,6,16,688,481,207,8
880,2022-02-06 16:00:00,60,223,11,10,757,649,108,6
881,2022-02-06 17:00:00,60,168,12,12,795,596,199,9
882,2022-02-06 18:00:00,73,181,11,13,604,502,102,10
883,2022-02-06 19:00:00,132,176,8,12,675,485,190,7
884,2022-02-06 20:00:00,98,278,6,18,679,514,165,13
885,2022-02-06 21:00:00,134,250,13,15,656,472,184,13
886,2022-02-06 22:00:00,79,173,9,14,655,466,189,11
887,2022-02-06 23:00:00,131,168,14,14,700,586,114,13
888,2022-02-07 00:00:00,79,107,7,14,547,426,121,7
889,2022-02-07 01:00:00,120,193,12,12,740,597,143,9
890,2022-02-07 02:00:00,127,241,6,19,536,466,70,13
891,2022-02-07 03:00:00,99,166,13,10,584,472,112,14
892,2022-02-07 04:00:00,121,224,6,10,685,523,162,9
893,2022-02-07 05:00:00,86,250,11,15,560,476,84,11
894,2022-02-07 06:00:00,53,125,10,12,581,468,113,12
895,2022-02-07 07:00:00,92,235,13,16,789,676,113,6
896,2022-02-07 08:00:00,104,285,5,17,629,488,141,12
897,2022-02-07 09:00:00,52,207,13,15,632,538,94,5
898,2022-02-07 10:00:00,146,111,7,10,778,558,220,5
899,2022-02-07 11:00:00,146,186,7,16,603,453,150,11
900,2022-02-07 12:00:00,96,147,12,13,671,486,185,8
901,2022-02-07 13:00:00,128,137,8,11,534,444,90,12
902,2022-02-07 14:00:00,141,203,5,13,690,573,117,12
903,2022-02-07 15:00:00,135,119,8,13,753,613,140,11
904,2022-02-07 16:00:00,144,131,8,11,794,599,195,10
905,2022-02-07 17:00:00,101,214,14,19,514,432,82,5
906,2022-02-07 18:00:00,141,272,5,18,628,514,114,11
907,2022-02-07 19:00:00,70,284,10,18,576,505,71,7
908,2022-02-07 20:00:00,128,242,13,15,578,436,142,9
909,2022-02-07 21:00:00,134,190,5,13,683,597,86,7
910,2022-02-07 22:00:00,101,120,7,12,632,446,186,5
911,2022-02-07 23:00:00,88,220,11,13,577,471,106,5
912,2022-02-08 00:00:00,65,228,7,17,685,479,206,8
913,2022-02-08 01:00:00,97,290,7,11,702,535,167,6
914,2022-02-08 02:00:00,114,166,11,12,549,483,66,6
915,2022-02-08 03:00:00,137,103,12,16,654,461,193,8
916,2022-02-08 04:00:00,102,195,12,10,738,548,190,12
917,2022-02-08 05:00:00,130,238,5,18,722,509,213,8
918,2022-02-08 06:00:00,59,212,8,17,596,426,170,14
919,2022-02-08 07:00:00,148,146,8,17,765,628,137,7
920,2022-02-08 08:00:00,146,213,6,19,616,503,113,6
921,2022-02-08 09:00:00,127,249,14,11,752,606,146,10
922,2022-02-08 10:00:00,70,289,11,15,651,462,189,11
923,2022-02-08 11:00:00,118,267,6,10,553,428,125,11
924,2022-02-08 12:00:00,98,219,11,13,745,581,164,6
925,2022-02-08 13:00:00,79,149,6,13,608,517,91,13
926,2022-02-08 14:00:00,109,105,9,14,620,499,121,14
927,2022-02-08 15:00:00,85,205,12,18,625,513,112,8
928,2022-02-08 16:00:00,102,226,10,19,521,444,77,6
929,2022-02-08 17:00:00,123,224,12,15,745,604,141,11
930,2022-02-08 18:00:00,86,263,8,19,661,584,77,12
931,2022-02-08 19:00:00,135,225,14,18,518,382,136,14
932,2022-02-08 20:00:00,107,157,14,16,730,511,219,14
933,2022-02-08 21:00:00,115,101,13,17,784,574,210,14
934,2022-02-08 22:00:00,67,231,7,17,513,409,104,13
935,2022-02-08 23:00:00,95,173,6,19,583,506,77,5
936,2022-02-09 00:00:00,60,232,11,17,536,444,92,6
937,2022-02-09 01:00:00,149,177,12,19,764,625,139,7
938,2022-02-09 02:00:00,53,269,7,14,535,460,75,12
939,2022-02-09 03:00:00,54,220,10,12,786,611,175,14
940,2022-02-09 04:00:00,146,124,5,14,531,443,88,6
941,2022-02-09 05:00:00,63,127,14,11,781,663,118,10
942,2022-02-09 06:00:00,85,204,13,14,549,407,142,9
943,2022-02-09 07:00:00,90,203,5,11,588,474,114,12
944,2022-02-09 08:00:00,86,100,7,10,566,484,82,14
945,2022-02-09 09:00:00,52,271,6,12,627,493,134,10
946,2022-02-09 10:00:00,113,187,13,14,519,417,102,11
947,2022-02-09 11:00:00,131,192,14,12,536,401,135,6
948,2022-02-09 12:00:00,97,152,9,16,725,590,135,8
949,2022-02-09 13:00:00,87,193,8,12,751,599,152,14
950,2022-02-09 14:00:00,120,216,11,16,573,425,148,13
951,2022-02-09 15:00:00,91,107,5,15,570,503,67,10
952,2022-02-09 16:00:00,142,226,11,14,738,646,92,14
953,2022-02-09 17:00:00,95,248,13,15,591,529,62,11
954,2022-02-09 18:00:00,140,126,5,18,601,509,92,13
955,2022-02-09 19:00:00,82,151,12,14,644,511,133,6
956,2022-02-09 20:00:00,124,149,7,15,650,473,177,10
957,2022-02-09 21:00:00,144,160,8,11,662,488,174,10
958,2022-02-09 22:00:00,91,174,9,13,553,418,135,5
959,2022-02-09 23:00:00,50,167,14,13,703,627,76,9
960,2022-02-10 00:00:00,77,231,5,15,662,483,179,14
961,2022-02-10 01:00:00,134,282,13,15,750,616,134,7
962,2022-02-10 02:00:00,82,182,11,14,611,545,66,5
963,2022-02-10 03:00:00,146,293,5,17,513,392,121,6
964,2022-02-10 04:00:00,66,142,14,14,782,619,163,14
965,2022-02-10 05:00:00,75,239,8,11,555,494,61,8
966,2022-02-10 06:00:00,119,187,9,17,534,385,149,10
967,2022-02-10 07:00:00,60,134,9,16,520,444,76,6
968,2022-02-10 08:00:00,103,232,10,13,752,618,134,10
969,2022-02-10 09:00:00,70,224,6,15,719,510,209,6
970,2022-02-10 10:00:00,116,229,6,17,527,436,91,14
971,2022-02-10 11:00:00,66,134,13,13,522,431,91,12
972,2022-02-10 12:00:00,140,248,8,17,542,416,126,6
973,2022-02-10 13:00:00,89,183,8,14,684,544,140,10
974,2022-02-10 14:00:00,137,294,11,12,552,387,165,13
975,2022-02-10 15:00:00,129,279,9,14,517,381,136,13
976,2022-02-10 16:00:00,68,273,8,11,717,564,153,7
977,2022-02-10 17:00:00,129,177,11,12,502,370,132,13
978,2022-02-10 18:00:00,141,121,5,16,775,607,168,8
979,2022-02-10 19:00:00,79,259,10,15,717,591,126,7
980,2022-02-10 20:00:00,70,138,6,16,518,452,66,6
981,2022-02-10 21:00:00,52,191,9,10,727,517,210,10
982,2022-02-10 22:00:00,92,255,11,16,732,557,175,7
983,2022-02-10 23:00:00,139,249,9,14,758,670,88,13
984,2022-02-11 00:00:00,68,190,12,10,516,398,118,11
985,2022-02-11 01:00:00,121,247,10,16,592,492,100,12
986,2022-02-11 02:00:00,74,191,6,13,654,515,139,8
987,2022-02-11 03:00:00,105,199,12,17,736,601,135,7
988,2022-02-11 04:00:00,131,111,11,12,764,561,203,12
989,2022-02-11 05:00:00,114,127,14,19,666,490,176,13
990,2022-02-11 06:00:00,61,101,7,17,708,627,81,14
991,2022-02-11 07:00:00,52,122,13,16,673,599,74,6
992,2022-02-11 08:00:00,55,170,13,18,641,530,111,10
993,2022-02-11 09:00:00,82,159,6,17,598,445,153,13
994,2022-02-11 10:00:00,141,183,13,19,711,516,195,11
995,2022-02-11 11:00:00,90,261,5,19,597,506,91,6
996,2022-02-11 12:00:00,67,208,7,17,667,487,180,14
997,2022-02-11 13:00:00,79,296,14,14,777,679,98,7
998,2022-02-11 14:00:00,114,159,10,12,758,625,133,6
999,2022-02-11 15:00:00,116,145,14,19,658,521,137,7
1000,2022-02-11 16:00:00,95,143,10,14,720,515,205,6
1001,2022-02-11 17:00:00,59,201,11,11,663,580,83,7
1002,2022-02-11 18:00:00,79,152,7,14,515,389,126,5
1003,2022-02-11 19:00:00,139,241,10,19,650,571,79,14
1004,2022-02-11 20:00:00,148,258,9,16,646,541,105,12
1005,2022-02-11 21:00:00,114,160,13,18,712,515,197,6
1006,2022-02-11 22:00:00,130,254,12,10,632,527,105,11
1007,2022-02-11 23:00:00,127,155,12,11,642,452,190,13
1008,2022-02-12 00:00:00,53,145,13,15,509,402,107,6
1009,2022-02-12 01:00:00,83,189,5,13,534,476,58,10
1010,2022-02-12 02:00:00,60,255,11,11,616,434,182,14
1011,2022-02-12 03:00:00,126,280,12,12,580,413,167,11
1012,2022-02-12 04:00:00,110,114,11,12,751,529,222,13
1013,2022-02-12 05:00:00,126,152,6,15,691,536,155,10
1014,2022-02-12 06:00:00,122,111,12,10,626,468,158,14
1015,2022-02-12 07:00:00,90,105,13,12,504,357,147,12
1016,2022-02-12 08:00:00,57,103,14,18,745,590,155,10
1017,2022-02-12 09:00:00,91,252,5,18,543,415,128,8
1018,2022-02-12 10:00:00,67,107,10,18,787,694,93,9
1019,2022-02-12 11:00:00,85,217,11,12,719,532,187,9
1020,2022-02-12 12:00:00,97,174,10,16,571,489,82,7
1021,2022-02-12 13:00:00,83,157,11,19,738,635,103,5
1022,2022-02-12 14:00:00,98,208,14,15,576,418,158,12
1023,2022-02-12 15:00:00,119,125,9,18,727,649,78,6
1024,2022-02-12 16:00:00,117,253,5,14,719,617,102,5
1025,2022-02-12 17:00:00,147,167,9,10,771,572,199,9
1026,2022-02-12 18:00:00,124,179,14,16,646,497,149,8
1027,2022-02-12 19:00:00,90,279,8,14,687,565,122,7
1028,2022-02-12 20:00:00,71,178,8,17,688,600,88,7
1029,2022-02-12 21:00:00,135,236,14,14,703,556,147,12
1030,2022-02-12 22:00:00,82,261,14,13,697,593,104,7
1031,2022-02-12 23:00:00,109,194,5,10,758,677,81,8
1032,2022-02-13 00:00:00,137,230,7,15,766,676,90,13
1033,2022-02-13 01:00:00,84,110,5,13,700,569,131,12
1034,2022-02-13 02:00:00,130,185,7,18,783,620,163,13
1035,2022-02-13 03:00:00,66,279,11,13,700,532,168,7
1036,2022-02-13 04:00:00,84,204,8,12,710,511,199,9
1037,2022-02-13 05:00:00,107,277,6,15,755,628,127,7
1038,2022-02-13 06:00:00,119,166,7,13,520,398,122,6
1039,2022-02-13 07:00:00,71,279,6,16,781,562,219,6
1040,2022-02-13 08:00:00,128,205,13,11,505,382,123,5
1041,2022-02-13 09:00:00,141,223,5,12,624,518,106,12
1042,2022-02-13 10:00:00,108,115,14,18,600,424,176,13
1043,2022-02-13 11:00:00,132,179,10,19,604,465,139,5
1044,2022-02-13 12:00:00,82,112,6,17,541,441,100,14
1045,2022-02-13 13:00:00,115,279,10,17,672,537,135,11
1046,2022-02-13 14:00:00,117,235,9,18,507,421,86,6
1047,2022-02-13 15:00:00,122,202,9,19,501,409,92,5
1048,2022-02-13 16:00:00,141,272,5,17,554,434,120,12
1049,2022-02-13 17:00:00,60,229,5,17,538,417,121,13
1050,2022-02-13 18:00:00,88,131,5,18,555,490,65,10
1051,2022-02-13 19:00:00,135,177,9,16,776,694,82,12
1052,2022-02-13 20:00:00,63,277,11,12,709,509,200,13
1053,2022-02-13 21:00:00,105,137,5,12,567,470,97,12
1054,2022-02-13 22:00:00,79,262,14,12,761,596,165,8
1055,2022-02-13 23:00:00,140,158,5,12,611,474,137,5
1056,2022-02-14 00:00:00,69,135,12,13,656,496,160,6
1057,2022-02-14 01:00:00,114,186,12,13,623,537,86,13
1058,2022-02-14 02:00:00,144,244,13,19,565,485,80,5
1059,2022-02-14 03:00:00,129,239,8,17,683,533,150,7
1060,2022-02-14 04:00:00,124,151,12,13,664,551,113,5
1061,2022-02-14 05:00:00,95,215,12,19,587,421,166,11
1062,2022-02-14 06:00:00,85,142,8,15,588,507,81,8
1063,2022-02-14 07:00:00,104,292,9,19,654,538,116,10
1064,2022-02-14 08:00:00,58,153,12,12,620,529,91,7
1065,2022-02-14 09:00:00,60,181,10,16,524,421,103,8
1066,2022-02-14 10:00:00,61,287,13,11,718,628,90,10
1067,2022-02-14 11:00:00,136,193,5,10,516,426,90,14
1068,2022-02-14 12:00:00,109,120,12,10,560,429,131,12
1069,2022-02-14 13:00:00,121,100,12,13,746,568,178,10
1070,2022-02-14 14:00:00,98,136,12,13,558,492,66,9
1071,2022-02-14 15:00:00,101,180,13,10,753,577,176,7
1072,2022-02-14 16:00:00,88,183,10,12,704,524,180,10
1073,2022-02-14 17:00:00,53,135,12,13,626,555,71,13
1074,2022-02-14 18:00:00,148,269,9,11,526,403,123,9
1075,2022-02-14 19:00:00,56,168,14,17,776,544,232,12
1076,2022-02-14 20:00:00,98,167,8,19,645,547,98,12
1077,2022-02-14 21:00:00,108,227,13,13,719,621,98,11
1078,2022-02-14 22:00:00,89,142,5,10,551,442,109,10
1079,2022-02-14 23:00:00,106,246,10,11,675,544,131,7
1080,2022-02-15 00:00:00,149,234,11,17,645,471,174,11
1081,2022-02-15 01:00:00,56,244,11,13,766,667,99,6
1082,2022-02-15 02:00:00,117,113,12,13,732,632,100,11
1083,2022-02-15 03:00:00,58,253,12,13,764,585,179,8
1084,2022-02-15 04:00:00,71,120,10,13,611,504,107,12
1085,2022-02-15 05:00:00,107,135,10,10,546,441,105,9
1086,2022-02-15 06:00:00,81,270,12,14,549,490,59,5
1087,2022-02-15 07:00:00,139,267,11,17,795,621,174,11
1088,2022-02-15 08:00:00,57,123,12,12,560,426,134,12
1089,2022-02-15 09:00:00,110,138,14,15,676,602,74,6
1090,2022-02-15 10:00:00,79,257,7,15,782,589,193,6
1091,2022-02-15 11:00:00,139,290,11,14,667,540,127,7
1092,2022-02-15 12:00:00,110,200,7,12,738,545,193,12
1093,2022-02-15 13:00:00,77,193,12,17,578,500,78,6
1094,2022-02-15 14:00:00,144,100,12,18,544,472,72,12
1095,2022-02-15 15:00:00,117,292,10,15,732,614,118,11
1096,2022-02-15 16:00:00,113,159,9,12,645,544,101,5
1097,2022-02-15 17:00:00,108,292,6,17,543,452,91,14
1098,2022-02-15 18:00:00,73,263,11,17,734,588,146,9
1099,2022-02-15 19:00:00,111,194,6,11,563,423,140,10
1100,2022-02-15 20:00:00,70,297,8,14,753,607,146,8
1101,2022-02-15 21:00:00,138,216,13,14,644,497,147,9
1102,2022-02-15 22:00:00,132,178,12,17,574,461,113,14
1103,2022-02-15 23:00:00,72,271,13,14,757,664,93,8
1104,2022-02-16 00:00:00,94,247,7,15,674,560,114,11
1105,2022-02-16 01:00:00,108,216,8,11,773,550,223,13
1106,2022-02-16 02:00:00,61,149,10,19,761,594,167,8
1107,2022-02-16 03:00:00,56,127,6,16,709,616,93,14
1108,2022-02-16 04:00:00,130,210,6,14,786,670,116,5
1109,2022-02-16 05:00:00,119,196,13,17,697,504,193,9
1110,2022-02-16 06:00:00,115,102,5,17,563,423,140,5
1111,2022-02-16 07:00:00,117,123,9,12,563,461,102,12
1112,2022-02-16 08:00:00,75,274,6,10,601,429,172,9
1113,2022-02-16 09:00:00,81,124,9,16,591,519,72,9
1114,2022-02-16 10:00:00,79,289,13,17,528,417,111,5
1115,2022-02-16 11:00:00,69,295,14,18,727,637,90,5
1116,2022-02-16 12:00:00,55,225,7,16,777,638,139,11
1117,2022-02-16 13:00:00,144,213,5,11,612,524,88,9
1118,2022-02-16 14:00:00,107,199,12,19,559,471,88,10
1119,2022-02-16 15:00:00,64,169,13,12,796,695,101,12
1120,2022-02-16 16:00:00,115,204,13,18,765,563,202,8
1121,2022-02-16 17:00:00,78,272,11,13,544,423,121,11
1122,2022-02-16 18:00:00,114,282,9,19,755,617,138,11
1123,2022-02-16 19:00:00,112,126,11,14,751,647,104,12
1124,2022-02-16 20:00:00,84,299,6,10,765,667,98,9
1125,2022-02-16 21:00:00,92,100,12,10,789,705,84,10
1126,2022-02-16 22:00:00,64,292,5,15,643,521,122,5
1127,2022-02-16 23:00:00,134,262,12,11,509,403,106,8
1128,2022-02-17 00:00:00,103,133,5,13,689,485,204,6
1129,2022-02-17 01:00:00,104,111,7,10,508,441,67,7
1130,2022-02-17 02:00:00,98,131,5,18,611,472,139,8
1131,2022-02-17 03:00:00,104,167,7,19,638,447,191,8
1132,2022-02-17 04:00:00,149,115,5,16,641,478,163,9
1133,2022-02-17 05:00:00,104,175,10,11,618,450,168,6
1134,2022-02-17 06:00:00,106,287,7,12,587,411,176,5
1135,2022-02-17 07:00:00,66,208,5,11,602,501,101,14
1136,2022-02-17 08:00:00,81,226,7,10,684,488,196,14
1137,2022-02-17 09:00:00,69,170,8,11,610,462,148,7
1138,2022-02-17 10:00:00,60,214,12,17,504,427,77,7
1139,2022-02-17 11:00:00,60,181,13,15,698,519,179,7
1140,2022-02-17 12:00:00,125,164,11,14,632,480,152,6
1141,2022-02-17 13:00:00,112,208,7,12,633,522,111,10
1142,2022-02-17 14:00:00,114,138,6,16,670,575,95,11
1143,2022-02-17 15:00:00,120,168,13,13,622,467,155,12
1144,2022-02-17 16:00:00,56,206,11,13,612,526,86,11
1145,2022-02-17 17:00:00,148,214,7,18,523,392,131,10
1146,2022-02-17 18:00:00,71,107,14,12,516,414,102,13
1147,2022-02-17 19:00:00,97,156,8,14,632,446,186,10
1148,2022-02-17 20:00:00,121,254,5,10,503,438,65,9
1149,2022-02-17 21:00:00,134,168,13,10,694,584,110,10
1150,2022-02-17 22:00:00,111,197,6,16,662,520,142,6
1151,2022-02-17 23:00:00,119,113,8,15,587,450,137,8
1152,2022-02-18 00:00:00,131,273,11,19,799,682,117,11
1153,2022-02-18 01:00:00,92,153,6,18,729,624,105,13
1154,2022-02-18 02:00:00,83,192,6,12,775,634,141,8
1155,2022-02-18 03:00:00,54,103,9,19,755,558,197,8
1156,2022-02-18 04:00:00,122,268,13,18,528,420,108,11
1157,2022-02-18 05:00:00,71,147,5,10,520,402,118,6
1158,2022-02-18 06:00:00,92,253,7,10,754,577,177,9
1159,2022-02-18 07:00:00,93,141,10,15,565,484,81,7
1160,2022-02-18 08:00:00,87,270,6,16,546,481,65,11
1161,2022-02-18 09:00:00,107,182,9,17,741,632,109,10
1162,2022-02-18 10:00:00,63,219,10,11,628,510,118,9
1163,2022-02-18 11:00:00,51,111,7,18,714,604,110,10
1164,2022-02-18 12:00:00,66,198,10,11,738,523,215,8
1165,2022-02-18 13:00:00,66,141,9,14,649,457,192,13
1166,2022-02-18 14:00:00,59,120,12,17,538,423,115,10
1167,2022-02-18 15:00:00,84,179,7,10,604,459,145,14
1168,2022-02-18 16:00:00,135,221,10,11,797,696,101,7
1169,2022-02-18 17:00:00,105,148,11,16,706,543,163,9
1170,2022-02-18 18:00:00,84,134,8,15,512,370,142,5
1171,2022-02-18 19:00:00,98,233,12,14,570,489,81,5
1172,2022-02-18 20:00:00,79,269,14,16,740,566,174,7
1173,2022-02-18 21:00:00,95,276,5,12,790,684,106,12
1174,2022-02-18 22:00:00,146,242,7,17,530,443,87,11
1175,2022-02-18 23:00:00,70,290,8,14,711,574,137,6
1176,2022-02-19 00:00:00,64,175,11,13,700,611,89,13
1177,2022-02-19 01:00:00,52,102,12,15,669,497,172,8
1178,2022-02-19 02:00:00,115,241,13,18,772,668,104,5
1179,2022-02-19 03:00:00,120,265,5,19,569,430,139,8
1180,2022-02-19 04:00:00,136,218,13,18,667,518,149,14
1181,2022-02-19 05:00:00,143,293,12,15,723,633,90,9
1182,2022-02-19 06:00:00,52,243,10,17,548,408,140,11
1183,2022-02-19 07:00:00,93,113,14,18,528,446,82,9
1184,2022-02-19 08:00:00,123,203,10,13,760,649,111,7
1185,2022-02-19 09:00:00,131,266,10,19,737,558,179,14
1186,2022-02-19 10:00:00,128,142,8,19,700,601,99,11
1187,2022-02-19 11:00:00,130,244,5,10,515,408,107,9
1188,2022-02-19 12:00:00,67,177,8,15,771,587,184,12
1189,2022-02-19 13:00:00,51,122,7,17,613,475,138,14
1190,2022-02-19 14:00:00,58,157,10,11,749,591,158,13
1191,2022-02-19 15:00:00,66,223,12,18,597,419,178,9
1192,2022-02-19 16:00:00,126,280,12,13,607,436,171,5
1193,2022-02-19 17:00:00,114,161,12,17,509,413,96,8
1194,2022-02-19 18:00:00,72,147,11,17,532,378,154,6
1195,2022-02-19 19:00:00,68,102,13,19,714,627,87,5
1196,2022-02-19 20:00:00,116,287,11,19,500,365,135,10
1197,2022-02-19 21:00:00,108,188,8,14,615,448,167,14
1198,2022-02-19 22:00:00,76,182,10,11,785,690,95,5
1199,2022-02-19 23:00:00,82,132,10,16,772,621,151,6
1200,2022-02-20 00:00:00,135,115,13,17,678,483,195,6
1201,2022-02-20 01:00:00,141,109,14,16,750,582,168,5
1202,2022-02-20 02:00:00,66,201,12,19,690,575,115,7
1203,2022-02-20 03:00:00,145,148,12,18,670,598,72,12
1204,2022-02-20 04:00:00,108,167,6,14,666,482,184,7
1205,2022-02-20 05:00:00,104,273,12,17,715,611,104,11
1206,2022-02-20 06:00:00,121,177,12,15,589,488,101,10
1207,2022-02-20 07:00:00,108,152,12,11,510,398,112,9
1208,2022-02-20 08:00:00,120,219,14,16,797,567,230,14
1209,2022-02-20 09:00:00,115,215,13,15,631,463,168,8
1210,2022-02-20 10:00:00,140,141,9,15,661,576,85,5
1211,2022-02-20 11:00:00,138,245,9,15,552,464,88,9
1212,2022-02-20 12:00:00,130,274,9,12,625,538,87,14
1213,2022-02-20 13:00:00,133,141,10,18,558,393,165,11
1214,2022-02-20 14:00:00,51,294,11,16,565,489,76,6
1215,2022-02-20 15:00:00,100,221,7,18,710,637,73,14
1216,2022-02-20 16:00:00,57,127,9,19,673,503,170,14
1217,2022-02-20 17:00:00,133,110,12,19,533,373,160,9
1218,2022-02-20 18:00:00,112,242,6,19,629,464,165,5
1219,2022-02-20 19:00:00,79,290,8,15,708,530,178,6
1220,2022-02-20 20:00:00,79,230,13,17,646,560,86,13
1221,2022-02-20 21:00:00,62,261,8,17,689,507,182,13
1222,2022-02-20 22:00:00,149,197,5,17,534,445,89,7
1223,2022-02-20 23:00:00,124,245,10,16,500,378,122,7
1224,2022-02-21 00:00:00,141,299,7,15,593,474,119,12
1225,2022-02-21 01:00:00,111,271,12,11,504,411,93,7
1226,2022-02-21 02:00:00,133,115,11,12,618,507,111,12
1227,2022-02-21 03:00:00,60,263,7,11,636,532,104,9
1228,2022-02-21 04:00:00,65,278,14,17,738,560,178,9
1229,2022-02-21 05:00:00,136,248,10,12,506,430,76,6
1230,2022-02-21 06:00:00,98,129,8,15,732,513,219,11
1231,2022-02-21 07:00:00,61,204,7,13,630,545,85,12
1232,2022-02-21 08:00:00,134,177,7,16,563,433,130,12
1233,2022-02-21 09:00:00,71,207,13,18,693,581,112,13
1234,2022-02-21 10:00:00,56,149,10,15,705,566,139,5
1235,2022-02-21 11:00:00,61,263,7,10,506,430,76,8
1236,2022-02-21 12:00:00,142,132,12,11,623,480,143,7
1237,2022-02-21 13:00:00,76,155,10,12,551,414,137,9
1238,2022-02-21 14:00:00,117,151,14,14,720,520,200,13
1239,2022-02-21 15:00:00,90,227,6,11,634,468,166,10
1240,2022-02-21 16:00:00,130,113,8,19,698,538,160,14
1241,2022-02-21 17:00:00,114,166,14,16,673,594,79,14
1242,2022-02-21 18:00:00,130,133,10,15,745,554,191,12
1243,2022-02-21 19:00:00,72,261,5,19,771,637,134,7
1244,2022-02-21 20:00:00,122,135,7,19,746,632,114,12
1245,2022-02-21 21:00:00,63,292,14,13,534,409,125,6
1246,2022-02-21 22:00:00,55,166,10,14,623,471,152,9
1247,2022-02-21 23:00:00,149,259,5,12,557,459,98,7
1248,2022-02-22 00:00:00,135,295,6,18,662,464,198,8
1249,2022-02-22 01:00:00,97,102,8,13,741,519,222,6
1250,2022-02-22 02:00:00,116,181,8,15,753,671,82,7
1251,2022-02-22 03:00:00,122,198,13,19,640,467,173,9
1252,2022-02-22 04:00:00,86,197,9,16,740,553,187,7
1253,2022-02-22 05:00:00,85,114,6,15,611,459,152,13
1254,2022-02-22 06:00:00,136,272,11,15,610,444,166,9
1255,2022-02-22 07:00:00,119,229,5,13,523,456,67,7
1256,2022-02-22 08:00:00,125,155,8,11,765,538,227,10
1257,2022-02-22 09:00:00,121,225,9,14,704,538,166,9
1258,2022-02-22 10:00:00,72,214,5,16,774,546,228,12
1259,2022-02-22 11:00:00,104,206,6,12,616,524,92,10
1260,2022-02-22 12:00:00,94,257,7,11,618,531,87,5
1261,2022-02-22 13:00:00,119,196,13,13,750,568,182,7
1262,2022-02-22 14:00:00,87,127,10,13,743,641,102,11
1263,2022-02-22 15:00:00,124,232,5,12,620,525,95,13
1264,2022-02-22 16:00:00,66,107,8,16,675,537,138,10
1265,2022-02-22 17:00:00,115,173,5,14,711,582,129,7
1266,2022-02-22 18:00:00,91,276,10,13,516,394,122,12
1267,2022-02-22 19:00:00,50,264,8,16,623,452,171,9
1268,2022-02-22 20:00:00,99,143,12,10,768,549,219,13
1269,2022-02-22 21:00:00,63,120,12,11,691,555,136,9
1270,2022-02-22 22:00:00,86,155,8,18,585,458,127,12
1271,2022-02-22 23:00:00,60,154,5,10,782,618,164,5
1272,2022-02-23 00:00:00,126,248,5,19,629,473,156,12
1273,2022-02-23 01:00:00,141,208,14,14,710,582,128,9
1274,2022-02-23 02:00:00,136,285,9,16,706,597,109,12
1275,2022-02-23 03:00:00,68,221,10,16,643,518,125,5
1276,2022-02-23 04:00:00,124,277,5,18,629,504,125,9
1277,2022-02-23 05:00:00,126,131,7,18,680,508,172,10
1278,2022-02-23 06:00:00,107,226,5,17,636,551,85,7
1279,2022-02-23 07:00:00,107,274,13,13,632,550,82,12
1280,2022-02-23 08:00:00,134,288,6,15,722,545,177,5
1281,2022-02-23 09:00:00,83,191,13,16,797,644,153,10
1282,2022-02-23 10:00:00,125,184,12,12,556,415,141,11
1283,2022-02-23 11:00:00,137,266,9,14,502,409,93,5
1284,2022-02-23 12:00:00,108,273,5,17,722,576,146,12
1285,2022-02-23 13:00:00,128,174,11,13,655,463,192,10
1286,2022-02-23 14:00:00,94,212,9,15,666,597,69,5
1287,2022-02-23 15:00:00,80,147,10,11,613,516,97,7
1288,2022-02-23 16:00:00,84,262,9,18,558,491,67,14
1289,2022-02-23 17:00:00,67,211,7,16,797,623,174,6
1290,2022-02-23 18:00:00,140,165,11,15,757,653,104,11
1291,2022-02-23 19:00:00,95,104,7,13,779,546,233,5
1292,2022-02-23 20:00:00,133,166,5,19,578,405,173,9
1293,2022-02-23 21:00:00,112,163,11,13,773,619,154,9
1294,2022-02-23 22:00:00,73,191,8,11,606,498,108,9
1295,2022-02-23 23:00:00,118,200,9,16,799,702,97,8
1296,2022-02-24 00:00:00,68,223,13,15,781,628,153,9
1297,2022-02-24 01:00:00,142,187,13,12,656,586,70,14
1298,2022-02-24 02:00:00,63,218,7,14,707,522,185,6
1299,2022-02-24 03:00:00,141,172,11,12,632,539,93,12
1300,2022-02-24 04:00:00,85,146,8,19,792,633,159,5
1301,2022-02-24 05:00:00,57,222,11,19,786,589,197,13
1302,2022-02-24 06:00:00,123,274,12,13,764,684,80,5
1303,2022-02-24 07:00:00,85,192,8,11,722,573,149,10
1304,2022-02-24 08:00:00,57,253,12,11,702,573,129,8
1305,2022-02-24 09:00:00,106,230,7,12,709,504,205,5
1306,2022-02-24 10:00:00,60,296,13,14,757,588,169,5
1307,2022-02-24 11:00:00,51,170,8,19,550,486,64,11
1308,2022-02-24 12:00:00,56,231,9,10,553,444,109,7
1309,2022-02-24 13:00:00,140,226,9,15,616,530,86,5
1310,2022-02-24 14:00:00,99,142,6,11,754,557,197,12
1311,2022-02-24 15:00:00,59,260,14,11,552,400,152,10
1312,2022-02-24 16:00:00,78,278,5,18,693,537,156,6
1313,2022-02-24 17:00:00,103,120,10,19,596,472,124,8
1314,2022-02-24 18:00:00,78,280,7,19,511,447,64,5
1315,2022-02-24 19:00:00,140,276,14,18,573,414,159,5
1316,2022-02-24 20:00:00,113,195,10,12,727,582,145,12
1317,2022-02-24 21:00:00,94,124,9,10,639,564,75,7
1318,2022-02-24 22:00:00,79,220,14,10,644,530,114,7
1319,2022-02-24 23:00:00,65,219,5,10,589,506,83,5
1320,2022-02-25 00:00:00,115,294,6,11,728,649,79,10
1321,2022-02-25 01:00:00,69,122,5,16,556,427,129,13
1322,2022-02-25 02:00:00,91,198,12,19,501,362,139,8
1323,2022-02-25 03:00:00,57,122,10,14,675,548,127,7
1324,2022-02-25 04:00:00,61,158,9,19,577,508,69,14
1325,2022-02-25 05:00:00,79,132,14,12,713,530,183,11
1326,2022-02-25 06:00:00,144,224,6,15,616,511,105,11
1327,2022-02-25 07:00:00,137,112,6,10,503,440,63,6
1328,2022-02-25 08:00:00,58,147,11,11,634,518,116,8
1329,2022-02-25 09:00:00,70,142,10,13,535,474,61,11
1330,2022-02-25 10:00:00,87,128,6,11,706,612,94,6
1331,2022-02-25 11:00:00,126,238,8,13,693,511,182,10
1332,2022-02-25 12:00:00,70,123,7,19,744,630,114,13
1333,2022-02-25 13:00:00,100,107,9,17,595,441,154,6
1334,2022-02-25 14:00:00,78,288,9,11,718,561,157,10
1335,2022-02-25 15:00:00,99,284,13,10,530,455,75,13
1336,2022-02-25 16:00:00,56,209,12,14,761,589,172,7
1337,2022-02-25 17:00:00,55,175,11,16,562,415,147,11
1338,2022-02-25 18:00:00,71,150,11,13,766,669,97,13
1339,2022-02-25 19:00:00,134,134,8,12,514,387,127,8
1340,2022-02-25 20:00:00,94,145,6,15,519,426,93,14
1341,2022-02-25 21:00:00,131,172,9,11,595,505,90,8
1342,2022-02-25 22:00:00,64,299,11,19,692,529,163,6
1343,2022-02-25 23:00:00,60,102,14,12,534,420,114,11
1344,2022-02-26 00:00:00,61,189,12,12,556,406,150,14
1345,2022-02-26 01:00:00,102,280,6,17,548,470,78,12
1346,2022-02-26 02:00:00,87,130,8,17,506,452,54,8
1347,2022-02-26 03:00:00,115,266,14,19,520,405,115,11
1348,2022-02-26 04:00:00,113,222,12,16,605,482,123,5
1349,2022-02-26 05:00:00,102,289,7,19,797,618,179,9
1350,2022-02-26 06:00:00,61,216,12,11,576,504,72,7
1351,2022-02-26 07:00:00,104,122,7,15,594,428,166,14
1352,2022-02-26 08:00:00,68,170,11,17,579,506,73,7
1353,2022-02-26 09:00:00,71,164,5,19,526,450,76,10
1354,2022-02-26 10:00:00,120,216,9,16,618,433,185,11
1355,2022-02-26 11:00:00,96,149,14,10,569,482,87,5
1356,2022-02-26 12:00:00,143,217,14,11,561,473,88,9
1357,2022-02-26 13:00:00,128,189,11,15,544,456,88,12
1358,2022-02-26 14:00:00,144,105,10,13,585,498,87,11
1359,2022-02-26 15:00:00,121,166,7,14,538,405,133,13
1360,2022-02-26 16:00:00,63,104,13,15,609,540,69,11
1361,2022-02-26 17:00:00,72,170,5,10,653,463,190,6
1362,2022-02-26 18:00:00,111,227,12,11,551,460,91,14
1363,2022-02-26 19:00:00,71,213,9,12,656,498,158,8
1364,2022-02-26 20:00:00,141,226,8,12,793,600,193,8
1365,2022-02-26 21:00:00,125,295,6,11,578,453,125,9
1366,2022-02-26 22:00:00,110,267,10,12,712,502,210,8
1367,2022-02-26 23:00:00,114,206,14,10,785,583,202,8
1368,2022-02-27 00:00:00,148,299,13,10,587,466,121,9
1369,2022-02-27 01:00:00,136,268,13,17,734,570,164,9
1370,2022-02-27 02:00:00,135,225,8,13,692,492,200,8
1371,2022-02-27 03:00:00,77,101,11,11,693,563,130,14
1372,2022-02-27 04:00:00,116,230,6,12,551,397,154,14
1373,2022-02-27 05:00:00,64,249,10,11,607,468,139,13
1374,2022-02-27 06:00:00,51,151,5,14,632,483,149,5
1375,2022-02-27 07:00:00,112,260,7,17,633,532,101,12
1376,2022-02-27 08:00:00,76,285,8,15,589,425,164,12
1377,2022-02-27 09:00:00,67,246,9,11,584,521,63,8
1378,2022-02-27 10:00:00,98,155,8,11,599,454,145,12
1379,2022-02-27 11:00:00,56,216,8,11,596,527,69,6
1380,2022-02-27 12:00:00,100,107,12,14,723,613,110,10
1381,2022-02-27 13:00:00,75,273,10,13,624,482,142,8
1382,2022-02-27 14:00:00,68,249,6,12,513,393,120,11
1383,2022-02-27 15:00:00,88,110,7,17,704,538,166,12
1384,2022-02-27 16:00:00,146,124,7,17,720,533,187,12
1385,2022-02-27 17:00:00,149,219,11,12,581,517,64,12
1386,2022-02-27 18:00:00,132,165,9,16,735,610,125,9
1387,2022-02-27 19:00:00,97,290,10,12,757,563,194,5
1388,2022-02-27 20:00:00,112,238,8,10,500,401,99,13
1389,2022-02-27 21:00:00,135,202,12,19,691,537,154,8
1390,2022-02-27 22:00:00,57,241,7,17,562,452,110,9
1391,2022-02-27 23:00:00,85,155,9,13,777,554,223,6
1392,2022-02-28 00:00:00,142,109,6,18,588,429,159,12
1393,2022-02-28 01:00:00,111,151,10,11,767,683,84,8
1394,2022-02-28 02:00:00,145,173,11,10,729,618,111,11
1395,2022-02-28 03:00:00,111,293,11,12,583,506,77,7
1396,2022-02-28 04:00:00,129,104,8,13,693,506,187,10
1397,2022-02-28 05:00:00,57,181,5,16,625,440,185,11
1398,2022-02-28 06:00:00,50,238,14,16,554,486,68,9
1399,2022-02-28 07:00:00,126,143,10,12,637,548,89,6
1400,2022-02-28 08:00:00,105,263,12,10,553,442,111,10
1401,2022-02-28 09:00:00,51,218,13,13,777,681,96,8
1402,2022-02-28 10:00:00,68,291,12,11,524,372,152,7
1403,2022-02-28 11:00:00,72,237,10,13,589,464,125,10
1404,2022-02-28 12:00:00,51,189,10,18,569,486,83,9
1405,2022-02-28 13:00:00,61,117,14,17,746,652,94,6
1406,2022-02-28 14:00:00,88,170,13,16,794,614,180,7
1407,2022-02-28 15:00:00,70,127,13,17,615,452,163,12
1408,2022-02-28 16:00:00,74,141,7,11,787,640,147,14
1409,2022-02-28 17:00:00,72,193,11,18,560,502,58,10
1410,2022-02-28 18:00:00,128,204,9,12,546,420,126,7
1411,2022-02-28 19:00:00,56,203,7,13,528,412,116,6
1412,2022-02-28 20:00:00,92,282,9,10,709,552,157,6
1413,2022-02-28 21:00:00,87,167,10,10,512,415,97,11
1414,2022-02-28 22:00:00,147,268,7,16,639,541,98,5
1415,2022-02-28 23:00:00,135,153,13,17,755,617,138,12
1416,2022-03-01 00:00:00,74,199,8,13,604,455,149,13
1417,2022-03-01 01:00:00,90,105,8,16,528,415,113,6
1418,2022-03-01 02:00:00,116,232,13,14,582,421,161,13
1419,2022-03-01 03:00:00,62,164,14,12,608,465,143,13
1420,2022-03-01 04:00:00,55,206,8,17,788,660,128,5
1421,2022-03-01 05:00:00,100,233,11,11,786,584,202,11
1422,2022-03-01 06:00:00,64,214,14,17,609,495,114,6
1423,2022-03-01 07:00:00,81,100,9,19,718,618,100,9
1424,2022-03-01 08:00:00,142,110,12,15,637,489,148,9
1425,2022-03-01 09:00:00,113,222,8,12,606,444,162,13
1426,2022-03-01 10:00:00,111,282,9,14,528,371,157,6
1427,2022-03-01 11:00:00,101,118,10,10,732,526,206,8
1428,2022-03-01 12:00:00,142,171,5,19,522,379,143,11
1429,2022-03-01 13:00:00,64,251,10,12,718,584,134,10
1430,2022-03-01 14:00:00,81,183,14,17,593,496,97,8
1431,2022-03-01 15:00:00,101,295,9,11,559,502,57,9
1432,2022-03-01 16:00:00,104,157,5,17,767,659,108,8
1433,2022-03-01 17:00:00,148,120,10,14,705,623,82,9
1434,2022-03-01 18:00:00,74,198,6,11,762,644,118,11
1435,2022-03-01 19:00:00,133,203,14,11,676,515,161,7
1436,2022-03-01 20:00:00,103,296,5,16,619,461,158,14
1437,2022-03-01 21:00:00,109,122,7,19,797,570,227,11
1438,2022-03-01 22:00:00,55,279,5,12,573,431,142,14
1439,2022-03-01 23:00:00,96,157,14,10,550,458,92,6
1440,2022-03-02 00:00:00,149,182,7,17,605,524,81,11
1441,2022-03-02 01:00:00,149,222,14,12,543,403,140,8
1442,2022-03-02 02:00:00,111,241,7,18,725,529,196,14
1443,2022-03-02 03:00:00,97,263,14,17,569,435,134,6
1444,2022-03-02 04:00:00,70,279,7,14,647,532,115,8
1445,2022-03-02 05:00:00,131,134,7,16,699,516,183,5
1446,2022-03-02 06:00:00,59,299,12,17,635,477,158,14
1447,2022-03-02 07:00:00,138,234,9,14,775,595,180,5
1448,2022-03-02 08:00:00,99,212,6,18,645,566,79,12
1449,2022-03-02 09:00:00,98,121,9,14,737,611,126,7
1450,2022-03-02 10:00:00,95,151,14,14,630,444,186,5
1451,2022-03-02 11:00:00,53,248,11,12,729,626,103,5
1452,2022-03-02 12:00:00,69,294,9,17,510,363,147,14
1453,2022-03-02 13:00:00,89,108,6,15,706,558,148,5
1454,2022-03-02 14:00:00,65,120,6,17,633,518,115,7
1455,2022-03-02 15:00:00,77,169,10,17,520,399,121,14
1456,2022-03-02 16:00:00,78,153,11,19,563,473,90,11
1457,2022-03-02 17:00:00,99,199,6,10,518,435,83,6
1458,2022-03-02 18:00:00,60,221,13,15,676,597,79,5
1459,2022-03-02 19:00:00,64,144,5,12,639,495,144,8
1460,2022-03-02 20:00:00,115,150,9,18,535,400,135,5
1461,2022-03-02 21:00:00,60,143,9,10,654,548,106,10
1462,2022-03-02 22:00:00,108,246,14,18,602,522,80,13
1463,2022-03-02 23:00:00,112,205,8,14,612,520,92,14
1464,2022-03-03 00:00:00,137,280,5,12,656,467,189,8
1465,2022-03-03 01:00:00,60,170,9,14,517,405,112,7
1466,2022-03-03 02:00:00,78,269,10,16,736,537,199,10
1467,2022-03-03 03:00:00,118,241,7,12,511,375,136,11
1468,2022-03-03 04:00:00,88,138,10,15,709,507,202,6
1469,2022-03-03 05:00:00,89,282,10,17,599,497,102,5
1470,2022-03-03 06:00:00,66,245,13,13,754,596,158,12
1471,2022-03-03 07:00:00,126,200,14,11,538,463,75,9
1472,2022-03-03 08:00:00,106,185,7,17,613,433,180,7
1473,2022-03-03 09:00:00,77,221,5,11,773,574,199,12
1474,2022-03-03 10:00:00,125,114,6,11,732,646,86,11
1475,2022-03-03 11:00:00,96,270,14,19,642,507,135,9
1476,2022-03-03 12:00:00,146,241,5,13,724,587,137,13
1477,2022-03-03 13:00:00,69,104,8,15,754,656,98,5
1478,2022-03-03 14:00:00,144,257,9,14,560,401,159,9
1479,2022-03-03 15:00:00,69,137,8,11,708,617,91,5
1480,2022-03-03 16:00:00,90,297,14,11,757,676,81,9
1481,2022-03-03 17:00:00,98,252,12,15,514,420,94,8
1482,2022-03-03 18:00:00,105,165,8,18,548,392,156,12
1483,2022-03-03 19:00:00,122,174,10,17,773,693,80,12
1484,2022-03-03 20:00:00,78,223,7,11,566,422,144,5
1485,2022-03-03 21:00:00,99,171,5,15,714,507,207,11
1486,2022-03-03 22:00:00,138,218,14,14,685,494,191,8
1487,2022-03-03 23:00:00,103,269,14,14,644,562,82,9
1488,2022-03-04 00:00:00,138,138,8,18,729,534,195,5
1489,2022-03-04 01:00:00,92,114,11,16,769,551,218,7
1490,2022-03-04 02:00:00,123,248,6,17,544,381,163,7
1491,2022-03-04 03:00:00,119,158,13,14,656,580,76,8
1492,2022-03-04 04:00:00,111,266,14,17,534,401,133,10
1493,2022-03-04 05:00:00,87,240,8,12,771,664,107,10
1494,2022-03-04 06:00:00,104,206,12,17,580,511,69,6
1495,2022-03-04 07:00:00,82,235,11,19,549,482,67,9
1496,2022-03-04 08:00:00,114,183,5,19,728,550,178,6
1497,2022-03-04 09:00:00,82,236,8,10,668,490,178,13
1498,2022-03-04 10:00:00,55,153,7,10,622,439,183,12
1499,2022-03-04 11:00:00,88,118,14,15,684,499,185,10
1500,2022-03-04 12:00:00,86,229,12,16,506,415,91,14
1501,2022-03-04 13:00:00,108,280,8,11,642,459,183,13
1502,2022-03-04 14:00:00,100,262,11,12,595,452,143,11
1503,2022-03-04 15:00:00,60,182,8,16,667,562,105,5
1504,2022-03-04 16:00:00,101,157,13,10,655,536,119,10
1505,2022-03-04 17:00:00,86,292,14,10,750,594,156,5
1506,2022-03-04 18:00:00,135,126,14,16,573,453,120,9
1507,2022-03-04 19:00:00,106,294,14,17,542,386,156,14
1508,2022-03-04 20:00:00,53,282,9,13,674,544,130,9
1509,2022-03-04 21:00:00,148,297,9,12,688,546,142,6
1510,2022-03-04 22:00:00,74,133,14,18,598,515,83,14
1511,2022-03-04 23:00:00,137,270,9,18,641,541,100,5
1512,2022-03-05 00:00:00,116,185,10,14,733,561,172,14
1513,2022-03-05 01:00:00,123,124,14,16,681,612,69,7
1514,2022-03-05 02:00:00,148,173,14,19,648,539,109,12
1515,2022-03-05 03:00:00,106,118,14,10,510,403,107,11
1516,2022-03-05 04:00:00,94,111,9,19,585,474,111,14
1517,2022-03-05 05:00:00,112,132,14,15,679,494,185,6
1518,2022-03-05 06:00:00,100,112,6,12,563,493,70,12
1519,2022-03-05 07:00:00,141,155,11,10,601,445,156,11
1520,2022-03-05 08:00:00,78,184,5,15,772,631,141,6
1521,2022-03-05 09:00:00,67,250,11,17,758,655,103,7
1522,2022-03-05 10:00:00,144,271,6,10,780,596,184,12
1523,2022-03-05 11:00:00,147,274,14,16,626,510,116,9
1524,2022-03-05 12:00:00,127,162,9,11,699,524,175,9
1525,2022-03-05 13:00:00,77,177,6,16,504,380,124,8
1526,2022-03-05 14:00:00,118,159,11,16,728,577,151,13
1527,2022-03-05 15:00:00,53,183,9,11,674,546,128,12
1528,2022-03-05 16:00:00,120,269,13,17,561,490,71,13
1529,2022-03-05 17:00:00,83,240,8,12,713,542,171,12
1530,2022-03-05 18:00:00,88,140,10,12,731,543,188,7
1531,2022-03-05 19:00:00,61,240,7,15,544,448,96,6
1532,2022-03-05 20:00:00,89,149,7,10,780,642,138,9
1533,2022-03-05 21:00:00,138,253,7,13,644,471,173,12
1534,2022-03-05 22:00:00,84,129,12,13,502,415,87,5
1535,2022-03-05 23:00:00,122,148,11,14,778,698,80,6
1536,2022-03-06 00:00:00,116,244,11,18,579,406,173,13
1537,2022-03-06 01:00:00,62,224,6,12,694,522,172,11
1538,2022-03-06 02:00:00,101,167,14,16,540,449,91,6
1539,2022-03-06 03:00:00,56,190,12,10,764,562,202,9
1540,2022-03-06 04:00:00,68,273,11,16,655,535,120,14
1541,2022-03-06 05:00:00,149,272,11,10,575,408,167,6
1542,2022-03-06 06:00:00,122,124,8,19,642,531,111,8
1543,2022-03-06 07:00:00,104,200,7,10,591,506,85,9
1544,2022-03-06 08:00:00,68,245,11,14,769,621,148,7
1545,2022-03-06 09:00:00,102,255,10,17,750,625,125,7
1546,2022-03-06 10:00:00,149,104,12,17,614,516,98,7
1547,2022-03-06 11:00:00,67,211,14,18,594,436,158,14
1548,2022-03-06 12:00:00,55,100,12,14,529,400,129,5
1549,2022-03-06 13:00:00,50,298,14,19,653,465,188,6
1550,2022-03-06 14:00:00,110,174,6,10,542,452,90,11
1551,2022-03-06 15:00:00,62,192,8,18,631,481,150,5
1552,2022-03-06 16:00:00,114,215,12,17,738,630,108,7
1553,2022-03-06 17:00:00,65,216,12,15,734,653,81,9
1554,2022-03-06 18:00:00,108,262,5,18,665,540,125,11
1555,2022-03-06 19:00:00,106,175,6,17,508,413,95,9
1556,2022-03-06 20:00:00,52,132,5,19,786,629,157,11
1557,2022-03-06 21:00:00,79,278,14,18,505,439,66,11
1558,2022-03-06 22:00:00,122,238,6,19,762,614,148,10
1559,2022-03-06 23:00:00,82,122,14,10,592,471,121,7
1560,2022-03-07 00:00:00,119,214,5,17,578,410,168,12
1561,2022-03-07 01:00:00,140,249,5,12,642,473,169,7
1562,2022-03-07 02:00:00,62,135,5,13,581,438,143,9
1563,2022-03-07 03:00:00,132,167,10,19,523,401,122,12
1564,2022-03-07 04:00:00,140,237,8,10,682,602,80,14
1565,2022-03-07 05:00:00,55,257,11,18,521,385,136,13
1566,2022-03-07 06:00:00,124,136,10,15,578,484,94,8
1567,2022-03-07 07:00:00,69,237,5,12,776,691,85,10
1568,2022-03-07 08:00:00,131,236,8,12,653,542,111,11
1569,2022-03-07 09:00:00,61,227,7,14,669,532,137,10
1570,2022-03-07 10:00:00,68,217,8,16,565,494,71,6
1571,2022-03-07 11:00:00,97,258,5,10,649,530,119,14
1572,2022-03-07 12:00:00,50,165,7,16,511,404,107,12
1573,2022-03-07 13:00:00,76,233,6,12,504,416,88,7
1574,2022-03-07 14:00:00,116,248,13,13,763,564,199,9
1575,2022-03-07 15:00:00,112,128,13,12,658,529,129,6
1576,2022-03-07 16:00:00,94,137,13,16,688,488,200,10
1577,2022-03-07 17:00:00,126,255,8,11,715,544,171,11
1578,2022-03-07 18:00:00,62,185,5,11,564,447,117,7
1579,2022-03-07 19:00:00,142,146,5,10,605,512,93,13
1580,2022-03-07 20:00:00,122,184,5,11,607,445,162,11
1581,2022-03-07 21:00:00,102,200,7,14,671,538,133,7
1582,2022-03-07 22:00:00,140,257,13,12,645,453,192,5
1583,2022-03-07 23:00:00,61,252,8,11,609,430,179,5
1584,2022-03-08 00:00:00,135,278,6,10,626,461,165,9
1585,2022-03-08 01:00:00,74,269,12,11,689,592,97,10
1586,2022-03-08 02:00:00,117,200,10,17,526,394,132,11
1587,2022-03-08 03:00:00,54,194,10,11,608,532,76,10
1588,2022-03-08 04:00:00,76,195,6,16,778,676,102,14
1589,2022-03-08 05:00:00,55,280,13,15,627,563,64,6
1590,2022-03-08 06:00:00,100,194,5,15,531,438,93,8
1591,2022-03-08 07:00:00,142,221,12,12,542,402,140,5
1592,2022-03-08 08:00:00,120,270,14,16,775,626,149,9
1593,2022-03-08 09:00:00,139,289,14,10,645,515,130,11
1594,2022-03-08 10:00:00,53,281,7,13,571,488,83,9
1595,2022-03-08 11:00:00,97,255,13,19,699,560,139,8
1596,2022-03-08 12:00:00,74,283,6,11,790,666,124,10
1597,2022-03-08 13:00:00,92,241,9,16,502,421,81,13
1598,2022-03-08 14:00:00,142,194,12,16,621,440,181,9
1599,2022-03-08 15:00:00,58,289,5,11,578,454,124,11
1600,2022-03-08 16:00:00,59,163,10,17,532,450,82,10
1601,2022-03-08 17:00:00,90,104,9,15,648,522,126,12
1602,2022-03-08 18:00:00,101,270,14,19,769,604,165,11
1603,2022-03-08 19:00:00,50,199,11,18,578,476,102,6
1604,2022-03-08 20:00:00,107,103,11,19,532,374,158,7
1605,2022-03-08 21:00:00,64,253,8,16,750,618,132,8
1606,2022-03-08 22:00:00,111,134,7,13,527,464,63,5
1607,2022-03-08 23:00:00,149,252,11,15,794,673,121,11
1608,2022-03-09 00:00:00,62,244,12,13,684,591,93,12
1609,2022-03-09 01:00:00,59,105,7,13,707,613,94,8
1610,2022-03-09 02:00:00,98,148,13,12,525,383,142,10
1611,2022-03-09 03:00:00,87,237,5,16,617,507,110,8
1612,2022-03-09 04:00:00,58,215,11,14,643,464,179,10
1613,2022-03-09 05:00:00,108,118,10,15,633,547,86,9
1614,2022-03-09 06:00:00,77,236,10,13,512,373,139,7
1615,2022-03-09 07:00:00,74,258,11,17,674,475,199,8
1616,2022-03-09 08:00:00,140,261,10,13,595,510,85,11
1617,2022-03-09 09:00:00,128,294,11,14,551,455,96,10
1618,2022-03-09 10:00:00,121,149,10,15,500,441,59,5
1619,2022-03-09 11:00:00,144,245,13,19,773,544,229,7
1620,2022-03-09 12:00:00,58,227,8,14,537,377,160,6
1621,2022-03-09 13:00:00,125,141,7,19,710,532,178,6
1622,2022-03-09 14:00:00,85,145,7,16,536,379,157,11
1623,2022-03-09 15:00:00,81,268,6,14,515,407,108,8
1624,2022-03-09 16:00:00,55,105,13,19,668,499,169,9
1625,2022-03-09 17:00:00,84,234,13,14,699,532,167,8
1626,2022-03-09 18:00:00,135,149,7,10,609,476,133,14
1627,2022-03-09 19:00:00,138,292,13,11,670,597,73,13
1628,2022-03-09 20:00:00,118,241,11,14,583,435,148,14
1629,2022-03-09 21:00:00,69,268,14,19,643,577,66,9
1630,2022-03-09 22:00:00,59,288,11,13,537,411,126,11
1631,2022-03-09 23:00:00,142,141,14,16,718,527,191,7
1632,2022-03-10 00:00:00,87,249,9,16,764,657,107,7
1633,2022-03-10 01:00:00,92,127,13,15,584,483,101,8
1634,2022-03-10 02:00:00,111,145,9,18,582,471,111,5
1635,2022-03-10 03:00:00,95,261,6,11,765,672,93,12
1636,2022-03-10 04:00:00,52,234,7,17,525,412,113,8
1637,2022-03-10 05:00:00,136,164,9,17,551,412,139,5
1638,2022-03-10 06:00:00,135,212,6,16,568,417,151,11
1639,2022-03-10 07:00:00,149,120,7,12,549,389,160,9
1640,2022-03-10 08:00:00,121,150,12,17,611,488,123,13
1641,2022-03-10 09:00:00,116,131,5,13,763,616,147,11
1642,2022-03-10 10:00:00,53,234,14,19,781,552,229,14
1643,2022-03-10 11:00:00,51,159,5,17,530,438,92,7
1644,2022-03-10 12:00:00,92,298,9,11,719,517,202,9
1645,2022-03-10 13:00:00,82,114,6,15,522,446,76,13
1646,2022-03-10 14:00:00,128,190,11,15,531,404,127,7
1647,2022-03-10 15:00:00,72,148,8,19,659,472,187,10
1648,2022-03-10 16:00:00,57,111,12,13,779,579,200,5
1649,2022-03-10 17:00:00,60,185,9,10,798,582,216,11
1650,2022-03-10 18:00:00,145,224,13,12,728,574,154,6
1651,2022-03-10 19:00:00,113,100,9,11,670,533,137,12
1652,2022-03-10 20:00:00,79,162,6,14,522,453,69,12
1653,2022-03-10 21:00:00,79,179,5,19,616,482,134,10
1654,2022-03-10 22:00:00,123,253,13,14,750,574,176,10
1655,2022-03-10 23:00:00,137,114,14,10,536,423,113,5
1656,2022-03-11 00:00:00,57,230,8,18,517,403,114,13
1657,2022-03-11 01:00:00,87,157,14,19,724,569,155,14
1658,2022-03-11 02:00:00,85,251,14,15,590,442,148,12
1659,2022-03-11 03:00:00,142,241,14,17,552,404,148,9
1660,2022-03-11 04:00:00,126,264,8,13,742,550,192,12
1661,2022-03-11 05:00:00,115,268,7,12,635,568,67,12
1662,2022-03-11 06:00:00,122,178,5,11,668,492,176,6
1663,2022-03-11 07:00:00,139,194,6,12,737,638,99,14
1664,2022-03-11 08:00:00,76,289,9,17,585,476,109,9
1665,2022-03-11 09:00:00,62,181,13,13,582,424,158,5
1666,2022-03-11 10:00:00,58,281,12,19,713,581,132,6
1667,2022-03-11 11:00:00,139,251,5,16,553,392,161,6
1668,2022-03-11 12:00:00,72,252,8,16,571,432,139,10
1669,2022-03-11 13:00:00,116,128,12,13,638,537,101,14
1670,2022-03-11 14:00:00,116,163,7,15,796,619,177,8
1671,2022-03-11 15:00:00,82,112,5,18,598,480,118,7
1672,2022-03-11 16:00:00,147,211,13,18,739,602,137,12
1673,2022-03-11 17:00:00,142,102,9,17,797,682,115,13
1674,2022-03-11 18:00:00,74,154,6,16,514,393,121,10
1675,2022-03-11 19:00:00,111,283,7,11,513,439,74,10
1676,2022-03-11 20:00:00,61,185,5,15,610,546,64,13
1677,2022-03-11 21:00:00,142,248,8,19,751,593,158,5
1678,2022-03-11 22:00:00,79,247,14,15,683,596,87,14
1679,2022-03-11 23:00:00,122,200,8,15,710,520,190,9
1680,2022-03-12 00:00:00,84,283,13,16,540,421,119,9
1681,2022-03-12 01:00:00,76,109,13,17,539,395,144,9
1682,2022-03-12 02:00:00,104,149,9,12,692,489,203,5
1683,2022-03-12 03:00:00,91,251,6,12,648,582,66,7
1684,2022-03-12 04:00:00,72,131,8,14,685,615,70,10
1685,2022-03-12 05:00:00,108,199,7,14,669,558,111,12
1686,2022-03-12 06:00:00,104,287,7,11,644,508,136,12
1687,2022-03-12 07:00:00,106,254,8,10,762,643,119,10
1688,2022-03-12 08:00:00,148,217,5,13,730,584,146,12
1689,2022-03-12 09:00:00,50,294,8,18,579,458,121,9
1690,2022-03-12 10:00:00,87,138,9,12,516,442,74,5
1691,2022-03-12 11:00:00,87,265,14,14,760,554,206,6
1692,2022-03-12 12:00:00,87,262,10,12,742,553,189,10
1693,2022-03-12 13:00:00,143,164,5,16,658,503,155,5
1694,2022-03-12 14:00:00,149,248,8,17,616,544,72,14
1695,2022-03-12 15:00:00,145,219,5,14,690,521,169,7
1696,2022-03-12 16:00:00,143,218,12,12,573,405,168,5
1697,2022-03-12 17:00:00,74,216,11,16,501,379,122,8
1698,2022-03-12 18:00:00,126,290,13,11,773,695,78,5
1699,2022-03-12 19:00:00,100,283,6,12,736,653,83,5
1700,2022-03-12 20:00:00,124,171,5,14,547,436,111,12
1701,2022-03-12 21:00:00,68,178,9,15,545,415,130,7
1702,2022-03-12 22:00:00,78,278,7,19,785,602,183,10
1703,2022-03-12 23:00:00,94,232,12,15,633,559,74,11
1704,2022-03-13 00:00:00,96,181,13,11,564,477,87,14
1705,2022-03-13 01:00:00,147,237,7,19,680,522,158,7
1706,2022-03-13 02:00:00,87,221,7,15,611,499,112,11
1707,2022-03-13 03:00:00,82,114,12,19,599,508,91,7
1708,2022-03-13 04:00:00,118,168,11,13,659,466,193,10
1709,2022-03-13 05:00:00,132,263,12,13,702,558,144,12
1710,2022-03-13 06:00:00,95,187,13,16,556,392,164,10
1711,2022-03-13 07:00:00,83,234,13,10,558,423,135,13
1712,2022-03-13 08:00:00,74,240,14,13,733,626,107,7
1713,2022-03-13 09:00:00,101,135,13,11,783,584,199,9
1714,2022-03-13 10:00:00,55,124,5,14,512,363,149,7
1715,2022-03-13 11:00:00,120,230,8,14,657,461,196,13
1716,2022-03-13 12:00:00,131,157,7,19,713,530,183,8
1717,2022-03-13 13:00:00,56,159,8,11,635,562,73,9
1718,2022-03-13 14:00:00,103,230,14,16,549,493,56,6
1719,2022-03-13 15:00:00,107,299,6,13,693,588,105,11
1720,2022-03-13 16:00:00,114,262,9,15,552,426,126,13
1721,2022-03-13 17:00:00,66,257,13,14,704,551,153,10
1722,2022-03-13 18:00:00,112,249,8,18,515,362,153,11
1723,2022-03-13 19:00:00,58,196,6,18,746,608,138,9
1724,2022-03-13 20:00:00,149,238,12,17,584,501,83,11
1725,2022-03-13 21:00:00,140,125,14,14,614,511,103,12
1726,2022-03-13 22:00:00,88,283,6,11,758,570,188,8
1727,2022-03-13 23:00:00,60,166,13,17,643,494,149,14
1728,2022-03-14 00:00:00,147,182,5,13,553,423,130,5
1729,2022-03-14 01:00:00,101,283,12,18,659,565,94,14
1730,2022-03-14 02:00:00,93,109,6,10,571,414,157,13
1731,2022-03-14 03:00:00,124,239,12,11,609,459,150,13
1732,2022-03-14 04:00:00,74,228,14,18,761,536,225,7
1733,2022-03-14 05:00:00,131,174,13,11,586,471,115,7
1734,2022-03-14 06:00:00,106,217,7,17,634,477,157,6
1735,2022-03-14 07:00:00,125,206,13,11,506,423,83,10
1736,2022-03-14 08:00:00,77,145,14,11,549,466,83,14
1737,2022-03-14 09:00:00,124,273,12,12,776,567,209,5
1738,2022-03-14 10:00:00,128,226,13,12,520,440,80,9
1739,2022-03-14 11:00:00,134,267,11,17,695,522,173,12
1740,2022-03-14 12:00:00,130,256,5,12,574,491,83,8
1741,2022-03-14 13:00:00,136,180,6,13,573,420,153,14
1742,2022-03-14 14:00:00,54,103,7,18,735,628,107,12
1743,2022-03-14 15:00:00,136,160,9,17,694,573,121,11
1744,2022-03-14 16:00:00,133,189,6,19,529,444,85,5
1745,2022-03-14 17:00:00,101,222,14,10,590,491,99,5
1746,2022-03-14 18:00:00,115,112,8,15,554,489,65,10
1747,2022-03-14 19:00:00,130,107,6,11,638,531,107,13
1748,2022-03-14 20:00:00,73,155,9,14,561,500,61,7
1749,2022-03-14 21:00:00,69,181,5,15,504,369,135,5
1750,2022-03-14 22:00:00,89,104,7,17,736,650,86,8
1751,2022-03-14 23:00:00,59,293,12,13,576,438,138,5
1752,2022-03-15 00:00:00,138,286,14,11,707,538,169,9
1753,2022-03-15 01:00:00,140,213,12,10,565,439,126,10
1754,2022-03-15 02:00:00,110,264,14,10,664,524,140,11
1755,2022-03-15 03:00:00,57,193,5,18,619,550,69,11
1756,2022-03-15 04:00:00,78,210,9,10,539,435,104,6
1757,2022-03-15 05:00:00,122,232,12,11,717,551,166,11
1758,2022-03-15 06:00:00,84,199,6,18,553,420,133,13
1759,2022-03-15 07:00:00,58,175,13,10,523,389,134,9
1760,2022-03-15 08:00:00,51,212,10,17,633,471,162,14
1761,2022-03-15 09:00:00,66,230,11,14,707,561,146,7
1762,2022-03-15 10:00:00,69,215,8,11,577,518,59,8
1763,2022-03-15 11:00:00,136,291,13,12,731,582,149,10
1764,2022-03-15 12:00:00,58,220,8,13,620,507,113,10
1765,2022-03-15 13:00:00,70,223,14,14,674,518,156,7
1766,2022-03-15 14:00:00,139,159,11,19,560,451,109,10
1767,2022-03-15 15:00:00,68,257,5,13,615,532,83,14
1768,2022-03-15 16:00:00,138,284,7,14,673,519,154,6
1769,2022-03-15 17:00:00,97,152,8,18,690,597,93,7
1770,2022-03-15 18:00:00,70,176,14,13,690,539,151,9
1771,2022-03-15 19:00:00,90,102,5,14,756,678,78,9
1772,2022-03-15 20:00:00,73,197,11,16,705,564,141,6
1773,2022-03-15 21:00:00,86,121,13,15,670,496,174,8
1774,2022-03-15 22:00:00,140,102,14,14,799,645,154,12
1775,2022-03-15 23:00:00,105,286,13,12,511,440,71,5
1776,2022-03-16 00:00:00,70,115,10,18,662,520,142,9
1777,2022-03-16 01:00:00,79,143,8,15,737,610,127,10
1778,2022-03-16 02:00:00,95,143,8,16,545,414,131,6
1779,2022-03-16 03:00:00,97,120,11,13,640,538,102,12
1780,2022-03-16 04:00:00,75,293,6,18,751,529,222,8
1781,2022-03-16 05:00:00,83,125,8,12,607,470,137,12
1782,2022-03-16 06:00:00,135,258,13,12,794,613,181,7
1783,2022-03-16 07:00:00,128,280,11,14,553,418,135,7
1784,2022-03-16 08:00:00,93,205,10,12,779,563,216,11
1785,2022-03-16 09:00:00,83,224,13,19,560,487,73,10
1786,2022-03-16 10:00:00,116,209,8,13,773,668,105,13
1787,2022-03-16 11:00:00,60,199,14,19,626,522,104,7
1788,2022-03-16 12:00:00,131,123,12,16,607,462,145,6
1789,2022-03-16 13:00:00,113,253,8,15,629,482,147,7
1790,2022-03-16 14:00:00,70,134,7,16,532,476,56,10
1791,2022-03-16 15:00:00,147,144,13,14,552,405,147,6
1792,2022-03-16 16:00:00,130,160,13,17,680,585,95,14
1793,2022-03-16 17:00:00,92,151,7,14,793,706,87,12
1794,2022-03-16 18:00:00,72,247,10,14,619,438,181,10
1795,2022-03-16 19:00:00,112,263,10,13,748,622,126,14
1796,2022-03-16 20:00:00,91,266,7,13,656,587,69,14
1797,2022-03-16 21:00:00,71,221,5,10,793,566,227,14
1798,2022-03-16 22:00:00,54,248,7,15,506,417,89,12
1799,2022-03-16 23:00:00,55,123,5,17,624,495,129,10
1800,2022-03-17 00:00:00,130,289,8,12,777,575,202,7
1801,2022-03-17 01:00:00,114,157,7,10,547,448,99,5
1802,2022-03-17 02:00:00,147,189,12,15,777,635,142,14
1803,2022-03-17 03:00:00,75,103,13,12,668,544,124,8
1804,2022-03-17 04:00:00,144,212,6,15,620,439,181,10
1805,2022-03-17 05:00:00,108,229,8,13,515,407,108,5
1806,2022-03-17 06:00:00,145,298,8,14,573,452,121,9
1807,2022-03-17 07:00:00,74,112,11,19,546,470,76,6
1808,2022-03-17 08:00:00,108,146,5,15,690,587,103,6
1809,2022-03-17 09:00:00,142,114,10,10,514,434,80,12
1810,2022-03-17 10:00:00,109,124,14,11,795,650,145,11
1811,2022-03-17 11:00:00,149,121,6,12,652,495,157,10
1812,2022-03-17 12:00:00,108,162,12,16,552,392,160,6
1813,2022-03-17 13:00:00,89,135,11,15,552,415,137,10
1814,2022-03-17 14:00:00,145,168,6,16,775,656,119,9
1815,2022-03-17 15:00:00,100,220,13,18,541,407,134,13
1816,2022-03-17 16:00:00,52,149,6,12,577,439,138,7
1817,2022-03-17 17:00:00,80,173,10,18,646,463,183,14
1818,2022-03-17 18:00:00,50,187,13,19,666,578,88,13
1819,2022-03-17 19:00:00,109,129,10,10,684,567,117,13
1820,2022-03-17 20:00:00,74,147,10,19,657,526,131,14
1821,2022-03-17 21:00:00,97,270,7,18,740,654,86,14
1822,2022-03-17 22:00:00,67,236,10,14,545,448,97,5
1823,2022-03-17 23:00:00,125,164,13,14,571,405,166,5
1824,2022-03-18 00:00:00,54,296,7,13,732,634,98,9
1825,2022-03-18 01:00:00,89,107,8,15,796,701,95,11
1826,2022-03-18 02:00:00,121,157,6,10,669,517,152,13
1827,2022-03-18 03:00:00,101,251,13,13,614,458,156,6
1828,2022-03-18 04:00:00,73,290,13,18,733,539,194,10
1829,2022-03-18 05:00:00,63,231,5,15,690,506,184,12
1830,2022-03-18 06:00:00,69,133,12,13,777,577,200,5
1831,2022-03-18 07:00:00,69,299,10,15,648,549,99,14
1832,2022-03-18 08:00:00,120,205,6,18,639,515,124,9
1833,2022-03-18 09:00:00,64,265,10,19,662,503,159,11
1834,2022-03-18 10:00:00,123,156,10,14,659,573,86,10
1835,2022-03-18 11:00:00,55,179,12,13,798,704,94,7
1836,2022-03-18 12:00:00,80,237,11,10,580,468,112,11
1837,2022-03-18 13:00:00,77,177,9,12,571,471,100,13
1838,2022-03-18 14:00:00,103,245,10,19,761,611,150,12
1839,2022-03-18 15:00:00,87,273,11,13,532,394,138,12
1840,2022-03-18 16:00:00,137,187,10,15,614,548,66,7
1841,2022-03-18 17:00:00,117,292,12,19,729,558,171,13
1842,2022-03-18 18:00:00,88,204,10,13,709,604,105,7
1843,2022-03-18 19:00:00,99,144,14,13,718,510,208,9
1844,2022-03-18 20:00:00,112,192,5,19,714,562,152,8
1845,2022-03-18 21:00:00,58,293,12,16,574,515,59,7
1846,2022-03-18 22:00:00,112,217,14,11,720,610,110,9
1847,2022-03-18 23:00:00,135,225,13,16,791,680,111,6
1848,2022-03-19 00:00:00,91,159,10,11,719,630,89,8
1849,2022-03-19 01:00:00,149,100,5,18,773,597,176,7
1850,2022-03-19 02:00:00,122,109,14,12,694,532,162,11
1851,2022-03-19 03:00:00,99,195,14,10,631,472,159,13
1852,2022-03-19 04:00:00,56,168,12,11,733,640,93,7
1853,2022-03-19 05:00:00,58,128,5,14,526,420,106,13
1854,2022-03-19 06:00:00,100,198,8,15,549,493,56,5
1855,2022-03-19 07:00:00,77,263,12,15,608,534,74,12
1856,2022-03-19 08:00:00,111,128,12,10,575,468,107,8
1857,2022-03-19 09:00:00,109,162,8,11,660,557,103,7
1858,2022-03-19 10:00:00,93,168,10,16,518,391,127,8
1859,2022-03-19 11:00:00,123,290,8,15,696,515,181,13
1860,2022-03-19 12:00:00,81,296,6,19,596,452,144,8
1861,2022-03-19 13:00:00,56,170,7,17,709,579,130,10
1862,2022-03-19 14:00:00,94,276,6,12,645,563,82,5
1863,2022-03-19 15:00:00,123,247,11,14,752,673,79,7
1864,2022-03-19 16:00:00,99,100,7,10,579,459,120,9
1865,2022-03-19 17:00:00,52,121,12,12,506,374,132,13
1866,2022-03-19 18:00:00,96,195,6,13,535,441,94,8
1867,2022-03-19 19:00:00,101,271,10,12,511,395,116,10
1868,2022-03-19 20:00:00,78,119,10,10,550,437,113,13
1869,2022-03-19 21:00:00,96,147,14,14,609,477,132,5
1870,2022-03-19 22:00:00,126,253,8,19,772,582,190,14
1871,2022-03-19 23:00:00,144,118,9,18,733,624,109,14
1872,2022-03-20 00:00:00,90,122,6,17,751,634,117,14
1873,2022-03-20 01:00:00,74,199,13,16,653,492,161,12
1874,2022-03-20 02:00:00,107,196,6,19,698,604,94,14
1875,2022-03-20 03:00:00,65,254,6,11,543,443,100,12
1876,2022-03-20 04:00:00,94,225,7,12,630,488,142,12
1877,2022-03-20 05:00:00,128,108,13,12,512,396,116,7
1878,2022-03-20 06:00:00,148,173,7,10,505,436,69,5
1879,2022-03-20 07:00:00,59,238,7,17,690,514,176,10
1880,2022-03-20 08:00:00,56,178,6,19,592,468,124,6
1881,2022-03-20 09:00:00,56,288,6,15,691,546,145,7
1882,2022-03-20 10:00:00,72,118,5,18,794,646,148,8
1883,2022-03-20 11:00:00,101,121,14,12,590,479,111,14
1884,2022-03-20 12:00:00,130,101,7,15,724,587,137,8
1885,2022-03-20 13:00:00,132,299,5,18,588,438,150,5
1886,2022-03-20 14:00:00,122,201,5,12,656,466,190,5
1887,2022-03-20 15:00:00,146,230,11,10,582,485,97,8
1888,2022-03-20 16:00:00,97,127,8,14,641,506,135,7
1889,2022-03-20 17:00:00,78,125,8,13,660,473,187,7
1890,2022-03-20 18:00:00,117,253,13,10,795,633,162,13
1891,2022-03-20 19:00:00,131,199,13,19,765,587,178,9
1892,2022-03-20 20:00:00,51,285,11,15,520,400,120,14
1893,2022-03-20 21:00:00,89,248,14,16,506,378,128,14
1894,2022-03-20 22:00:00,71,144,9,12,539,381,158,10
1895,2022-03-20 23:00:00,63,294,5,14,660,535,125,7
1896,2022-03-21 00:00:00,84,166,8,10,687,552,135,9
1897,2022-03-21 01:00:00,53,262,5,13,767,602,165,14
1898,2022-03-21 02:00:00,88,251,13,16,571,479,92,8
1899,2022-03-21 03:00:00,88,131,6,18,529,462,67,10
1900,2022-03-21 04:00:00,149,137,14,15,666,561,105,8
1901,2022-03-21 05:00:00,103,168,5,13,680,610,70,10
1902,2022-03-21 06:00:00,73,274,5,14,526,430,96,13
1903,2022-03-21 07:00:00,121,165,7,18,700,515,185,9
1904,2022-03-21 08:00:00,92,227,12,16,603,536,67,11
1905,2022-03-21 09:00:00,102,157,7,14,791,564,227,6
1906,2022-03-21 10:00:00,55,296,7,11,589,453,136,14
1907,2022-03-21 11:00:00,76,207,5,17,719,613,106,6
1908,2022-03-21 12:00:00,132,278,8,13,769,548,221,12
1909,2022-03-21 13:00:00,140,233,10,15,794,591,203,10
1910,2022-03-21 14:00:00,62,256,10,12,729,599,130,6
1911,2022-03-21 15:00:00,122,119,8,12,715,579,136,13
1912,2022-03-21 16:00:00,140,135,8,12,798,575,223,6
1913,2022-03-21 17:00:00,63,275,9,10,565,462,103,10
1914,2022-03-21 18:00:00,148,244,9,17,564,441,123,6
1915,2022-03-21 19:00:00,107,264,11,11,683,492,191,8
1916,2022-03-21 20:00:00,60,228,13,17,556,412,144,7
1917,2022-03-21 21:00:00,87,222,10,12,619,541,78,7
1918,2022-03-21 22:00:00,70,252,5,13,686,570,116,6
1919,2022-03-21 23:00:00,92,149,10,11,687,559,128,7
1920,2022-03-22 00:00:00,79,149,9,10,524,404,120,11
1921,2022-03-22 01:00:00,62,143,7,13,552,433,119,9
1922,2022-03-22 02:00:00,115,234,10,14,543,394,149,13
1923,2022-03-22 03:00:00,129,173,13,13,699,491,208,14
1924,2022-03-22 04:00:00,60,132,7,17,610,493,117,8
1925,2022-03-22 05:00:00,108,142,12,12,670,538,132,5
1926,2022-03-22 06:00:00,55,192,7,12,652,577,75,10
1927,2022-03-22 07:00:00,143,237,8,10,787,623,164,9
1928,2022-03-22 08:00:00,102,194,11,19,620,473,147,6
1929,2022-03-22 09:00:00,83,204,12,12,531,424,107,9
1930,2022-03-22 10:00:00,122,263,10,16,774,547,227,5
1931,2022-03-22 11:00:00,99,267,9,10,539,431,108,8
1932,2022-03-22 12:00:00,89,281,12,16,635,539,96,6
1933,2022-03-22 13:00:00,137,256,11,12,705,608,97,8
1934,2022-03-22 14:00:00,95,183,14,17,621,551,70,12
1935,2022-03-22 15:00:00,80,290,6,18,705,505,200,5
1936,2022-03-22 16:00:00,65,242,7,11,602,538,64,14
1937,2022-03-22 17:00:00,100,276,9,16,762,591,171,11
1938,2022-03-22 18:00:00,126,139,13,13,565,502,63,11
1939,2022-03-22 19:00:00,80,289,11,10,782,589,193,10
1940,2022-03-22 20:00:00,67,285,14,12,738,580,158,13
1941,2022-03-22 21:00:00,107,286,13,11,538,458,80,8
1942,2022-03-22 22:00:00,82,124,9,15,749,597,152,10
1943,2022-03-22 23:00:00,96,164,10,19,551,434,117,10
1944,2022-03-23 00:00:00,129,127,11,11,695,614,81,10
1945,2022-03-23 01:00:00,78,218,5,17,677,556,121,7
1946,2022-03-23 02:00:00,131,296,5,12,648,564,84,12
1947,2022-03-23 03:00:00,60,265,12,17,520,436,84,6
1948,2022-03-23 04:00:00,141,283,7,10,749,666,83,14
1949,2022-03-23 05:00:00,100,137,8,19,592,424,168,11
1950,2022-03-23 06:00:00,93,113,11,15,519,393,126,13
1951,2022-03-23 07:00:00,80,278,8,19,793,668,125,12
1952,2022-03-23 08:00:00,141,123,14,12,677,495,182,13
1953,2022-03-23 09:00:00,97,166,5,13,549,447,102,8
1954,2022-03-23 10:00:00,149,163,7,17,522,393,129,13
1955,2022-03-23 11:00:00,120,201,5,19,720,504,216,6
1956,2022-03-23 12:00:00,61,141,13,10,571,448,123,7
1957,2022-03-23 13:00:00,109,133,7,17,726,628,98,5
1958,2022-03-23 14:00:00,55,133,5,12,593,473,120,7
1959,2022-03-23 15:00:00,62,196,11,17,647,470,177,10
1960,2022-03-23 16:00:00,79,113,8,15,655,465,190,5
1961,2022-03-23 17:00:00,50,237,7,10,712,502,210,10
1962,2022-03-23 18:00:00,58,153,12,18,725,515,210,6
1963,2022-03-23 19:00:00,89,102,14,12,620,519,101,8
1964,2022-03-23 20:00:00,130,204,12,14,517,406,111,6
1965,2022-03-23 21:00:00,64,235,7,14,682,493,189,5
1966,2022-03-23 22:00:00,80,237,14,10,534,397,137,7
1967,2022-03-23 23:00:00,52,151,6,17,797,708,89,5
1968,2022-03-24 00:00:00,97,110,10,11,704,613,91,8
1969,2022-03-24 01:00:00,74,149,5,18,774,653,121,9
1970,2022-03-24 02:00:00,145,228,10,16,697,491,206,12
1971,2022-03-24 03:00:00,67,281,9,11,596,457,139,13
1972,2022-03-24 04:00:00,91,229,13,14,553,474,79,6
1973,2022-03-24 05:00:00,81,103,11,17,698,601,97,7
1974,2022-03-24 06:00:00,104,195,11,10,627,472,155,5
1975,2022-03-24 07:00:00,97,121,7,19,619,439,180,7
1976,2022-03-24 08:00:00,60,164,6,13,687,604,83,10
1977,2022-03-24 09:00:00,100,162,12,11,749,613,136,10
1978,2022-03-24 10:00:00,112,271,14,10,730,564,166,6
1979,2022-03-24 11:00:00,83,163,12,11,523,452,71,11
1980,2022-03-24 12:00:00,85,290,11,14,673,503,170,7
1981,2022-03-24 13:00:00,124,192,6,10,756,578,178,5
1982,2022-03-24 14:00:00,137,139,7,19,510,410,100,9
1983,2022-03-24 15:00:00,147,159,10,13,559,475,84,6
1984,2022-03-24 16:00:00,148,170,5,15,698,612,86,7
1985,2022-03-24 17:00:00,116,278,6,18,536,398,138,6
1986,2022-03-24 18:00:00,81,270,13,14,509,446,63,6
1987,2022-03-24 19:00:00,139,124,11,15,791,555,236,11
1988,2022-03-24 20:00:00,141,143,6,16,743,564,179,7
1989,2022-03-24 21:00:00,98,220,14,14,731,570,161,11
1990,2022-03-24 22:00:00,105,286,9,16,520,463,57,8
1991,2022-03-24 23:00:00,117,155,11,16,609,503,106,14
1992,2022-03-25 00:00:00,126,117,13,18,555,390,165,9
1993,2022-03-25 01:00:00,62,249,10,12,748,532,216,11
1994,2022-03-25 02:00:00,98,101,12,13,514,427,87,7
1995,2022-03-25 03:00:00,142,230,5,13,600,439,161,9
1996,2022-03-25 04:00:00,129,234,9,11,675,560,115,10
1997,2022-03-25 05:00:00,72,244,13,14,519,368,151,10
1998,2022-03-25 06:00:00,84,296,13,13,757,592,165,14
1999,2022-03-25 07:00:00,72,249,5,19,619,552,67,9
2000,2022-03-25 08:00:00,107,122,9,13,723,582,141,7
2001,2022-03-25 09:00:00,125,281,12,11,755,593,162,10
2002,2022-03-25 10:00:00,146,230,10,18,592,523,69,12
2003,2022-03-25 11:00:00,134,174,14,19,507,372,135,11
2004,2022-03-25 12:00:00,143,126,7,14,724,515,209,8
2005,2022-03-25 13:00:00,132,290,7,11,749,556,193,13
2006,2022-03-25 14:00:00,149,298,9,10,505,364,141,9
2007,2022-03-25 15:00:00,116,176,13,11,611,429,182,11
2008,2022-03-25 16:00:00,96,229,13,17,675,495,180,14
2009,2022-03-25 17:00:00,111,237,14,10,678,517,161,10
2010,2022-03-25 18:00:00,147,174,13,10,517,375,142,11
2011,2022-03-25 19:00:00,99,233,11,17,579,462,117,12
2012,2022-03-25 20:00:00,111,135,8,15,526,436,90,13
2013,2022-03-25 21:00:00,129,190,9,15,752,623,129,13
2014,2022-03-25 22:00:00,93,191,12,19,775,619,156,7
2015,2022-03-25 23:00:00,76,286,13,11,524,429,95,10
2016,2022-03-26 00:00:00,119,116,9,18,636,469,167,10
2017,2022-03-26 01:00:00,53,168,14,12,777,664,113,7
2018,2022-03-26 02:00:00,66,231,8,17,637,543,94,13
2019,2022-03-26 03:00:00,53,166,5,13,716,643,73,9
2020,2022-03-26 04:00:00,53,160,10,12,694,523,171,14
2021,2022-03-26 05:00:00,95,248,12,12,659,559,100,11
2022,2022-03-26 06:00:00,141,192,13,13,567,474,93,11
2023,2022-03-26 07:00:00,123,246,5,19,634,475,159,13
2024,2022-03-26 08:00:00,77,125,9,18,792,616,176,6
2025,2022-03-26 09:00:00,87,139,6,15,563,429,134,14
2026,2022-03-26 10:00:00,93,179,11,19,570,489,81,7
2027,2022-03-26 11:00:00,137,209,5,18,741,524,217,5
2028,2022-03-26 12:00:00,106,134,11,12,630,528,102,11
2029,2022-03-26 13:00:00,96,279,6,10,620,511,109,7
2030,2022-03-26 14:00:00,113,211,11,16,699,593,106,11
2031,2022-03-26 15:00:00,79,159,7,13,769,690,79,9
2032,2022-03-26 16:00:00,80,111,12,19,688,516,172,14
2033,2022-03-26 17:00:00,90,270,11,12,534,440,94,14
2034,2022-03-26 18:00:00,102,197,14,13,788,570,218,5
2035,2022-03-26 19:00:00,51,149,10,11,721,521,200,7
2036,2022-03-26 20:00:00,140,266,6,17,637,505,132,9
2037,2022-03-26 21:00:00,145,132,6,14,538,394,144,8
2038,2022-03-26 22:00:00,64,128,6,19,644,484,160,9
2039,2022-03-26 23:00:00,73,196,7,13,611,496,115,11
2040,2022-03-27 00:00:00,89,235,10,16,708,619,89,12
2041,2022-03-27 01:00:00,118,125,6,15,713,613,100,9
2042,2022-03-27 02:00:00,122,162,13,18,712,555,157,6
2043,2022-03-27 03:00:00,110,281,13,15,780,583,197,11
2044,2022-03-27 04:00:00,80,182,10,10,511,448,63,9
2045,2022-03-27 05:00:00,118,137,14,16,589,471,118,8
2046,2022-03-27 06:00:00,111,282,11,14,512,396,116,12
2047,2022-03-27 07:00:00,50,293,8,17,707,626,81,5
2048,2022-03-27 08:00:00,107,260,14,15,525,408,117,9
2049,2022-03-27 09:00:00,70,169,6,12,759,654,105,13
2050,2022-03-27 10:00:00,83,226,9,19,536,451,85,5
2051,2022-03-27 11:00:00,79,207,9,13,625,439,186,6
2052,2022-03-27 12:00:00,71,243,9,11,708,614,94,8
2053,2022-03-27 13:00:00,75,262,12,12,532,410,122,8
2054,2022-03-27 14:00:00,124,151,7,11,700,548,152,10
2055,2022-03-27 15:00:00,107,284,8,17,638,485,153,7
2056,2022-03-27 16:00:00,55,266,6,19,635,454,181,7
2057,2022-03-27 17:00:00,78,145,11,16,664,507,157,10
2058,2022-03-27 18:00:00,87,279,13,18,632,444,188,14
2059,2022-03-27 19:00:00,144,257,7,18,741,596,145,5
2060,2022-03-27 20:00:00,130,172,12,13,717,618,99,8
2061,2022-03-27 21:00:00,52,177,9,19,699,578,121,6
2062,2022-03-27 22:00:00,118,178,8,12,583,432,151,11
2063,2022-03-27 23:00:00,65,145,9,16,534,459,75,7
2064,2022-03-28 00:00:00,144,185,7,10,745,595,150,11
2065,2022-03-28 01:00:00,139,204,13,19,796,590,206,11
2066,2022-03-28 02:00:00,124,214,14,11,637,473,164,14
2067,2022-03-28 03:00:00,110,177,11,15,506,452,54,12
2068,2022-03-28 04:00:00,76,118,13,14,788,558,230,11
2069,2022-03-28 05:00:00,73,161,7,11,574,460,114,8
2070,2022-03-28 06:00:00,123,114,9,15,778,581,197,9
2071,2022-03-28 07:00:00,148,103,6,18,755,548,207,9
2072,2022-03-28 08:00:00,63,117,13,14,573,458,115,9
2073,2022-03-28 09:00:00,95,288,6,19,532,435,97,6
2074,2022-03-28 10:00:00,81,265,5,12,548,449,99,6
2075,2022-03-28 11:00:00,53,279,11,10,501,364,137,7
2076,2022-03-28 12:00:00,119,131,8,16,580,496,84,14
2077,2022-03-28 13:00:00,72,281,14,14,525,375,150,13
2078,2022-03-28 14:00:00,128,288,12,10,609,525,84,7
2079,2022-03-28 15:00:00,113,246,10,10,572,481,91,6
2080,2022-03-28 16:00:00,126,169,11,13,691,539,152,13
2081,2022-03-28 17:00:00,89,130,11,10,680,516,164,8
2082,2022-03-28 18:00:00,91,168,8,19,753,648,105,9
2083,2022-03-28 19:00:00,85,245,13,12,520,444,76,10
2084,2022-03-28 20:00:00,100,263,9,15,603,516,87,5
2085,2022-03-28 21:00:00,70,231,11,17,558,466,92,13
2086,2022-03-28 22:00:00,140,127,8,10,527,422,105,13
2087,2022-03-28 23:00:00,127,188,13,12,681,594,87,13
2088,2022-03-29 00:00:00,110,213,8,14,501,383,118,14
2089,2022-03-29 01:00:00,146,251,5,14,581,473,108,10
2090,2022-03-29 02:00:00,112,121,11,19,583,427,156,7
2091,2022-03-29 03:00:00,52,118,7,10,777,579,198,6
2092,2022-03-29 04:00:00,58,140,6,16,519,416,103,12
2093,2022-03-29 05:00:00,125,168,9,19,536,380,156,8
2094,2022-03-29 06:00:00,50,288,10,17,752,570,182,13
2095,2022-03-29 07:00:00,71,285,5,17,545,435,110,14
2096,2022-03-29 08:00:00,146,152,9,14,607,523,84,12
2097,2022-03-29 09:00:00,81,187,7,15,581,408,173,9
2098,2022-03-29 10:00:00,87,178,6,14,558,477,81,5
2099,2022-03-29 11:00:00,98,227,14,12,602,514,88,12
2100,2022-03-29 12:00:00,136,101,13,13,643,504,139,12
2101,2022-03-29 13:00:00,78,286,12,18,675,595,80,13
2102,2022-03-29 14:00:00,80,295,9,15,623,448,175,7
2103,2022-03-29 15:00:00,110,162,14,13,532,388,144,11
2104,2022-03-29 16:00:00,148,203,5,18,534,467,67,11
2105,2022-03-29 17:00:00,76,153,14,13,557,420,137,9
2106,2022-03-29 18:00:00,93,126,5,17,585,518,67,10
2107,2022-03-29 19:00:00,77,223,10,18,738,518,220,14
2108,2022-03-29 20:00:00,69,257,7,16,638,539,99,11
2109,2022-03-29 21:00:00,96,219,5,15,657,536,121,7
2110,2022-03-29 22:00:00,111,104,7,19,678,518,160,13
2111,2022-03-29 23:00:00,101,213,10,16,659,559,100,13
2112,2022-03-30 00:00:00,94,207,5,15,601,434,167,13
2113,2022-03-30 01:00:00,75,185,13,16,719,556,163,13
2114,2022-03-30 02:00:00,95,204,12,12,798,697,101,7
2115,2022-03-30 03:00:00,93,206,10,18,659,575,84,5
2116,2022-03-30 04:00:00,79,193,11,11,695,556,139,9
2117,2022-03-30 05:00:00,124,163,6,16,750,606,144,10
2118,2022-03-30 06:00:00,138,132,13,13,619,433,186,6
2119,2022-03-30 07:00:00,54,245,6,18,736,636,100,9
2120,2022-03-30 08:00:00,140,220,13,11,502,387,115,6
2121,2022-03-30 09:00:00,92,200,13,11,758,659,99,5
2122,2022-03-30 10:00:00,54,117,8,13,615,547,68,12
2123,2022-03-30 11:00:00,139,157,14,11,724,626,98,13
2124,2022-03-30 12:00:00,97,115,13,15,579,491,88,6
2125,2022-03-30 13:00:00,73,114,12,15,755,600,155,7
2126,2022-03-30 14:00:00,112,144,8,11,797,706,91,5
2127,2022-03-30 15:00:00,108,282,7,17,722,587,135,14
2128,2022-03-30 16:00:00,111,129,14,14,711,565,146,5
2129,2022-03-30 17:00:00,130,124,11,16,619,493,126,10
2130,2022-03-30 18:00:00,106,122,13,10,736,650,86,10
2131,2022-03-30 19:00:00,102,178,6,16,789,664,125,14
2132,2022-03-30 20:00:00,148,239,13,15,606,435,171,14
2133,2022-03-30 21:00:00,95,142,11,19,686,498,188,10
2134,2022-03-30 22:00:00,109,234,14,19,796,564,232,8
2135,2022-03-30 23:00:00,75,120,8,10,608,463,145,6
2136,2022-03-31 00:00:00,96,231,14,10,749,647,102,8
2137,2022-03-31 01:00:00,120,108,5,17,587,434,153,10
2138,2022-03-31 02:00:00,146,215,5,15,769,547,222,9
2139,2022-03-31 03:00:00,108,211,12,15,734,549,185,7
2140,2022-03-31 04:00:00,105,146,13,14,502,351,151,13
2141,2022-03-31 05:00:00,87,120,12,11,700,576,124,13
2142,2022-03-31 06:00:00,111,278,5,12,629,492,137,7
2143,2022-03-31 07:00:00,84,247,13,12,573,449,124,9
2144,2022-03-31 08:00:00,80,165,5,13,569,427,142,6
2145,2022-03-31 09:00:00,137,288,13,10,759,667,92,8
2146,2022-03-31 10:00:00,98,209,6,11,667,492,175,11
2147,2022-03-31 11:00:00,130,127,6,16,579,447,132,8
2148,2022-03-31 12:00:00,138,135,6,16,744,661,83,5
2149,2022-03-31 13:00:00,73,196,9,19,737,555,182,13
2150,2022-03-31 14:00:00,67,233,11,19,684,549,135,13
2151,2022-03-31 15:00:00,75,267,11,13,673,492,181,10
2152,2022-03-31 16:00:00,94,203,14,11,756,529,227,9
2153,2022-03-31 17:00:00,84,137,13,13,641,573,68,5
2154,2022-03-31 18:00:00,103,214,12,17,546,439,107,9
2155,2022-03-31 19:00:00,144,166,14,16,567,474,93,8
2156,2022-03-31 20:00:00,103,190,14,17,613,493,120,6
2157,2022-03-31 21:00:00,88,236,11,13,555,455,100,6
2158,2022-03-31 22:00:00,75,215,13,13,502,387,115,11
2159,2022-03-31 23:00:00,133,257,6,14,739,520,219,13
2160,2022-04-01 00:00:00,52,273,7,10,541,391,150,8
2161,2022-04-01 01:00:00,116,131,8,15,555,451,104,6
2162,2022-04-01 02:00:00,67,143,13,11,772,602,170,13
2163,2022-04-01 03:00:00,126,147,7,17,521,376,145,11
2164,2022-04-01 04:00:00,148,198,13,18,573,433,140,12
2165,2022-04-01 05:00:00,72,153,10,12,647,523,124,11
2166,2022-04-01 06:00:00,125,191,9,18,585,482,103,9
2167,2022-04-01 07:00:00,78,231,9,17,611,449,162,9
2168,2022-04-01 08:00:00,51,153,5,15,762,663,99,5
2169,2022-04-01 09:00:00,111,188,6,14,747,602,145,5
2170,2022-04-01 10:00:00,53,291,6,19,747,572,175,7
2171,2022-04-01 11:00:00,122,155,12,12,713,632,81,6
2172,2022-04-01 12:00:00,77,253,9,13,546,428,118,13
2173,2022-04-01 13:00:00,58,202,8,17,557,434,123,6
2174,2022-04-01 14:00:00,146,231,6,15,678,567,111,11
2175,2022-04-01 15:00:00,115,278,9,18,705,624,81,5
2176,2022-04-01 16:00:00,86,122,11,16,597,514,83,10
2177,2022-04-01 17:00:00,96,136,8,10,591,494,97,10
2178,2022-04-01 18:00:00,121,194,5,17,561,477,84,13
2179,2022-04-01 19:00:00,139,233,10,15,515,374,141,7
2180,2022-04-01 20:00:00,132,273,14,16,566,463,103,9
2181,2022-04-01 21:00:00,99,135,7,14,536,465,71,9
2182,2022-04-01 22:00:00,141,102,5,10,794,592,202,8
2183,2022-04-01 23:00:00,82,259,12,18,795,607,188,9
2184,2022-04-02 00:00:00,77,204,12,11,536,381,155,12
2185,2022-04-02 01:00:00,52,204,10,10,692,575,117,5
2186,2022-04-02 02:00:00,82,132,8,13,734,569,165,14
2187,2022-04-02 03:00:00,80,112,8,17,797,712,85,13
2188,2022-04-02 04:00:00,62,280,14,11,528,443,85,8
2189,2022-04-02 05:00:00,119,242,11,17,548,453,95,5
2190,2022-04-02 06:00:00,55,125,14,14,790,694,96,6
2191,2022-04-02 07:00:00,115,286,11,12,717,571,146,11
2192,2022-04-02 08:00:00,116,231,12,15,755,667,88,13
2193,2022-04-02 09:00:00,79,205,12,15,775,572,203,10
2194,2022-04-02 10:00:00,130,120,9,17,778,559,219,8
2195,2022-04-02 11:00:00,142,119,7,13,677,579,98,6
2196,2022-04-02 12:00:00,65,265,7,16,708,624,84,11
2197,2022-04-02 13:00:00,129,179,5,15,577,428,149,14
2198,2022-04-02 14:00:00,75,210,9,14,581,432,149,13
2199,2022-04-02 15:00:00,74,203,13,15,733,552,181,13
2200,2022-04-02 16:00:00,55,235,5,19,616,512,104,7
2201,2022-04-02 17:00:00,140,151,6,16,500,370,130,7
2202,2022-04-02 18:00:00,96,278,7,18,701,598,103,13
2203,2022-04-02 19:00:00,111,275,6,17,591,420,171,5
2204,2022-04-02 20:00:00,81,269,5,15,518,456,62,13
2205,2022-04-02 21:00:00,84,139,11,13,673,599,74,7
2206,2022-04-02 22:00:00,110,225,11,11,514,454,60,10
2207,2022-04-02 23:00:00,117,241,10,10,782,551,231,6
2208,2022-04-03 00:00:00,67,109,14,15,741,570,171,11
2209,2022-04-03 01:00:00,119,220,14,13,723,546,177,13
2210,2022-04-03 02:00:00,136,214,8,11,571,494,77,8
2211,2022-04-03 03:00:00,135,284,13,13,750,553,197,9
2212,2022-04-03 04:00:00,127,180,10,16,659,513,146,6
2213,2022-04-03 05:00:00,69,167,9,12,520,380,140,7
2214,2022-04-03 06:00:00,104,193,11,11,624,495,129,9
2215,2022-04-03 07:00:00,125,274,12,19,726,609,117,12
2216,2022-04-03 08:00:00,106,182,10,10,748,612,136,11
2217,2022-04-03 09:00:00,110,253,8,12,508,379,129,13
2218,2022-04-03 10:00:00,131,165,7,13,762,577,185,8
2219,2022-04-03 11:00:00,70,299,6,13,750,577,173,11
2220,2022-04-03 12:00:00,120,191,10,17,734,517,217,9
2221,2022-04-03 13:00:00,82,249,8,19,560,482,78,11
2222,2022-04-03 14:00:00,50,275,13,15,792,644,148,6
2223,2022-04-03 15:00:00,85,245,11,13,662,572,90,12
2224,2022-04-03 16:00:00,99,167,12,17,502,377,125,8
2225,2022-04-03 17:00:00,131,159,6,19,770,574,196,9
2226,2022-04-03 18:00:00,137,132,13,11,615,461,154,9
2227,2022-04-03 19:00:00,79,122,11,10,551,386,165,12
2228,2022-04-03 20:00:00,144,267,6,12,616,466,150,11
2229,2022-04-03 21:00:00,127,103,8,16,589,418,171,7
2230,2022-04-03 22:00:00,78,281,10,17,707,629,78,14
2231,2022-04-03 23:00:00,137,281,10,14,559,452,107,11
2232,2022-04-04 00:00:00,130,101,8,13,791,703,88,11
2233,2022-04-04 01:00:00,70,249,10,17,650,473,177,9
2234,2022-04-04 02:00:00,75,212,10,14,712,628,84,14
2235,2022-04-04 03:00:00,143,155,6,14,519,450,69,12
2236,2022-04-04 04:00:00,128,103,12,16,573,470,103,9
2237,2022-04-04 05:00:00,89,265,5,11,682,554,128,7
2238,2022-04-04 06:00:00,127,101,8,10,683,605,78,9
2239,2022-04-04 07:00:00,69,234,8,16,761,597,164,12
2240,2022-04-04 08:00:00,90,256,5,16,625,473,152,14
2241,2022-04-04 09:00:00,108,214,11,11,750,543,207,9
2242,2022-04-04 10:00:00,99,116,8,16,633,448,185,14
2243,2022-04-04 11:00:00,121,239,5,16,587,503,84,6
2244,2022-04-04 12:00:00,112,229,6,10,704,611,93,9
2245,2022-04-04 13:00:00,121,277,11,15,526,410,116,14
2246,2022-04-04 14:00:00,136,138,5,11,696,596,100,11
2247,2022-04-04 15:00:00,138,293,5,19,778,700,78,13
2248,2022-04-04 16:00:00,134,106,13,16,539,415,124,8
2249,2022-04-04 17:00:00,114,219,7,17,769,656,113,14
2250,2022-04-04 18:00:00,135,289,14,15,685,598,87,10
2251,2022-04-04 19:00:00,67,130,8,14,713,617,96,9
2252,2022-04-04 20:00:00,122,189,11,17,651,470,181,7
2253,2022-04-04 21:00:00,97,104,7,16,517,408,109,14
2254,2022-04-04 22:00:00,131,100,7,15,519,416,103,12
2255,2022-04-04 23:00:00,90,234,10,16,686,552,134,13
2256,2022-04-05 00:00:00,61,296,13,14,781,655,126,11
2257,2022-04-05 01:00:00,133,168,10,11,719,593,126,8
2258,2022-04-05 02:00:00,69,140,9,18,500,360,140,13
2259,2022-04-05 03:00:00,87,107,13,11,598,484,114,11
2260,2022-04-05 04:00:00,120,167,5,15,638,542,96,10
2261,2022-04-05 05:00:00,137,114,10,10,756,620,136,14
2262,2022-04-05 06:00:00,88,135,11,15,711,506,205,6
2263,2022-04-05 07:00:00,83,244,13,10,530,382,148,13
2264,2022-04-05 08:00:00,118,163,6,16,719,558,161,7
2265,2022-04-05 09:00:00,115,109,8,18,625,540,85,6
2266,2022-04-05 10:00:00,129,188,7,10,593,520,73,12
2267,2022-04-05 11:00:00,85,182,8,15,753,585,168,11
2268,2022-04-05 12:00:00,119,188,13,13,572,501,71,14
2269,2022-04-05 13:00:00,148,297,12,13,581,485,96,9
2270,2022-04-05 14:00:00,51,141,11,18,723,613,110,14
2271,2022-04-05 15:00:00,101,232,5,10,539,465,74,9
2272,2022-04-05 16:00:00,145,163,10,13,587,456,131,8
2273,2022-04-05 17:00:00,120,187,8,17,631,476,155,13
2274,2022-04-05 18:00:00,88,184,13,18,573,438,135,8
2275,2022-04-05 19:00:00,92,193,5,13,634,527,107,13
2276,2022-04-05 20:00:00,69,211,11,15,727,532,195,7
2277,2022-04-05 21:00:00,101,299,9,11,546,437,109,11
2278,2022-04-05 22:00:00,59,153,8,15,656,570,86,10
2279,2022-04-05 23:00:00,89,250,10,14,658,540,118,11
2280,2022-04-06 00:00:00,86,129,10,11,686,567,119,11
2281,2022-04-06 01:00:00,86,115,12,14,734,555,179,11
2282,2022-04-06 02:00:00,123,164,5,15,518,462,56,10
2283,2022-04-06 03:00:00,136,241,11,18,760,647,113,13
2284,2022-04-06 04:00:00,118,291,14,15,706,577,129,10
2285,2022-04-06 05:00:00,101,289,11,13,653,542,111,9
2286,2022-04-06 06:00:00,60,209,12,14,524,463,61,10
2287,2022-04-06 07:00:00,117,121,11,16,749,568,181,9
2288,2022-04-06 08:00:00,89,207,10,16,644,566,78,11
2289,2022-04-06 09:00:00,60,245,14,15,680,498,182,10
2290,2022-04-06 10:00:00,122,283,7,12,765,622,143,13
2291,2022-04-06 11:00:00,112,248,6,17,669,553,116,9
2292,2022-04-06 12:00:00,118,110,12,18,787,705,82,10
2293,2022-04-06 13:00:00,94,104,12,10,612,521,91,12
2294,2022-04-06 14:00:00,75,109,13,17,692,578,114,10
2295,2022-04-06 15:00:00,138,226,10,14,738,543,195,9
2296,2022-04-06 16:00:00,123,111,12,12,545,458,87,6
2297,2022-04-06 17:00:00,54,160,11,16,504,365,139,11
2298,2022-04-06 18:00:00,135,264,7,11,535,477,58,13
2299,2022-04-06 19:00:00,125,154,5,18,616,535,81,9
2300,2022-04-06 20:00:00,73,275,10,12,710,603,107,5
2301,2022-04-06 21:00:00,122,159,12,15,546,392,154,10
2302,2022-04-06 22:00:00,100,181,9,18,778,599,179,14
2303,2022-04-06 23:00:00,115,162,14,18,769,658,111,10
2304,2022-04-07 00:00:00,106,225,13,17,764,600,164,14
2305,2022-04-07 01:00:00,60,216,5,10,577,408,169,8
2306,2022-04-07 02:00:00,115,299,9,19,522,445,77,8
2307,2022-04-07 03:00:00,132,175,14,18,677,502,175,9
2308,2022-04-07 04:00:00,69,195,8,14,650,573,77,8
2309,2022-04-07 05:00:00,80,230,11,17,674,591,83,6
2310,2022-04-07 06:00:00,139,232,5,15,584,502,82,13
2311,2022-04-07 07:00:00,58,283,12,18,773,570,203,11
2312,2022-04-07 08:00:00,111,156,8,10,531,399,132,6
2313,2022-04-07 09:00:00,59,172,8,18,580,461,119,9
2314,2022-04-07 10:00:00,71,218,7,13,653,488,165,5
2315,2022-04-07 11:00:00,133,257,7,10,557,457,100,10
2316,2022-04-07 12:00:00,107,258,9,10,680,581,99,5
2317,2022-04-07 13:00:00,56,297,10,13,783,576,207,13
2318,2022-04-07 14:00:00,52,171,10,17,711,524,187,12
2319,2022-04-07 15:00:00,149,157,11,13,783,653,130,14
2320,2022-04-07 16:00:00,92,291,5,12,500,449,51,5
2321,2022-04-07 17:00:00,81,259,13,11,514,376,138,13
2322,2022-04-07 18:00:00,94,118,9,17,703,590,113,10
2323,2022-04-07 19:00:00,73,194,13,19,701,509,192,5
2324,2022-04-07 20:00:00,61,287,12,16,503,446,57,9
2325,2022-04-07 21:00:00,126,299,12,18,788,553,235,10
2326,2022-04-07 22:00:00,52,297,11,11,763,614,149,14
2327,2022-04-07 23:00:00,62,237,14,15,610,475,135,10
2328,2022-04-08 00:00:00,64,140,9,11,543,413,130,10
2329,2022-04-08 01:00:00,100,160,10,12,649,483,166,5
2330,2022-04-08 02:00:00,83,290,9,15,547,489,58,7
2331,2022-04-08 03:00:00,64,222,11,16,748,573,175,6
2332,2022-04-08 04:00:00,58,223,9,18,731,595,136,14
2333,2022-04-08 05:00:00,108,142,13,10,795,686,109,5
2334,2022-04-08 06:00:00,139,155,10,10,707,603,104,13
2335,2022-04-08 07:00:00,90,165,14,16,725,533,192,11
2336,2022-04-08 08:00:00,105,237,14,19,772,571,201,13
2337,2022-04-08 09:00:00,94,226,9,17,719,602,117,7
2338,2022-04-08 10:00:00,61,101,9,10,705,528,177,9
2339,2022-04-08 11:00:00,86,134,12,13,610,539,71,12
2340,2022-04-08 12:00:00,84,230,14,14,761,601,160,12
2341,2022-04-08 13:00:00,106,282,12,12,603,516,87,13
2342,2022-04-08 14:00:00,126,149,10,18,586,488,98,5
2343,2022-04-08 15:00:00,85,226,12,18,713,638,75,5
2344,2022-04-08 16:00:00,105,196,14,13,764,675,89,13
2345,2022-04-08 17:00:00,90,113,5,14,655,506,149,11
2346,2022-04-08 18:00:00,52,195,11,14,765,660,105,9
2347,2022-04-08 19:00:00,106,166,8,13,539,378,161,13
2348,2022-04-08 20:00:00,50,237,10,10,529,433,96,10
2349,2022-04-08 21:00:00,129,294,14,19,749,656,93,12
2350,2022-04-08 22:00:00,122,251,9,10,615,551,64,6
2351,2022-04-08 23:00:00,87,120,14,14,741,650,91,6
2352,2022-04-09 00:00:00,149,112,13,17,600,421,179,6
2353,2022-04-09 01:00:00,146,234,11,18,557,465,92,5
2354,2022-04-09 02:00:00,75,243,12,15,597,533,64,6
2355,2022-04-09 03:00:00,72,107,9,11,520,438,82,14
2356,2022-04-09 04:00:00,98,189,6,11,683,591,92,13
2357,2022-04-09 05:00:00,59,124,7,10,781,549,232,8
2358,2022-04-09 06:00:00,109,224,8,16,522,424,98,14
2359,2022-04-09 07:00:00,143,264,7,10,575,487,88,12
2360,2022-04-09 08:00:00,132,217,14,18,761,650,111,5
2361,2022-04-09 09:00:00,128,140,13,11,548,456,92,8
2362,2022-04-09 10:00:00,84,153,9,15,682,494,188,7
2363,2022-04-09 11:00:00,63,235,7,10,781,659,122,6
2364,2022-04-09 12:00:00,132,132,6,15,731,542,189,6
2365,2022-04-09 13:00:00,105,162,8,11,666,482,184,6
2366,2022-04-09 14:00:00,114,169,13,12,782,692,90,6
2367,2022-04-09 15:00:00,67,222,7,13,746,588,158,6
2368,2022-04-09 16:00:00,131,299,7,18,742,549,193,11
2369,2022-04-09 17:00:00,75,154,9,17,540,411,129,6
2370,2022-04-09 18:00:00,80,190,7,14,609,532,77,14
2371,2022-04-09 19:00:00,80,156,6,10,764,585,179,7
2372,2022-04-09 20:00:00,122,137,14,15,673,541,132,13
2373,2022-04-09 21:00:00,89,201,13,13,707,560,147,6
2374,2022-04-09 22:00:00,139,260,11,11,531,445,86,13
2375,2022-04-09 23:00:00,114,112,8,17,506,453,53,13
2376,2022-04-10 00:00:00,137,118,12,10,584,419,165,9
2377,2022-04-10 01:00:00,104,297,12,19,774,616,158,9
2378,2022-04-10 02:00:00,110,126,10,16,674,473,201,5
2379,2022-04-10 03:00:00,62,223,6,17,563,462,101,13
2380,2022-04-10 04:00:00,65,106,12,17,767,583,184,9
2381,2022-04-10 05:00:00,117,214,5,10,757,576,181,5
2382,2022-04-10 06:00:00,106,159,11,16,523,435,88,7
2383,2022-04-10 07:00:00,134,279,7,15,522,408,114,12
2384,2022-04-10 08:00:00,73,153,5,19,734,656,78,14
2385,2022-04-10 09:00:00,122,141,13,11,782,612,170,8
2386,2022-04-10 10:00:00,127,136,5,18,527,371,156,11
2387,2022-04-10 11:00:00,132,181,10,15,545,418,127,11
2388,2022-04-10 12:00:00,137,253,10,17,677,475,202,6
2389,2022-04-10 13:00:00,143,274,13,11,545,399,146,10
2390,2022-04-10 14:00:00,109,125,5,13,688,580,108,12
2391,2022-04-10 15:00:00,123,196,11,15,508,454,54,11
2392,2022-04-10 16:00:00,66,183,9,11,634,549,85,10
2393,2022-04-10 17:00:00,125,148,13,17,647,495,152,11
2394,2022-04-10 18:00:00,104,265,12,16,714,500,214,12
2395,2022-04-10 19:00:00,130,132,13,13,658,498,160,12
2396,2022-04-10 20:00:00,97,150,9,12,640,545,95,11
2397,2022-04-10 21:00:00,63,210,6,11,528,448,80,9
2398,2022-04-10 22:00:00,140,202,8,17,607,444,163,8
2399,2022-04-10 23:00:00,128,112,7,13,700,606,94,12
2400,2022-04-11 00:00:00,136,210,14,15,587,524,63,10
2401,2022-04-11 01:00:00,110,204,7,15,706,524,182,8
2402,2022-04-11 02:00:00,70,204,13,18,760,609,151,12
2403,2022-04-11 03:00:00,96,148,10,19,681,583,98,5
2404,2022-04-11 04:00:00,103,206,7,19,750,674,76,12
2405,2022-04-11 05:00:00,62,176,8,18,706,610,96,5
2406,2022-04-11 06:00:00,138,281,5,14,762,569,193,7
2407,2022-04-11 07:00:00,96,182,8,17,671,474,197,12
2408,2022-04-11 08:00:00,105,228,8,12,611,502,109,5
2409,2022-04-11 09:00:00,64,249,12,17,738,578,160,9
2410,2022-04-11 10:00:00,113,253,8,19,799,591,208,14
2411,2022-04-11 11:00:00,108,179,9,16,541,431,110,12
2412,2022-04-11 12:00:00,129,271,6,19,630,563,67,6
2413,2022-04-11 13:00:00,121,134,13,13,522,425,97,14
2414,2022-04-11 14:00:00,115,118,11,17,724,574,150,5
2415,2022-04-11 15:00:00,80,283,9,15,640,475,165,7
2416,2022-04-11 16:00:00,82,182,6,11,696,589,107,9
2417,2022-04-11 17:00:00,58,141,14,17,675,572,103,7
2418,2022-04-11 18:00:00,123,125,8,13,670,584,86,14
2419,2022-04-11 19:00:00,144,269,10,11,600,477,123,14
2420,2022-04-11 20:00:00,75,261,9,12,700,573,127,13
2421,2022-04-11 21:00:00,66,165,11,12,731,633,98,12
2422,2022-04-11 22:00:00,124,132,13,16,584,509,75,7
2423,2022-04-11 23:00:00,130,205,12,14,534,424,110,10
2424,2022-04-12 00:00:00,55,287,14,10,502,394,108,5
2425,2022-04-12 01:00:00,75,158,9,12,645,499,146,14
2426,2022-04-12 02:00:00,95,229,8,17,669,554,115,6
2427,2022-04-12 03:00:00,105,161,10,14,785,672,113,14
2428,2022-04-12 04:00:00,114,259,8,14,692,505,187,11
2429,2022-04-12 05:00:00,95,276,10,19,544,468,76,5
2430,2022-04-12 06:00:00,120,110,9,18,767,540,227,7
2431,2022-04-12 07:00:00,52,188,13,16,546,473,73,7
2432,2022-04-12 08:00:00,95,114,9,10,749,536,213,13
2433,2022-04-12 09:00:00,88,286,6,18,714,513,201,8
2434,2022-04-12 10:00:00,89,274,13,16,542,390,152,8
2435,2022-04-12 11:00:00,74,298,9,18,651,456,195,10
2436,2022-04-12 12:00:00,118,236,7,14,563,420,143,8
2437,2022-04-12 13:00:00,138,136,14,13,555,482,73,7
2438,2022-04-12 14:00:00,74,211,6,14,744,573,171,7
2439,2022-04-12 15:00:00,56,270,12,17,746,641,105,5
2440,2022-04-12 16:00:00,145,272,11,14,680,496,184,13
2441,2022-04-12 17:00:00,113,255,7,18,740,524,216,13
2442,2022-04-12 18:00:00,67,292,9,11,536,405,131,11
2443,2022-04-12 19:00:00,141,112,9,13,694,525,169,10
2444,2022-04-12 20:00:00,60,261,5,14,599,450,149,10
2445,2022-04-12 21:00:00,87,100,10,15,670,577,93,7
2446,2022-04-12 22:00:00,138,238,13,11,741,537,204,5
2447,2022-04-12 23:00:00,92,243,14,13,500,422,78,10
2448,2022-04-13 00:00:00,50,111,11,13,509,400,109,12
2449,2022-04-13 01:00:00,79,158,10,11,673,491,182,13
2450,2022-04-13 02:00:00,54,172,9,13,714,507,207,12
2451,2022-04-13 03:00:00,142,279,12,14,588,509,79,7
2452,2022-04-13 04:00:00,135,217,8,14,635,570,65,12
2453,2022-04-13 05:00:00,109,263,7,17,506,440,66,10
2454,2022-04-13 06:00:00,64,270,12,15,597,505,92,11
2455,2022-04-13 07:00:00,76,228,5,14,603,522,81,11
2456,2022-04-13 08:00:00,71,153,10,10,776,599,177,7
2457,2022-04-13 09:00:00,100,288,13,19,566,411,155,14
2458,2022-04-13 10:00:00,113,179,9,11,699,540,159,7
2459,2022-04-13 11:00:00,112,218,5,18,573,459,114,9
2460,2022-04-13 12:00:00,88,221,9,19,692,523,169,7
2461,2022-04-13 13:00:00,59,278,5,19,628,457,171,9
2462,2022-04-13 14:00:00,67,121,11,13,641,508,133,7
2463,2022-04-13 15:00:00,51,221,7,16,592,448,144,6
2464,2022-04-13 16:00:00,141,264,13,18,736,547,189,13
2465,2022-04-13 17:00:00,132,138,13,12,602,500,102,9
2466,2022-04-13 18:00:00,63,278,6,10,727,600,127,14
2467,2022-04-13 19:00:00,143,132,10,15,572,411,161,5
2468,2022-04-13 20:00:00,68,191,9,11,554,461,93,10
2469,2022-04-13 21:00:00,86,133,9,11,644,566,78,7
2470,2022-04-13 22:00:00,108,173,10,16,758,658,100,11
2471,2022-04-13 23:00:00,92,195,9,12,655,584,71,6
2472,2022-04-14 00:00:00,73,137,7,11,515,387,128,7
2473,2022-04-14 01:00:00,139,120,5,16,610,511,99,6
2474,2022-04-14 02:00:00,111,280,8,14,729,646,83,7
2475,2022-04-14 03:00:00,78,254,10,18,550,491,59,12
2476,2022-04-14 04:00:00,126,237,5,17,590,497,93,14
2477,2022-04-14 05:00:00,79,288,10,14,690,603,87,8
2478,2022-04-14 06:00:00,60,248,12,10,562,432,130,8
2479,2022-04-14 07:00:00,68,237,13,17,646,550,96,11
2480,2022-04-14 08:00:00,120,239,12,17,649,526,123,9
2481,2022-04-14 09:00:00,140,199,7,13,574,433,141,11
2482,2022-04-14 10:00:00,134,260,11,19,705,579,126,8
2483,2022-04-14 11:00:00,141,220,10,19,725,628,97,12
2484,2022-04-14 12:00:00,53,103,7,13,711,510,201,5
2485,2022-04-14 13:00:00,52,136,13,17,598,419,179,8
2486,2022-04-14 14:00:00,108,262,8,16,775,649,126,5
2487,2022-04-14 15:00:00,123,273,6,10,746,575,171,7
2488,2022-04-14 16:00:00,91,188,13,12,548,474,74,9
2489,2022-04-14 17:00:00,69,128,7,17,646,557,89,7
2490,2022-04-14 18:00:00,113,270,7,15,689,547,142,7
2491,2022-04-14 19:00:00,74,227,5,10,794,701,93,13
2492,2022-04-14 20:00:00,84,141,13,10,511,404,107,9
2493,2022-04-14 21:00:00,85,215,12,18,553,482,71,5
2494,2022-04-14 22:00:00,65,286,12,16,717,510,207,10
2495,2022-04-14 23:00:00,116,136,6,17,671,494,177,11
2496,2022-04-15 00:00:00,51,191,11,10,705,611,94,5
2497,2022-04-15 01:00:00,96,213,14,12,794,625,169,6
2498,2022-04-15 02:00:00,143,224,12,13,562,409,153,9
2499,2022-04-15 03:00:00,56,213,7,18,715,622,93,8
2500,2022-04-15 04:00:00,133,233,5,10,606,514,92,8
2501,2022-04-15 05:00:00,87,277,9,11,670,562,108,9
2502,2022-04-15 06:00:00,51,162,7,12,621,543,78,14
2503,2022-04-15 07:00:00,140,212,11,16,676,540,136,11
2504,2022-04-15 08:00:00,78,172,11,19,618,477,141,9
2505,2022-04-15 09:00:00,104,133,7,19,580,451,129,14
2506,2022-04-15 10:00:00,82,289,5,14,577,454,123,7
2507,2022-04-15 11:00:00,103,234,10,17,592,447,145,14
2508,2022-04-15 12:00:00,135,134,8,11,568,481,87,10
2509,2022-04-15 13:00:00,136,175,12,16,554,445,109,6
2510,2022-04-15 14:00:00,109,222,5,11,563,424,139,6
2511,2022-04-15 15:00:00,86,162,6,19,612,537,75,7
2512,2022-04-15 16:00:00,141,104,7,16,696,543,153,7
2513,2022-04-15 17:00:00,138,291,6,10,760,622,138,11
2514,2022-04-15 18:00:00,51,100,11,16,771,656,115,11
2515,2022-04-15 19:00:00,122,273,5,18,551,416,135,6
2516,2022-04-15 20:00:00,87,286,6,14,511,374,137,6
2517,2022-04-15 21:00:00,103,224,13,11,575,462,113,12
2518,2022-04-15 22:00:00,85,192,7,11,546,465,81,6
2519,2022-04-15 23:00:00,62,275,11,17,785,640,145,14
2520,2022-04-16 00:00:00,62,260,10,10,572,474,98,6
2521,2022-04-16 01:00:00,127,283,11,17,591,521,70,7
2522,2022-04-16 02:00:00,79,180,9,13,622,510,112,10
2523,2022-04-16 03:00:00,87,240,9,11,633,554,79,7
2524,2022-04-16 04:00:00,100,287,9,12,678,487,191,9
2525,2022-04-16 05:00:00,85,148,10,14,541,399,142,13
2526,2022-04-16 06:00:00,81,226,8,15,705,550,155,6
2527,2022-04-16 07:00:00,146,187,10,11,607,494,113,6
2528,2022-04-16 08:00:00,144,228,10,12,556,406,150,11
2529,2022-04-16 09:00:00,94,178,7,18,583,455,128,8
2530,2022-04-16 10:00:00,127,241,6,12,507,416,91,6
2531,2022-04-16 11:00:00,134,170,8,14,796,668,128,13
2532,2022-04-16 12:00:00,115,296,14,18,544,402,142,7
2533,2022-04-16 13:00:00,67,205,5,17,676,508,168,6
2534,2022-04-16 14:00:00,93,188,10,13,612,476,136,6
2535,2022-04-16 15:00:00,115,168,12,17,671,583,88,12
2536,2022-04-16 16:00:00,99,149,12,18,674,517,157,9
2537,2022-04-16 17:00:00,99,147,5,13,603,510,93,10
2538,2022-04-16 18:00:00,96,223,9,15,525,433,92,13
2539,2022-04-16 19:00:00,101,272,14,14,680,528,152,7
2540,2022-04-16 20:00:00,64,241,14,11,637,569,68,14
2541,2022-04-16 21:00:00,68,232,10,16,693,568,125,9
2542,2022-04-16 22:00:00,111,267,11,16,661,554,107,8
2543,2022-04-16 23:00:00,141,242,9,18,795,584,211,14
2544,2022-04-17 00:00:00,130,147,5,12,793,661,132,9
2545,2022-04-17 01:00:00,94,101,10,11,616,445,171,7
2546,2022-04-17 02:00:00,126,280,14,18,716,590,126,10
2547,2022-04-17 03:00:00,101,203,7,16,729,577,152,8
2548,2022-04-17 04:00:00,139,133,10,18,744,629,115,10
2549,2022-04-17 05:00:00,145,110,14,15,537,401,136,10
2550,2022-04-17 06:00:00,137,182,13,18,781,573,208,5
2551,2022-04-17 07:00:00,135,164,6,10,575,479,96,5
2552,2022-04-17 08:00:00,120,159,10,17,625,499,126,10
2553,2022-04-17 09:00:00,123,230,14,16,585,432,153,14
2554,2022-04-17 10:00:00,68,170,11,12,743,614,129,7
2555,2022-04-17 11:00:00,119,223,10,12,557,454,103,8
2556,2022-04-17 12:00:00,84,203,5,19,699,599,100,8
2557,2022-04-17 13:00:00,86,190,11,16,740,544,196,6
2558,2022-04-17 14:00:00,126,173,6,18,500,382,118,7
2559,2022-04-17 15:00:00,112,175,13,16,537,403,134,5
2560,2022-04-17 16:00:00,126,287,10,17,794,669,125,13
2561,2022-04-17 17:00:00,81,212,6,19,714,506,208,9
2562,2022-04-17 18:00:00,122,132,14,18,762,682,80,12
2563,2022-04-17 19:00:00,132,200,7,15,768,575,193,13
2564,2022-04-17 20:00:00,112,140,13,15,668,590,78,13
2565,2022-04-17 21:00:00,109,150,13,12,516,430,86,13
2566,2022-04-17 22:00:00,138,285,10,15,563,453,110,12
2567,2022-04-17 23:00:00,140,243,10,17,770,552,218,7
2568,2022-04-18 00:00:00,56,156,5,16,680,580,100,9
2569,2022-04-18 01:00:00,142,279,14,19,597,514,83,14
2570,2022-04-18 02:00:00,81,191,7,15,546,391,155,11
2571,2022-04-18 03:00:00,59,246,11,19,753,595,158,12
2572,2022-04-18 04:00:00,60,124,6,13,706,558,148,8
2573,2022-04-18 05:00:00,66,124,7,10,667,584,83,10
2574,2022-04-18 06:00:00,91,282,8,16,525,387,138,8
2575,2022-04-18 07:00:00,147,264,10,18,700,604,96,12
2576,2022-04-18 08:00:00,93,245,13,14,633,476,157,6
2577,2022-04-18 09:00:00,66,180,13,14,758,664,94,11
2578,2022-04-18 10:00:00,144,175,5,12,674,535,139,8
2579,2022-04-18 11:00:00,87,134,9,13,500,433,67,11
2580,2022-04-18 12:00:00,116,270,12,10,640,496,144,6
2581,2022-04-18 13:00:00,121,291,11,17,694,533,161,8
2582,2022-04-18 14:00:00,110,223,7,18,603,488,115,8
2583,2022-04-18 15:00:00,122,111,6,12,575,477,98,6
2584,2022-04-18 16:00:00,71,244,7,19,645,488,157,7
2585,2022-04-18 17:00:00,117,125,5,19,581,503,78,6
2586,2022-04-18 18:00:00,104,212,11,17,628,516,112,8
2587,2022-04-18 19:00:00,70,182,9,14,534,468,66,6
2588,2022-04-18 20:00:00,66,241,12,14,711,614,97,14
2589,2022-04-18 21:00:00,136,134,13,14,550,457,93,9
2590,2022-04-18 22:00:00,135,267,9,11,661,520,141,10
2591,2022-04-18 23:00:00,115,270,14,19,735,528,207,6
2592,2022-04-19 00:00:00,134,187,8,13,532,392,140,14
2593,2022-04-19 01:00:00,140,142,7,12,536,471,65,6
2594,2022-04-19 02:00:00,62,130,5,12,602,483,119,10
2595,2022-04-19 03:00:00,104,181,10,18,530,384,146,5
2596,2022-04-19 04:00:00,65,173,9,19,509,357,152,5
2597,2022-04-19 05:00:00,54,217,13,16,690,503,187,10
2598,2022-04-19 06:00:00,66,249,13,10,794,574,220,10
2599,2022-04-19 07:00:00,102,139,5,11,678,516,162,9
2600,2022-04-19 08:00:00,62,195,9,16,660,549,111,11
2601,2022-04-19 09:00:00,81,190,5,17,588,419,169,11
2602,2022-04-19 10:00:00,111,221,11,15,691,499,192,6
2603,2022-04-19 11:00:00,53,106,6,15,570,467,103,14
2604,2022-04-19 12:00:00,116,266,13,14,633,536,97,9
2605,2022-04-19 13:00:00,60,192,14,13,680,551,129,8
2606,2022-04-19 14:00:00,110,222,9,13,703,609,94,8
2607,2022-04-19 15:00:00,107,284,13,18,575,462,113,14
2608,2022-04-19 16:00:00,110,267,14,14,679,541,138,12
2609,2022-04-19 17:00:00,60,259,5,12,735,586,149,7
2610,2022-04-19 18:00:00,71,133,10,10,574,499,75,13
2611,2022-04-19 19:00:00,76,182,10,17,569,502,67,12
2612,2022-04-19 20:00:00,123,149,6,15,519,428,91,5
2613,2022-04-19 21:00:00,130,104,10,19,567,498,69,10
2614,2022-04-19 22:00:00,77,189,9,13,598,449,149,14
2615,2022-04-19 23:00:00,52,221,7,11,555,417,138,11
2616,2022-04-20 00:00:00,139,258,13,16,661,554,107,14
2617,2022-04-20 01:00:00,84,289,12,17,767,623,144,7
2618,2022-04-20 02:00:00,57,140,6,11,701,569,132,14
2619,2022-04-20 03:00:00,75,128,6,14,749,563,186,11
2620,2022-04-20 04:00:00,109,257,11,19,788,633,155,8
2621,2022-04-20 05:00:00,100,104,14,19,724,531,193,5
2622,2022-04-20 06:00:00,59,182,10,13,674,596,78,5
2623,2022-04-20 07:00:00,89,174,7,14,793,611,182,11
2624,2022-04-20 08:00:00,94,296,10,11,773,584,189,9
2625,2022-04-20 09:00:00,56,296,11,12,582,415,167,6
2626,2022-04-20 10:00:00,128,122,8,12,557,454,103,8
2627,2022-04-20 11:00:00,116,205,14,19,590,506,84,13
2628,2022-04-20 12:00:00,117,168,10,10,532,472,60,5
2629,2022-04-20 13:00:00,74,181,5,17,520,463,57,7
2630,2022-04-20 14:00:00,137,177,9,17,731,621,110,6
2631,2022-04-20 15:00:00,146,184,6,10,659,554,105,7
2632,2022-04-20 16:00:00,87,142,6,16,715,515,200,14
2633,2022-04-20 17:00:00,143,203,12,11,748,564,184,5
2634,2022-04-20 18:00:00,145,229,14,18,572,493,79,12
2635,2022-04-20 19:00:00,107,119,5,16,653,564,89,8
2636,2022-04-20 20:00:00,130,105,7,12,509,441,68,7
2637,2022-04-20 21:00:00,142,104,11,17,616,443,173,8
2638,2022-04-20 22:00:00,52,293,12,11,525,372,153,6
2639,2022-04-20 23:00:00,105,171,11,13,557,410,147,9
2640,2022-04-21 00:00:00,132,250,14,13,624,547,77,12
2641,2022-04-21 01:00:00,77,264,11,15,556,444,112,6
2642,2022-04-21 02:00:00,119,204,11,14,584,473,111,6
2643,2022-04-21 03:00:00,106,292,10,18,772,580,192,7
2644,2022-04-21 04:00:00,89,248,14,12,792,696,96,9
2645,2022-04-21 05:00:00,62,183,13,16,618,435,183,14
2646,2022-04-21 06:00:00,137,116,13,15,512,451,61,13
2647,2022-04-21 07:00:00,52,135,13,17,534,441,93,13
2648,2022-04-21 08:00:00,54,262,10,12,775,692,83,7
2649,2022-04-21 09:00:00,73,214,5,13,563,454,109,7
2650,2022-04-21 10:00:00,81,218,7,17,751,579,172,7
2651,2022-04-21 11:00:00,119,233,9,16,626,537,89,9
2652,2022-04-21 12:00:00,148,184,8,13,768,577,191,6
2653,2022-04-21 13:00:00,67,201,7,16,727,532,195,9
2654,2022-04-21 14:00:00,137,246,8,17,743,668,75,7
2655,2022-04-21 15:00:00,97,253,10,11,579,443,136,13
2656,2022-04-21 16:00:00,97,111,5,13,694,513,181,11
2657,2022-04-21 17:00:00,72,282,8,16,518,448,70,7
2658,2022-04-21 18:00:00,129,238,10,17,621,479,142,8
2659,2022-04-21 19:00:00,90,291,13,17,705,519,186,6
2660,2022-04-21 20:00:00,51,115,11,19,784,690,94,11
2661,2022-04-21 21:00:00,114,193,6,15,538,397,141,13
2662,2022-04-21 22:00:00,111,197,6,15,768,634,134,10
2663,2022-04-21 23:00:00,68,272,13,18,728,513,215,9
2664,2022-04-22 00:00:00,98,258,9,10,794,598,196,13
2665,2022-04-22 01:00:00,104,153,10,17,797,571,226,6
2666,2022-04-22 02:00:00,134,108,12,15,734,573,161,14
2667,2022-04-22 03:00:00,56,217,7,19,530,466,64,7
2668,2022-04-22 04:00:00,108,140,8,11,607,463,144,9
2669,2022-04-22 05:00:00,108,224,11,17,776,631,145,8
2670,2022-04-22 06:00:00,54,168,8,19,709,543,166,7
2671,2022-04-22 07:00:00,88,148,5,15,709,555,154,12
2672,2022-04-22 08:00:00,149,246,12,11,621,491,130,5
2673,2022-04-22 09:00:00,67,102,12,17,588,487,101,11
2674,2022-04-22 10:00:00,119,125,14,11,698,623,75,9
2675,2022-04-22 11:00:00,58,193,6,13,548,456,92,7
2676,2022-04-22 12:00:00,107,103,8,12,722,638,84,9
2677,2022-04-22 13:00:00,143,168,11,10,537,463,74,11
2678,2022-04-22 14:00:00,112,237,8,18,740,544,196,7
2679,2022-04-22 15:00:00,139,137,13,15,671,478,193,5
2680,2022-04-22 16:00:00,84,291,12,14,629,469,160,6
2681,2022-04-22 17:00:00,88,100,14,11,674,489,185,12
2682,2022-04-22 18:00:00,134,204,12,13,544,480,64,12
2683,2022-04-22 19:00:00,52,293,6,13,668,578,90,5
2684,2022-04-22 20:00:00,121,214,11,11,639,451,188,10
2685,2022-04-22 21:00:00,72,211,12,12,779,548,231,10
2686,2022-04-22 22:00:00,74,134,5,17,509,427,82,7
2687,2022-04-22 23:00:00,104,207,13,18,702,579,123,12
2688,2022-04-23 00:00:00,59,210,13,14,549,396,153,9
2689,2022-04-23 01:00:00,138,272,9,10,708,511,197,13
2690,2022-04-23 02:00:00,125,215,13,12,788,597,191,5
2691,2022-04-23 03:00:00,113,124,5,12,559,426,133,12
2692,2022-04-23 04:00:00,51,265,5,16,588,431,157,11
2693,2022-04-23 05:00:00,147,121,6,15,710,608,102,11
2694,2022-04-23 06:00:00,149,275,14,19,532,401,131,6
2695,2022-04-23 07:00:00,89,195,13,16,736,565,171,13
2696,2022-04-23 08:00:00,69,169,5,18,748,532,216,5
2697,2022-04-23 09:00:00,102,138,11,15,754,589,165,9
2698,2022-04-23 10:00:00,92,187,7,19,674,500,174,14
2699,2022-04-23 11:00:00,84,152,14,16,551,448,103,6
2700,2022-04-23 12:00:00,146,157,11,12,612,513,99,7
2701,2022-04-23 13:00:00,110,248,12,11,782,642,140,11
2702,2022-04-23 14:00:00,100,281,9,11,724,648,76,14
2703,2022-04-23 15:00:00,108,189,12,12,589,527,62,10
2704,2022-04-23 16:00:00,130,105,14,14,503,363,140,13
2705,2022-04-23 17:00:00,52,128,9,11,551,425,126,13
2706,2022-04-23 18:00:00,118,145,14,19,763,585,178,8
2707,2022-04-23 19:00:00,117,268,14,18,704,587,117,10
2708,2022-04-23 20:00:00,114,275,9,14,732,535,197,8
2709,2022-04-23 21:00:00,138,282,6,17,780,557,223,5
2710,2022-04-23 22:00:00,98,104,14,19,513,400,113,12
2711,2022-04-23 23:00:00,113,240,5,19,569,466,103,5
2712,2022-04-24 00:00:00,88,232,11,19,550,480,70,13
2713,2022-04-24 01:00:00,146,255,12,16,657,570,87,12
2714,2022-04-24 02:00:00,93,153,5,13,500,416,84,9
2715,2022-04-24 03:00:00,144,263,14,12,670,559,111,12
2716,2022-04-24 04:00:00,105,224,6,11,533,454,79,13
2717,2022-04-24 05:00:00,82,237,12,11,737,623,114,12
2718,2022-04-24 06:00:00,95,255,13,13,506,418,88,11
2719,2022-04-24 07:00:00,83,221,10,14,606,435,171,9
2720,2022-04-24 08:00:00,61,136,5,17,713,623,90,13
2721,2022-04-24 09:00:00,106,218,7,10,674,547,127,7
2722,2022-04-24 10:00:00,121,181,13,10,649,518,131,14
2723,2022-04-24 11:00:00,76,264,5,18,610,484,126,8
2724,2022-04-24 12:00:00,78,187,10,16,795,711,84,12
2725,2022-04-24 13:00:00,51,201,14,18,553,412,141,10
2726,2022-04-24 14:00:00,117,116,9,13,735,585,150,8
2727,2022-04-24 15:00:00,102,277,9,14,675,504,171,8
2728,2022-04-24 16:00:00,109,225,7,15,618,531,87,5
2729,2022-04-24 17:00:00,60,237,13,17,787,595,192,6
2730,2022-04-24 18:00:00,116,243,5,19,534,432,102,9
2731,2022-04-24 19:00:00,105,213,9,16,545,448,97,6
2732,2022-04-24 20:00:00,108,214,11,17,572,465,107,14
2733,2022-04-24 21:00:00,106,199,13,17,690,596,94,7
2734,2022-04-24 22:00:00,96,119,10,16,668,558,110,12
2735,2022-04-24 23:00:00,110,284,9,18,719,533,186,13
2736,2022-04-25 00:00:00,96,261,10,19,655,495,160,14
2737,2022-04-25 01:00:00,135,193,14,14,541,478,63,10
2738,2022-04-25 02:00:00,140,275,6,19,501,430,71,7
2739,2022-04-25 03:00:00,138,191,6,11,741,573,168,9
2740,2022-04-25 04:00:00,134,198,8,14,690,493,197,8
2741,2022-04-25 05:00:00,100,257,13,16,789,656,133,12
2742,2022-04-25 06:00:00,69,104,7,14,670,579,91,7
2743,2022-04-25 07:00:00,73,244,12,14,611,465,146,8
2744,2022-04-25 08:00:00,96,240,11,13,538,471,67,7
2745,2022-04-25 09:00:00,97,279,11,18,631,483,148,6
2746,2022-04-25 10:00:00,98,149,7,13,739,518,221,13
2747,2022-04-25 11:00:00,111,148,5,13,616,498,118,7
2748,2022-04-25 12:00:00,109,157,10,14,605,461,144,10
2749,2022-04-25 13:00:00,85,106,13,15,636,481,155,6
2750,2022-04-25 14:00:00,93,236,13,16,503,450,53,8
2751,2022-04-25 15:00:00,61,139,5,19,691,536,155,5
2752,2022-04-25 16:00:00,129,199,12,16,617,432,185,9
2753,2022-04-25 17:00:00,139,279,8,18,564,397,167,7
2754,2022-04-25 18:00:00,113,250,10,13,769,571,198,8
2755,2022-04-25 19:00:00,90,290,10,13,627,452,175,9
2756,2022-04-25 20:00:00,74,261,10,14,782,679,103,11
2757,2022-04-25 21:00:00,147,127,14,11,658,498,160,10
2758,2022-04-25 22:00:00,96,228,12,17,771,672,99,8
2759,2022-04-25 23:00:00,75,233,10,12,638,525,113,9
2760,2022-04-26 00:00:00,79,241,13,13,766,608,158,12
2761,2022-04-26 01:00:00,50,234,12,19,688,534,154,13
2762,2022-04-26 02:00:00,126,195,9,12,784,566,218,8
2763,2022-04-26 03:00:00,80,205,9,15,682,568,114,11
2764,2022-04-26 04:00:00,117,250,5,11,584,411,173,6
2765,2022-04-26 05:00:00,62,122,7,14,690,596,94,5
2766,2022-04-26 06:00:00,114,218,5,10,741,664,77,11
2767,2022-04-26 07:00:00,85,151,10,14,638,448,190,5
2768,2022-04-26 08:00:00,101,202,6,14,686,499,187,13
2769,2022-04-26 09:00:00,100,260,8,12,576,483,93,7
2770,2022-04-26 10:00:00,65,101,9,17,588,481,107,9
2771,2022-04-26 11:00:00,85,236,7,12,626,476,150,6
2772,2022-04-26 12:00:00,70,290,5,13,662,468,194,11
2773,2022-04-26 13:00:00,129,113,5,13,729,522,207,10
2774,2022-04-26 14:00:00,77,118,6,15,624,543,81,10
2775,2022-04-26 15:00:00,104,299,8,14,766,661,105,12
2776,2022-04-26 16:00:00,102,168,5,16,684,577,107,14
2777,2022-04-26 17:00:00,110,119,14,14,749,609,140,10
2778,2022-04-26 18:00:00,127,219,12,13,757,604,153,7
2779,2022-04-26 19:00:00,77,127,5,12,645,478,167,8
2780,2022-04-26 20:00:00,83,298,10,11,671,479,192,8
2781,2022-04-26 21:00:00,134,286,7,19,786,597,189,8
2782,2022-04-26 22:00:00,138,246,6,13,756,589,167,6
2783,2022-04-26 23:00:00,111,292,6,18,557,488,69,14
2784,2022-04-27 00:00:00,132,141,5,13,550,448,102,13
2785,2022-04-27 01:00:00,61,206,6,19,626,520,106,10
2786,2022-04-27 02:00:00,114,226,12,14,520,406,114,6
2787,2022-04-27 03:00:00,106,255,6,10,721,577,144,13
2788,2022-04-27 04:00:00,85,278,7,12,661,543,118,7
2789,2022-04-27 05:00:00,82,266,8,13,655,585,70,10
2790,2022-04-27 06:00:00,70,275,14,16,585,411,174,6
2791,2022-04-27 07:00:00,108,295,9,17,700,604,96,10
2792,2022-04-27 08:00:00,97,265,6,11,770,608,162,7
2793,2022-04-27 09:00:00,121,192,7,16,573,423,150,5
2794,2022-04-27 10:00:00,123,266,6,11,618,478,140,5
2795,2022-04-27 11:00:00,133,283,8,10,791,623,168,14
2796,2022-04-27 12:00:00,127,292,14,10,583,479,104,13
2797,2022-04-27 13:00:00,83,265,8,14,517,364,153,8
2798,2022-04-27 14:00:00,131,214,11,11,564,477,87,12
2799,2022-04-27 15:00:00,85,258,10,19,527,408,119,10
2800,2022-04-27 16:00:00,99,255,6,17,768,572,196,9
2801,2022-04-27 17:00:00,67,161,6,19,585,444,141,6
2802,2022-04-27 18:00:00,62,116,7,15,554,468,86,8
2803,2022-04-27 19:00:00,130,128,5,14,758,534,224,12
2804,2022-04-27 20:00:00,89,169,14,15,584,433,151,7
2805,2022-04-27 21:00:00,87,123,11,12,592,420,172,5
2806,2022-04-27 22:00:00,66,124,14,14,538,447,91,10
2807,2022-04-27 23:00:00,87,135,5,18,624,517,107,13
2808,2022-04-28 00:00:00,137,126,10,12,582,487,95,8
2809,2022-04-28 01:00:00,61,227,7,15,695,554,141,8
2810,2022-04-28 02:00:00,132,114,13,17,572,409,163,9
2811,2022-04-28 03:00:00,112,222,11,18,744,637,107,11
2812,2022-04-28 04:00:00,147,127,11,17,648,560,88,11
2813,2022-04-28 05:00:00,141,249,9,16,599,511,88,12
2814,2022-04-28 06:00:00,59,125,13,14,788,655,133,13
2815,2022-04-28 07:00:00,95,178,12,11,661,477,184,5
2816,2022-04-28 08:00:00,145,245,9,11,609,439,170,6
2817,2022-04-28 09:00:00,56,228,5,17,759,649,110,7
2818,2022-04-28 10:00:00,82,125,12,17,759,617,142,10
2819,2022-04-28 11:00:00,63,271,10,14,694,530,164,7
2820,2022-04-28 12:00:00,79,271,9,16,796,634,162,13
2821,2022-04-28 13:00:00,143,172,9,12,529,379,150,8
2822,2022-04-28 14:00:00,114,170,9,16,763,605,158,12
2823,2022-04-28 15:00:00,72,282,6,12,731,521,210,13
2824,2022-04-28 16:00:00,141,109,7,17,672,539,133,14
2825,2022-04-28 17:00:00,62,168,14,18,538,472,66,14
2826,2022-04-28 18:00:00,80,134,12,15,692,622,70,10
2827,2022-04-28 19:00:00,86,130,9,11,760,537,223,6
2828,2022-04-28 20:00:00,132,143,9,14,692,510,182,13
2829,2022-04-28 21:00:00,91,150,13,15,614,451,163,14
2830,2022-04-28 22:00:00,77,125,5,10,639,490,149,13
2831,2022-04-28 23:00:00,96,263,12,18,777,615,162,8
2832,2022-04-29 00:00:00,90,109,11,16,589,465,124,12
2833,2022-04-29 01:00:00,122,279,7,17,672,586,86,6
2834,2022-04-29 02:00:00,52,160,14,15,525,426,99,10
2835,2022-04-29 03:00:00,86,212,5,11,660,487,173,11
2836,2022-04-29 04:00:00,134,214,8,17,607,459,148,12
2837,2022-04-29 05:00:00,96,281,10,16,559,484,75,13
2838,2022-04-29 06:00:00,87,283,12,19,703,575,128,12
2839,2022-04-29 07:00:00,71,116,11,19,751,675,76,12
2840,2022-04-29 08:00:00,84,216,12,10,543,383,160,14
2841,2022-04-29 09:00:00,95,269,12,19,611,496,115,12
2842,2022-04-29 10:00:00,106,187,14,11,586,460,126,8
2843,2022-04-29 11:00:00,101,239,14,15,765,688,77,11
2844,2022-04-29 12:00:00,99,209,6,11,771,656,115,11
2845,2022-04-29 13:00:00,137,124,7,10,531,468,63,8
2846,2022-04-29 14:00:00,76,259,10,12,710,565,145,12
2847,2022-04-29 15:00:00,62,192,10,16,731,552,179,5
2848,2022-04-29 16:00:00,79,138,13,10,789,607,182,12
2849,2022-04-29 17:00:00,92,152,11,12,650,532,118,7
2850,2022-04-29 18:00:00,128,285,6,18,591,511,80,8
2851,2022-04-29 19:00:00,111,125,8,11,615,467,148,5
2852,2022-04-29 20:00:00,117,222,14,11,608,501,107,10
2853,2022-04-29 21:00:00,141,137,7,15,714,631,83,14
2854,2022-04-29 22:00:00,135,293,12,17,741,628,113,14
2855,2022-04-29 23:00:00,53,229,5,13,726,633,93,6
2856,2022-04-30 00:00:00,93,264,14,18,512,433,79,10
2857,2022-04-30 01:00:00,86,201,9,17,654,587,67,13
2858,2022-04-30 02:00:00,145,243,13,16,702,561,141,13
2859,2022-04-30 03:00:00,126,168,14,10,687,526,161,9
2860,2022-04-30 04:00:00,129,295,9,17,752,546,206,13
2861,2022-04-30 05:00:00,116,157,9,15,792,671,121,10
2862,2022-04-30 06:00:00,122,213,8,14,752,608,144,8
2863,2022-04-30 07:00:00,52,184,9,14,514,380,134,12
2864,2022-04-30 08:00:00,115,195,8,18,618,457,161,11
2865,2022-04-30 09:00:00,147,151,11,16,620,465,155,11
2866,2022-04-30 10:00:00,105,270,13,12,753,570,183,11
2867,2022-04-30 11:00:00,111,169,13,17,712,561,151,8
2868,2022-04-30 12:00:00,60,291,12,11,610,488,122,12
2869,2022-04-30 13:00:00,115,198,14,12,726,522,204,6
2870,2022-04-30 14:00:00,118,223,11,15,521,415,106,6
2871,2022-04-30 15:00:00,82,165,5,13,567,447,120,9
2872,2022-04-30 16:00:00,77,163,13,10,507,439,68,12
2873,2022-04-30 17:00:00,98,162,11,12,755,597,158,11
2874,2022-04-30 18:00:00,117,165,6,12,743,555,188,14
2875,2022-04-30 19:00:00,62,166,12,14,716,643,73,8
2876,2022-04-30 20:00:00,143,152,9,10,535,398,137,12
2877,2022-04-30 21:00:00,131,136,9,11,607,469,138,13
2878,2022-04-30 22:00:00,79,218,11,13,776,668,108,6
2879,2022-04-30 23:00:00,75,137,10,14,754,546,208,7
2880,2022-05-01 00:00:00,126,255,11,13,593,499,94,5
2881,2022-05-01 01:00:00,122,101,5,11,748,611,137,10
2882,2022-05-01 02:00:00,148,227,11,12,710,510,200,5
2883,2022-05-01 03:00:00,53,146,12,11,704,575,129,8
2884,2022-05-01 04:00:00,112,180,5,12,706,531,175,5
2885,2022-05-01 05:00:00,73,224,5,13,745,652,93,6
2886,2022-05-01 06:00:00,111,198,5,10,731,631,100,9
2887,2022-05-01 07:00:00,138,202,10,14,735,530,205,5
2888,2022-05-01 08:00:00,88,256,5,17,671,554,117,10
2889,2022-05-01 09:00:00,87,145,10,10,793,684,109,7
2890,2022-05-01 10:00:00,118,272,10,16,620,539,81,5
2891,2022-05-01 11:00:00,76,237,8,13,642,516,126,9
2892,2022-05-01 12:00:00,82,251,9,10,757,651,106,11
2893,2022-05-01 13:00:00,107,251,10,10,633,524,109,6
2894,2022-05-01 14:00:00,55,107,10,17,722,547,175,14
2895,2022-05-01 15:00:00,80,272,5,16,581,439,142,10
2896,2022-05-01 16:00:00,134,193,9,17,511,359,152,7
2897,2022-05-01 17:00:00,61,293,8,14,508,419,89,9
2898,2022-05-01 18:00:00,67,250,11,15,683,577,106,8
2899,2022-05-01 19:00:00,50,245,14,10,654,560,94,11
2900,2022-05-01 20:00:00,129,206,11,19,545,445,100,14
2901,2022-05-01 21:00:00,124,107,11,11,758,606,152,11
2902,2022-05-01 22:00:00,60,231,9,16,654,485,169,11
2903,2022-05-01 23:00:00,87,235,8,11,548,406,142,8
2904,2022-05-02 00:00:00,124,242,8,12,655,485,170,7
2905,2022-05-02 01:00:00,90,243,10,19,627,563,64,10
2906,2022-05-02 02:00:00,139,297,13,17,621,437,184,8
2907,2022-05-02 03:00:00,81,223,7,12,722,619,103,8
2908,2022-05-02 04:00:00,135,250,8,14,625,504,121,8
2909,2022-05-02 05:00:00,119,147,11,19,743,640,103,5
2910,2022-05-02 06:00:00,100,172,6,15,793,624,169,8
2911,2022-05-02 07:00:00,65,205,9,15,678,518,160,7
2912,2022-05-02 08:00:00,108,272,12,14,509,393,116,13
2913,2022-05-02 09:00:00,102,115,12,11,636,521,115,6
2914,2022-05-02 10:00:00,82,125,9,16,640,536,104,6
2915,2022-05-02 11:00:00,116,114,5,10,570,473,97,12
2916,2022-05-02 12:00:00,126,133,5,17,766,563,203,13
2917,2022-05-02 13:00:00,62,275,9,11,601,488,113,14
2918,2022-05-02 14:00:00,144,168,13,19,620,455,165,8
2919,2022-05-02 15:00:00,104,117,9,19,772,569,203,10
2920,2022-05-02 16:00:00,119,219,8,16,618,503,115,8
2921,2022-05-02 17:00:00,149,168,14,13,721,596,125,13
2922,2022-05-02 18:00:00,90,197,6,13,701,546,155,10
2923,2022-05-02 19:00:00,126,239,13,17,770,650,120,10
2924,2022-05-02 20:00:00,136,239,8,13,736,523,213,12
2925,2022-05-02 21:00:00,93,270,14,14,628,442,186,10
2926,2022-05-02 22:00:00,96,139,5,16,776,560,216,11
2927,2022-05-02 23:00:00,61,220,5,14,624,494,130,5
2928,2022-05-03 00:00:00,128,272,14,18,716,534,182,11
2929,2022-05-03 01:00:00,93,264,9,17,530,410,120,13
2930,2022-05-03 02:00:00,87,136,11,19,560,427,133,9
2931,2022-05-03 03:00:00,66,236,10,15,534,383,151,9
2932,2022-05-03 04:00:00,98,102,14,15,622,449,173,8
2933,2022-05-03 05:00:00,105,138,6,14,754,552,202,6
2934,2022-05-03 06:00:00,114,194,12,17,727,612,115,9
2935,2022-05-03 07:00:00,84,204,12,14,750,653,97,14
2936,2022-05-03 08:00:00,133,170,11,18,685,601,84,13
2937,2022-05-03 09:00:00,113,268,14,12,710,505,205,5
2938,2022-05-03 10:00:00,78,281,9,18,554,430,124,14
2939,2022-05-03 11:00:00,118,275,6,19,734,637,97,10
2940,2022-05-03 12:00:00,86,245,6,19,538,433,105,14
2941,2022-05-03 13:00:00,145,280,8,13,655,505,150,11
2942,2022-05-03 14:00:00,85,234,7,16,730,596,134,14
2943,2022-05-03 15:00:00,106,155,7,14,629,537,92,6
2944,2022-05-03 16:00:00,108,138,12,13,695,589,106,7
2945,2022-05-03 17:00:00,87,128,7,16,505,451,54,8
2946,2022-05-03 18:00:00,124,115,5,14,623,524,99,11
2947,2022-05-03 19:00:00,120,114,10,15,533,467,66,5
2948,2022-05-03 20:00:00,133,115,10,18,630,525,105,7
2949,2022-05-03 21:00:00,126,260,13,18,710,505,205,11
2950,2022-05-03 22:00:00,86,279,6,19,629,490,139,14
2951,2022-05-03 23:00:00,79,283,14,12,635,482,153,14
2952,2022-05-04 00:00:00,92,104,12,15,791,596,195,9
2953,2022-05-04 01:00:00,80,253,7,11,645,558,87,7
2954,2022-05-04 02:00:00,145,275,14,17,701,565,136,12
2955,2022-05-04 03:00:00,125,219,7,15,643,524,119,11
2956,2022-05-04 04:00:00,51,143,10,18,740,562,178,8
2957,2022-05-04 05:00:00,76,187,9,12,698,627,71,9
2958,2022-05-04 06:00:00,139,248,7,14,727,537,190,6
2959,2022-05-04 07:00:00,87,269,11,19,587,416,171,5
2960,2022-05-04 08:00:00,92,177,10,16,686,527,159,7
2961,2022-05-04 09:00:00,69,253,5,18,765,562,203,10
2962,2022-05-04 10:00:00,118,143,14,18,518,406,112,13
2963,2022-05-04 11:00:00,64,104,14,19,683,613,70,14
2964,2022-05-04 12:00:00,138,283,14,16,720,558,162,13
2965,2022-05-04 13:00:00,56,270,13,14,695,597,98,8
2966,2022-05-04 14:00:00,111,267,5,13,637,486,151,11
2967,2022-05-04 15:00:00,67,175,9,14,522,450,72,5
2968,2022-05-04 16:00:00,109,146,13,16,519,405,114,11
2969,2022-05-04 17:00:00,130,184,7,16,554,425,129,14
2970,2022-05-04 18:00:00,92,285,9,15,641,523,118,6
2971,2022-05-04 19:00:00,54,155,13,16,764,641,123,12
2972,2022-05-04 20:00:00,91,285,8,14,696,530,166,9
2973,2022-05-04 21:00:00,83,176,10,11,601,507,94,8
2974,2022-05-04 22:00:00,94,179,14,15,519,399,120,11
2975,2022-05-04 23:00:00,60,195,9,17,694,585,109,14
2976,2022-05-05 00:00:00,124,112,12,11,731,583,148,8
2977,2022-05-05 01:00:00,114,158,6,15,513,451,62,10
2978,2022-05-05 02:00:00,133,145,8,10,648,539,109,12
2979,2022-05-05 03:00:00,134,187,11,18,520,402,118,7
2980,2022-05-05 04:00:00,113,248,5,15,685,490,195,11
2981,2022-05-05 05:00:00,111,132,6,17,617,551,66,5
2982,2022-05-05 06:00:00,107,246,5,10,701,621,80,11
2983,2022-05-05 07:00:00,108,272,6,15,547,405,142,9
2984,2022-05-05 08:00:00,130,157,12,19,760,640,120,6
2985,2022-05-05 09:00:00,104,143,8,14,678,604,74,6
2986,2022-05-05 10:00:00,143,198,5,12,587,491,96,12
2987,2022-05-05 11:00:00,110,206,8,11,650,472,178,14
2988,2022-05-05 12:00:00,63,249,8,17,601,463,138,5
2989,2022-05-05 13:00:00,107,237,5,19,742,577,165,14
2990,2022-05-05 14:00:00,129,295,9,11,686,481,205,6
2991,2022-05-05 15:00:00,90,245,9,19,567,403,164,5
2992,2022-05-05 16:00:00,101,296,10,13,761,572,189,6
2993,2022-05-05 17:00:00,132,217,7,17,696,492,204,9
2994,2022-05-05 18:00:00,124,256,6,14,665,469,196,10
2995,2022-05-05 19:00:00,101,293,10,16,776,624,152,13
2996,2022-05-05 20:00:00,132,244,13,11,536,405,131,13
2997,2022-05-05 21:00:00,133,291,14,11,506,409,97,7
2998,2022-05-05 22:00:00,51,243,7,12,698,526,172,14
2999,2022-05-05 23:00:00,137,260,13,19,772,652,120,12
3000,2022-05-06 00:00:00,72,125,7,10,653,570,83,8
3001,2022-05-06 01:00:00,65,184,12,12,655,581,74,7
3002,2022-05-06 02:00:00,121,253,12,18,621,551,70,13
3003,2022-05-06 03:00:00,83,249,8,13,759,577,182,7
3004,2022-05-06 04:00:00,148,222,11,11,513,403,110,11
3005,2022-05-06 05:00:00,126,164,8,16,619,553,66,14
3006,2022-05-06 06:00:00,89,216,10,11,789,680,109,11
3007,2022-05-06 07:00:00,101,165,9,19,574,470,104,13
3008,2022-05-06 08:00:00,58,299,9,14,544,442,102,7
3009,2022-05-06 09:00:00,65,223,12,18,505,435,70,13
3010,2022-05-06 10:00:00,58,188,9,12,563,491,72,11
3011,2022-05-06 11:00:00,133,112,6,12,786,685,101,5
3012,2022-05-06 12:00:00,129,256,6,18,593,453,140,11
3013,2022-05-06 13:00:00,66,149,8,19,577,456,121,14
3014,2022-05-06 14:00:00,81,212,8,10,707,577,130,9
3015,2022-05-06 15:00:00,132,251,13,17,675,495,180,7
3016,2022-05-06 16:00:00,126,292,10,13,579,475,104,10
3017,2022-05-06 17:00:00,123,281,13,19,667,531,136,11
3018,2022-05-06 18:00:00,76,273,13,10,700,496,204,8
3019,2022-05-06 19:00:00,125,202,6,19,628,494,134,14
3020,2022-05-06 20:00:00,57,143,7,19,551,413,138,9
3021,2022-05-06 21:00:00,116,253,6,12,779,602,177,7
3022,2022-05-06 22:00:00,63,257,12,14,689,614,75,14
3023,2022-05-06 23:00:00,123,131,12,18,597,430,167,14
3024,2022-05-07 00:00:00,87,213,6,11,657,479,178,7
3025,2022-05-07 01:00:00,85,257,14,12,737,576,161,11
3026,2022-05-07 02:00:00,105,254,7,10,539,418,121,5
3027,2022-05-07 03:00:00,78,244,13,10,775,662,113,11
3028,2022-05-07 04:00:00,115,146,7,19,630,544,86,9
3029,2022-05-07 05:00:00,131,134,9,13,599,478,121,13
3030,2022-05-07 06:00:00,144,251,5,15,779,589,190,6
3031,2022-05-07 07:00:00,138,224,8,17,780,661,119,11
3032,2022-05-07 08:00:00,68,214,12,12,794,669,125,5
3033,2022-05-07 09:00:00,132,226,13,10,774,599,175,8
3034,2022-05-07 10:00:00,116,163,13,11,624,467,157,11
3035,2022-05-07 11:00:00,115,121,14,15,738,583,155,11
3036,2022-05-07 12:00:00,58,229,8,15,760,666,94,7
3037,2022-05-07 13:00:00,102,110,5,11,502,428,74,14
3038,2022-05-07 14:00:00,70,247,5,14,732,638,94,10
3039,2022-05-07 15:00:00,86,173,5,12,592,459,133,6
3040,2022-05-07 16:00:00,84,281,10,13,500,401,99,7
3041,2022-05-07 17:00:00,72,127,6,17,725,508,217,5
3042,2022-05-07 18:00:00,51,104,10,19,604,505,99,5
3043,2022-05-07 19:00:00,110,200,9,16,699,585,114,7
3044,2022-05-07 20:00:00,72,214,13,18,634,485,149,6
3045,2022-05-07 21:00:00,89,283,14,18,663,582,81,5
3046,2022-05-07 22:00:00,93,106,5,18,524,429,95,6
3047,2022-05-07 23:00:00,131,128,13,11,699,569,130,6
3048,2022-05-08 00:00:00,88,270,11,13,774,650,124,7
3049,2022-05-08 01:00:00,120,243,11,10,686,570,116,12
3050,2022-05-08 02:00:00,128,294,12,17,605,538,67,14
3051,2022-05-08 03:00:00,129,273,14,14,666,517,149,7
3052,2022-05-08 04:00:00,56,111,10,16,516,442,74,12
3053,2022-05-08 05:00:00,105,120,9,18,653,530,123,5
3054,2022-05-08 06:00:00,77,276,7,17,517,461,56,11
3055,2022-05-08 07:00:00,87,211,14,15,765,630,135,10
3056,2022-05-08 08:00:00,84,185,10,10,517,391,126,14
3057,2022-05-08 09:00:00,59,272,10,18,512,424,88,5
3058,2022-05-08 10:00:00,68,252,8,12,623,451,172,12
3059,2022-05-08 11:00:00,131,141,8,11,543,429,114,14
3060,2022-05-08 12:00:00,92,180,14,13,631,483,148,8
3061,2022-05-08 13:00:00,52,270,10,12,606,464,142,13
3062,2022-05-08 14:00:00,51,130,10,15,531,477,54,7
3063,2022-05-08 15:00:00,124,298,10,13,680,554,126,8
3064,2022-05-08 16:00:00,117,254,10,17,621,484,137,5
3065,2022-05-08 17:00:00,64,126,13,15,747,562,185,12
3066,2022-05-08 18:00:00,143,206,10,15,776,608,168,9
3067,2022-05-08 19:00:00,100,115,10,14,745,669,76,14
3068,2022-05-08 20:00:00,131,196,11,17,742,607,135,9
3069,2022-05-08 21:00:00,144,298,9,17,786,576,210,11
3070,2022-05-08 22:00:00,108,237,9,17,779,622,157,13
3071,2022-05-08 23:00:00,63,298,10,13,504,434,70,6
3072,2022-05-09 00:00:00,86,151,7,11,759,550,209,11
3073,2022-05-09 01:00:00,102,173,7,15,645,455,190,14
3074,2022-05-09 02:00:00,87,192,6,19,799,685,114,11
3075,2022-05-09 03:00:00,100,233,7,16,737,623,114,10
3076,2022-05-09 04:00:00,55,124,10,13,755,662,93,8
3077,2022-05-09 05:00:00,129,279,10,15,636,553,83,11
3078,2022-05-09 06:00:00,60,217,12,12,640,565,75,14
3079,2022-05-09 07:00:00,71,135,11,11,621,486,135,5
3080,2022-05-09 08:00:00,120,262,7,14,637,494,143,5
3081,2022-05-09 09:00:00,59,110,14,19,687,542,145,11
3082,2022-05-09 10:00:00,104,203,6,17,765,652,113,7
3083,2022-05-09 11:00:00,79,291,5,18,520,397,123,11
3084,2022-05-09 12:00:00,78,115,7,10,577,434,143,12
3085,2022-05-09 13:00:00,53,202,11,18,582,433,149,12
3086,2022-05-09 14:00:00,118,199,14,17,617,450,167,11
3087,2022-05-09 15:00:00,63,280,10,15,572,427,145,11
3088,2022-05-09 16:00:00,70,148,6,14,689,552,137,6
3089,2022-05-09 17:00:00,117,112,14,10,673,573,100,5
3090,2022-05-09 18:00:00,53,109,11,13,587,436,151,8
3091,2022-05-09 19:00:00,71,184,11,19,513,394,119,11
3092,2022-05-09 20:00:00,77,181,10,18,701,551,150,13
3093,2022-05-09 21:00:00,61,185,11,18,759,619,140,9
3094,2022-05-09 22:00:00,100,186,12,14,573,506,67,5
3095,2022-05-09 23:00:00,98,244,12,18,742,622,120,7
3096,2022-05-10 00:00:00,118,227,8,15,753,553,200,9
3097,2022-05-10 01:00:00,84,200,6,11,700,523,177,7
3098,2022-05-10 02:00:00,89,296,13,18,724,617,107,7
3099,2022-05-10 03:00:00,51,246,9,12,671,538,133,14
3100,2022-05-10 04:00:00,73,192,10,17,665,474,191,6
3101,2022-05-10 05:00:00,83,264,12,14,508,361,147,10
3102,2022-05-10 06:00:00,67,141,7,11,525,450,75,13
3103,2022-05-10 07:00:00,122,139,10,10,768,580,188,10
3104,2022-05-10 08:00:00,60,201,10,13,640,460,180,5
3105,2022-05-10 09:00:00,54,153,7,19,782,570,212,13
3106,2022-05-10 10:00:00,138,188,9,13,691,563,128,13
3107,2022-05-10 11:00:00,141,183,8,19,748,555,193,8
3108,2022-05-10 12:00:00,53,131,11,18,716,612,104,6
3109,2022-05-10 13:00:00,74,282,7,18,750,601,149,7
3110,2022-05-10 14:00:00,67,195,9,18,616,446,170,5
3111,2022-05-10 15:00:00,89,157,13,15,778,551,227,7
3112,2022-05-10 16:00:00,118,154,8,14,518,370,148,5
3113,2022-05-10 17:00:00,82,174,9,14,766,551,215,10
3114,2022-05-10 18:00:00,116,275,10,17,552,482,70,10
3115,2022-05-10 19:00:00,59,158,11,11,686,582,104,7
3116,2022-05-10 20:00:00,127,167,11,17,551,475,76,7
3117,2022-05-10 21:00:00,80,143,8,11,799,651,148,8
3118,2022-05-10 22:00:00,138,166,11,16,542,385,157,9
3119,2022-05-10 23:00:00,68,179,11,17,700,616,84,11
3120,2022-05-11 00:00:00,116,207,6,14,604,454,150,9
3121,2022-05-11 01:00:00,97,280,11,14,559,497,62,5
3122,2022-05-11 02:00:00,122,124,10,18,653,460,193,7
3123,2022-05-11 03:00:00,109,172,11,14,564,473,91,5
3124,2022-05-11 04:00:00,139,279,10,19,594,462,132,11
3125,2022-05-11 05:00:00,60,149,8,18,754,566,188,13
3126,2022-05-11 06:00:00,60,203,12,12,754,646,108,8
3127,2022-05-11 07:00:00,103,190,9,12,526,374,152,11
3128,2022-05-11 08:00:00,64,190,10,16,655,502,153,8
3129,2022-05-11 09:00:00,81,291,8,16,716,527,189,9
3130,2022-05-11 10:00:00,65,249,6,12,669,574,95,6
3131,2022-05-11 11:00:00,66,236,14,12,557,496,61,9
3132,2022-05-11 12:00:00,82,291,11,17,693,574,119,13
3133,2022-05-11 13:00:00,90,188,9,17,680,548,132,9
3134,2022-05-11 14:00:00,109,233,9,12,644,479,165,5
3135,2022-05-11 15:00:00,107,287,8,16,644,452,192,5
3136,2022-05-11 16:00:00,133,207,9,10,512,383,129,9
3137,2022-05-11 17:00:00,114,156,8,18,624,554,70,7
3138,2022-05-11 18:00:00,140,288,9,19,530,401,129,10
3139,2022-05-11 19:00:00,85,163,13,12,506,355,151,6
3140,2022-05-11 20:00:00,74,298,13,19,690,488,202,12
3141,2022-05-11 21:00:00,74,215,6,12,715,624,91,12
3142,2022-05-11 22:00:00,64,103,14,14,586,493,93,5
3143,2022-05-11 23:00:00,71,265,14,14,618,485,133,14
3144,2022-05-12 00:00:00,72,263,9,17,525,414,111,13
3145,2022-05-12 01:00:00,122,214,14,15,764,550,214,12
3146,2022-05-12 02:00:00,145,178,9,18,680,611,69,5
3147,2022-05-12 03:00:00,71,104,11,19,581,500,81,9
3148,2022-05-12 04:00:00,59,241,5,16,731,596,135,14
3149,2022-05-12 05:00:00,57,292,12,17,506,434,72,5
3150,2022-05-12 06:00:00,67,137,10,10,631,463,168,9
3151,2022-05-12 07:00:00,145,249,10,12,527,411,116,13
3152,2022-05-12 08:00:00,118,217,5,15,640,523,117,8
3153,2022-05-12 09:00:00,69,269,10,17,752,581,171,10
3154,2022-05-12 10:00:00,89,132,11,16,684,577,107,7
3155,2022-05-12 11:00:00,107,162,12,11,565,430,135,7
3156,2022-05-12 12:00:00,84,213,14,17,794,697,97,9
3157,2022-05-12 13:00:00,69,156,9,15,678,563,115,12
3158,2022-05-12 14:00:00,126,162,12,15,528,402,126,13
3159,2022-05-12 15:00:00,144,281,9,13,747,618,129,5
3160,2022-05-12 16:00:00,132,217,13,11,541,390,151,8
3161,2022-05-12 17:00:00,91,131,8,13,647,493,154,11
3162,2022-05-12 18:00:00,94,286,8,18,557,471,86,13
3163,2022-05-12 19:00:00,74,101,6,14,537,433,104,6
3164,2022-05-12 20:00:00,121,297,5,10,539,466,73,13
3165,2022-05-12 21:00:00,99,104,5,14,625,560,65,5
3166,2022-05-12 22:00:00,74,288,8,16,562,403,159,7
3167,2022-05-12 23:00:00,88,273,5,12,715,610,105,8
3168,2022-05-13 00:00:00,98,298,5,11,795,672,123,10
3169,2022-05-13 01:00:00,123,155,9,11,637,462,175,7
3170,2022-05-13 02:00:00,68,176,5,15,602,492,110,8
3171,2022-05-13 03:00:00,56,245,9,10,543,386,157,8
3172,2022-05-13 04:00:00,115,217,8,19,646,528,118,5
3173,2022-05-13 05:00:00,99,220,10,13,539,470,69,5
3174,2022-05-13 06:00:00,128,150,9,17,696,544,152,14
3175,2022-05-13 07:00:00,121,145,6,14,718,620,98,7
3176,2022-05-13 08:00:00,51,139,8,11,790,691,99,11
3177,2022-05-13 09:00:00,130,162,11,15,778,560,218,7
3178,2022-05-13 10:00:00,57,155,13,12,780,609,171,14
3179,2022-05-13 11:00:00,149,166,14,16,709,562,147,8
3180,2022-05-13 12:00:00,122,258,12,14,673,528,145,11
3181,2022-05-13 13:00:00,116,141,5,19,748,653,95,6
3182,2022-05-13 14:00:00,142,119,10,16,622,463,159,7
3183,2022-05-13 15:00:00,92,160,6,10,674,492,182,8
3184,2022-05-13 16:00:00,60,146,10,17,620,552,68,5
3185,2022-05-13 17:00:00,61,205,6,19,678,542,136,7
3186,2022-05-13 18:00:00,130,261,11,17,631,517,114,7
3187,2022-05-13 19:00:00,118,184,14,17,765,556,209,11
3188,2022-05-13 20:00:00,145,231,11,11,770,661,109,8
3189,2022-05-13 21:00:00,52,154,10,19,758,679,79,14
3190,2022-05-13 22:00:00,100,216,8,17,555,490,65,12
3191,2022-05-13 23:00:00,57,258,9,12,743,659,84,11
3192,2022-05-14 00:00:00,110,227,9,14,563,423,140,5
3193,2022-05-14 01:00:00,105,275,12,19,741,645,96,12
3194,2022-05-14 02:00:00,70,224,6,10,592,499,93,9
3195,2022-05-14 03:00:00,101,111,5,16,795,680,115,11
3196,2022-05-14 04:00:00,145,155,5,12,711,573,138,6
3197,2022-05-14 05:00:00,61,245,7,14,708,516,192,10
3198,2022-05-14 06:00:00,83,232,11,18,663,464,199,8
3199,2022-05-14 07:00:00,102,169,6,13,794,703,91,14
3200,2022-05-14 08:00:00,74,284,9,11,773,623,150,10
3201,2022-05-14 09:00:00,67,102,12,13,516,458,58,9
3202,2022-05-14 10:00:00,67,157,14,18,553,495,58,6
3203,2022-05-14 11:00:00,78,110,14,16,710,577,133,5
3204,2022-05-14 12:00:00,72,221,5,16,567,449,118,5
3205,2022-05-14 13:00:00,79,197,5,18,545,422,123,9
3206,2022-05-14 14:00:00,105,246,12,14,735,577,158,11
3207,2022-05-14 15:00:00,123,198,5,15,691,596,95,14
3208,2022-05-14 16:00:00,97,137,8,10,638,556,82,12
3209,2022-05-14 17:00:00,105,231,7,14,621,509,112,12
3210,2022-05-14 18:00:00,104,287,8,14,640,547,93,12
3211,2022-05-14 19:00:00,101,151,7,13,738,569,169,10
3212,2022-05-14 20:00:00,108,192,10,11,590,420,170,6
3213,2022-05-14 21:00:00,77,178,9,19,658,554,104,12
3214,2022-05-14 22:00:00,133,254,9,10,508,427,81,12
3215,2022-05-14 23:00:00,85,272,8,19,672,526,146,11
3216,2022-05-15 00:00:00,93,128,10,10,568,428,140,14
3217,2022-05-15 01:00:00,99,183,5,15,627,541,86,5
3218,2022-05-15 02:00:00,89,237,13,15,655,542,113,10
3219,2022-05-15 03:00:00,114,284,13,12,695,560,135,5
3220,2022-05-15 04:00:00,108,298,6,16,752,649,103,12
3221,2022-05-15 05:00:00,107,124,12,13,512,381,131,10
3222,2022-05-15 06:00:00,98,232,13,14,750,644,106,6
3223,2022-05-15 07:00:00,117,281,8,13,565,398,167,12
3224,2022-05-15 08:00:00,79,138,14,14,635,529,106,5
3225,2022-05-15 09:00:00,51,178,14,11,708,606,102,8
3226,2022-05-15 10:00:00,131,298,13,12,750,659,91,10
3227,2022-05-15 11:00:00,123,162,8,16,594,445,149,14
3228,2022-05-15 12:00:00,94,147,11,17,555,457,98,14
3229,2022-05-15 13:00:00,147,136,7,10,710,553,157,11
3230,2022-05-15 14:00:00,94,124,11,10,690,520,170,10
3231,2022-05-15 15:00:00,113,282,10,10,522,397,125,9
3232,2022-05-15 16:00:00,148,230,6,18,722,645,77,6
3233,2022-05-15 17:00:00,87,215,14,18,789,560,229,13
3234,2022-05-15 18:00:00,57,256,6,11,691,539,152,12
3235,2022-05-15 19:00:00,55,141,9,16,623,559,64,14
3236,2022-05-15 20:00:00,91,142,7,11,702,615,87,6
3237,2022-05-15 21:00:00,144,188,9,16,602,491,111,11
3238,2022-05-15 22:00:00,86,154,13,13,686,545,141,6
3239,2022-05-15 23:00:00,105,232,11,14,763,593,170,12
3240,2022-05-16 00:00:00,71,178,13,14,582,408,174,9
3241,2022-05-16 01:00:00,96,296,8,18,591,500,91,9
3242,2022-05-16 02:00:00,74,237,14,13,521,386,135,8
3243,2022-05-16 03:00:00,128,250,12,15,655,549,106,8
3244,2022-05-16 04:00:00,57,152,14,14,597,509,88,11
3245,2022-05-16 05:00:00,50,160,9,12,798,627,171,9
3246,2022-05-16 06:00:00,98,209,13,19,710,573,137,5
3247,2022-05-16 07:00:00,145,156,12,17,738,542,196,10
3248,2022-05-16 08:00:00,79,224,6,19,732,533,199,11
3249,2022-05-16 09:00:00,112,221,7,19,610,430,180,9
3250,2022-05-16 10:00:00,95,103,13,10,654,585,69,12
3251,2022-05-16 11:00:00,114,167,10,13,717,539,178,5
3252,2022-05-16 12:00:00,91,192,6,18,662,499,163,9
3253,2022-05-16 13:00:00,108,116,12,14,669,519,150,7
3254,2022-05-16 14:00:00,58,154,8,16,672,547,125,8
3255,2022-05-16 15:00:00,77,100,13,11,513,404,109,11
3256,2022-05-16 16:00:00,110,179,12,12,714,622,92,12
3257,2022-05-16 17:00:00,92,221,12,18,659,497,162,10
3258,2022-05-16 18:00:00,61,252,6,12,584,505,79,6
3259,2022-05-16 19:00:00,93,104,8,16,656,577,79,13
3260,2022-05-16 20:00:00,117,220,10,17,599,426,173,8
3261,2022-05-16 21:00:00,72,197,13,10,736,579,157,8
3262,2022-05-16 22:00:00,115,122,9,11,545,406,139,6
3263,2022-05-16 23:00:00,74,290,10,15,797,613,184,14
3264,2022-05-17 00:00:00,65,250,6,12,598,498,100,13
3265,2022-05-17 01:00:00,143,235,13,10,678,497,181,6
3266,2022-05-17 02:00:00,51,297,7,19,750,670,80,13
3267,2022-05-17 03:00:00,106,280,14,14,539,471,68,11
3268,2022-05-17 04:00:00,91,212,8,11,741,644,97,6
3269,2022-05-17 05:00:00,114,184,10,11,646,532,114,8
3270,2022-05-17 06:00:00,92,114,7,13,703,548,155,14
3271,2022-05-17 07:00:00,56,243,6,14,768,669,99,10
3272,2022-05-17 08:00:00,130,243,13,12,598,479,119,8
3273,2022-05-17 09:00:00,119,254,14,16,742,616,126,10
3274,2022-05-17 10:00:00,85,281,10,15,778,690,88,9
3275,2022-05-17 11:00:00,108,167,5,12,586,452,134,13
3276,2022-05-17 12:00:00,79,294,12,13,613,519,94,5
3277,2022-05-17 13:00:00,81,249,14,14,676,599,77,9
3278,2022-05-17 14:00:00,73,230,11,17,656,526,130,9
3279,2022-05-17 15:00:00,84,265,7,15,766,634,132,12
3280,2022-05-17 16:00:00,74,164,5,14,587,419,168,11
3281,2022-05-17 17:00:00,77,202,11,17,656,553,103,9
3282,2022-05-17 18:00:00,96,163,9,12,626,546,80,14
3283,2022-05-17 19:00:00,78,127,9,14,635,480,155,9
3284,2022-05-17 20:00:00,94,195,11,13,525,402,123,5
3285,2022-05-17 21:00:00,52,190,12,15,787,563,224,6
3286,2022-05-17 22:00:00,65,103,6,15,638,487,151,13
3287,2022-05-17 23:00:00,123,137,7,12,734,628,106,13
3288,2022-05-18 00:00:00,109,294,6,17,767,666,101,10
3289,2022-05-18 01:00:00,105,111,11,10,732,657,75,5
3290,2022-05-18 02:00:00,53,162,5,14,775,619,156,10
3291,2022-05-18 03:00:00,126,229,9,16,726,597,129,6
3292,2022-05-18 04:00:00,144,155,6,12,684,596,88,7
3293,2022-05-18 05:00:00,80,216,12,19,526,381,145,9
3294,2022-05-18 06:00:00,107,181,5,13,603,427,176,5
3295,2022-05-18 07:00:00,131,179,11,10,640,545,95,13
3296,2022-05-18 08:00:00,73,294,13,16,658,503,155,11
3297,2022-05-18 09:00:00,83,134,14,16,704,591,113,11
3298,2022-05-18 10:00:00,144,189,7,10,604,510,94,10
3299,2022-05-18 11:00:00,105,120,13,11,757,538,219,9
3300,2022-05-18 12:00:00,69,249,14,11,640,479,161,14
3301,2022-05-18 13:00:00,81,104,11,10,666,564,102,9
3302,2022-05-18 14:00:00,133,138,5,12,515,438,77,6
3303,2022-05-18 15:00:00,107,169,10,12,556,499,57,11
3304,2022-05-18 16:00:00,110,141,10,14,720,573,147,7
3305,2022-05-18 17:00:00,139,287,10,14,778,559,219,7
3306,2022-05-18 18:00:00,50,154,6,10,710,631,79,11
3307,2022-05-18 19:00:00,57,288,12,13,760,570,190,13
3308,2022-05-18 20:00:00,122,277,9,14,677,504,173,14
3309,2022-05-18 21:00:00,133,162,10,11,638,472,166,8
3310,2022-05-18 22:00:00,98,271,7,18,792,692,100,13
3311,2022-05-18 23:00:00,97,194,14,14,650,567,83,9
3312,2022-05-19 00:00:00,58,145,10,17,687,481,206,6
3313,2022-05-19 01:00:00,145,144,14,13,692,592,100,8
3314,2022-05-19 02:00:00,109,178,7,18,656,530,126,5
3315,2022-05-19 03:00:00,127,159,8,18,512,405,107,6
3316,2022-05-19 04:00:00,105,134,12,15,668,523,145,9
3317,2022-05-19 05:00:00,132,148,9,12,585,497,88,11
3318,2022-05-19 06:00:00,123,239,9,19,681,523,158,11
3319,2022-05-19 07:00:00,61,205,9,19,711,498,213,14
3320,2022-05-19 08:00:00,142,211,12,18,738,649,89,12
3321,2022-05-19 09:00:00,52,278,6,18,674,571,103,12
3322,2022-05-19 10:00:00,94,120,6,16,778,618,160,12
3323,2022-05-19 11:00:00,114,295,10,16,778,641,137,11
3324,2022-05-19 12:00:00,63,214,13,17,653,492,161,11
3325,2022-05-19 13:00:00,60,134,10,19,630,546,84,7
3326,2022-05-19 14:00:00,130,122,14,17,531,416,115,14
3327,2022-05-19 15:00:00,71,251,10,10,519,380,139,6
3328,2022-05-19 16:00:00,59,161,6,11,723,555,168,14
3329,2022-05-19 17:00:00,78,165,10,10,685,606,79,6
3330,2022-05-19 18:00:00,81,269,12,15,578,517,61,12
3331,2022-05-19 19:00:00,115,298,13,12,772,624,148,7
3332,2022-05-19 20:00:00,68,163,9,10,686,504,182,6
3333,2022-05-19 21:00:00,89,195,10,19,733,558,175,8
3334,2022-05-19 22:00:00,92,235,13,12,507,414,93,6
3335,2022-05-19 23:00:00,101,167,9,17,734,633,101,9
3336,2022-05-20 00:00:00,116,256,6,16,580,491,89,12
3337,2022-05-20 01:00:00,122,234,10,19,521,427,94,10
3338,2022-05-20 02:00:00,67,112,11,13,764,643,121,8
3339,2022-05-20 03:00:00,127,103,8,11,796,560,236,10
3340,2022-05-20 04:00:00,127,102,11,12,673,504,169,7
3341,2022-05-20 05:00:00,69,190,7,10,688,595,93,7
3342,2022-05-20 06:00:00,54,254,5,12,533,418,115,12
3343,2022-05-20 07:00:00,98,284,13,11,581,426,155,5
3344,2022-05-20 08:00:00,78,261,12,14,691,588,103,14
3345,2022-05-20 09:00:00,76,198,9,19,593,483,110,7
3346,2022-05-20 10:00:00,109,266,13,16,634,549,85,5
3347,2022-05-20 11:00:00,93,188,8,18,604,511,93,7
3348,2022-05-20 12:00:00,52,277,8,18,682,524,158,12
3349,2022-05-20 13:00:00,70,179,10,15,614,458,156,9
3350,2022-05-20 14:00:00,123,103,12,14,526,454,72,11
3351,2022-05-20 15:00:00,120,147,8,16,698,531,167,13
3352,2022-05-20 16:00:00,117,144,7,16,757,543,214,11
3353,2022-05-20 17:00:00,65,149,7,17,760,567,193,13
3354,2022-05-20 18:00:00,145,204,10,18,755,656,99,6
3355,2022-05-20 19:00:00,83,101,8,18,544,395,149,7
3356,2022-05-20 20:00:00,118,190,10,12,508,443,65,12
3357,2022-05-20 21:00:00,131,280,5,10,680,551,129,9
3358,2022-05-20 22:00:00,112,114,10,16,793,570,223,5
3359,2022-05-20 23:00:00,83,292,6,12,559,472,87,8
3360,2022-05-21 00:00:00,112,253,12,18,554,445,109,11
3361,2022-05-21 01:00:00,131,236,9,18,686,564,122,6
3362,2022-05-21 02:00:00,116,254,9,17,716,638,78,11
3363,2022-05-21 03:00:00,105,104,8,17,636,494,142,12
3364,2022-05-21 04:00:00,137,199,13,17,772,598,174,10
3365,2022-05-21 05:00:00,137,110,9,11,568,451,117,14
3366,2022-05-21 06:00:00,52,189,12,17,704,558,146,8
3367,2022-05-21 07:00:00,143,222,10,19,640,464,176,5
3368,2022-05-21 08:00:00,137,233,12,18,513,458,55,5
3369,2022-05-21 09:00:00,74,282,6,11,707,561,146,7
3370,2022-05-21 10:00:00,59,196,10,16,594,487,107,6
3371,2022-05-21 11:00:00,87,157,14,18,651,541,110,10
3372,2022-05-21 12:00:00,129,188,12,12,642,526,116,6
3373,2022-05-21 13:00:00,99,208,9,13,792,594,198,5
3374,2022-05-21 14:00:00,94,126,5,19,760,582,178,5
3375,2022-05-21 15:00:00,64,285,13,17,674,598,76,7
3376,2022-05-21 16:00:00,90,187,6,14,731,534,197,8
3377,2022-05-21 17:00:00,79,211,14,17,686,486,200,11
3378,2022-05-21 18:00:00,137,170,7,14,757,614,143,10
3379,2022-05-21 19:00:00,136,264,5,15,599,476,123,12
3380,2022-05-21 20:00:00,69,149,6,17,790,606,184,10
3381,2022-05-21 21:00:00,68,173,10,16,702,520,182,12
3382,2022-05-21 22:00:00,93,125,11,15,656,504,152,5
3383,2022-05-21 23:00:00,93,276,5,10,640,476,164,9
3384,2022-05-22 00:00:00,130,281,14,10,681,572,109,8
3385,2022-05-22 01:00:00,134,130,11,17,649,528,121,11
3386,2022-05-22 02:00:00,90,185,14,19,564,455,109,14
3387,2022-05-22 03:00:00,93,202,14,13,518,402,116,9
3388,2022-05-22 04:00:00,144,180,14,12,542,413,129,11
3389,2022-05-22 05:00:00,98,173,8,17,559,416,143,8
3390,2022-05-22 06:00:00,91,210,5,17,581,451,130,12
3391,2022-05-22 07:00:00,105,126,12,18,550,451,99,9
3392,2022-05-22 08:00:00,99,293,10,19,610,477,133,7
3393,2022-05-22 09:00:00,98,219,7,11,615,434,181,14
3394,2022-05-22 10:00:00,60,130,9,13,764,565,199,5
3395,2022-05-22 11:00:00,85,277,8,11,513,412,101,9
3396,2022-05-22 12:00:00,76,107,9,15,561,488,73,12
3397,2022-05-22 13:00:00,93,104,11,12,590,509,81,5
3398,2022-05-22 14:00:00,143,184,10,19,559,471,88,12
3399,2022-05-22 15:00:00,102,279,14,11,640,485,155,7
3400,2022-05-22 16:00:00,101,251,5,14,630,493,137,13
3401,2022-05-22 17:00:00,77,134,9,15,755,602,153,13
3402,2022-05-22 18:00:00,90,273,8,14,547,446,101,7
3403,2022-05-22 19:00:00,52,182,9,17,773,587,186,10
3404,2022-05-22 20:00:00,78,287,9,18,568,465,103,14
3405,2022-05-22 21:00:00,120,205,11,12,650,520,130,14
3406,2022-05-22 22:00:00,64,282,13,18,521,435,86,7
3407,2022-05-22 23:00:00,58,257,13,11,500,386,114,6
3408,2022-05-23 00:00:00,60,269,6,13,783,558,225,6
3409,2022-05-23 01:00:00,119,189,10,17,724,608,116,11
3410,2022-05-23 02:00:00,89,271,12,10,679,553,126,10
3411,2022-05-23 03:00:00,149,263,11,16,517,393,124,14
3412,2022-05-23 04:00:00,121,289,11,17,788,580,208,9
3413,2022-05-23 05:00:00,128,192,14,10,560,398,162,12
3414,2022-05-23 06:00:00,148,185,9,19,759,647,112,8
3415,2022-05-23 07:00:00,109,283,11,10,552,439,113,12
3416,2022-05-23 08:00:00,144,299,10,10,729,549,180,13
3417,2022-05-23 09:00:00,92,233,7,13,598,456,142,7
3418,2022-05-23 10:00:00,85,103,8,17,506,355,151,5
3419,2022-05-23 11:00:00,132,264,6,16,774,553,221,8
3420,2022-05-23 12:00:00,128,132,14,16,630,495,135,12
3421,2022-05-23 13:00:00,50,260,5,15,543,396,147,7
3422,2022-05-23 14:00:00,93,264,9,15,596,460,136,12
3423,2022-05-23 15:00:00,78,131,5,17,585,523,62,14
3424,2022-05-23 16:00:00,134,253,7,18,786,638,148,11
3425,2022-05-23 17:00:00,60,109,10,13,636,500,136,13
3426,2022-05-23 18:00:00,70,195,5,19,520,460,60,8
3427,2022-05-23 19:00:00,135,102,12,17,775,552,223,7
3428,2022-05-23 20:00:00,72,265,8,15,792,556,236,11
3429,2022-05-23 21:00:00,134,299,5,15,601,449,152,14
3430,2022-05-23 22:00:00,148,117,13,13,702,621,81,6
3431,2022-05-23 23:00:00,77,210,14,17,742,543,199,9
3432,2022-05-24 00:00:00,109,248,11,13,784,664,120,9
3433,2022-05-24 01:00:00,66,174,7,12,627,535,92,10
3434,2022-05-24 02:00:00,123,182,12,19,720,557,163,7
3435,2022-05-24 03:00:00,52,142,6,18,650,569,81,13
3436,2022-05-24 04:00:00,114,265,10,10,768,582,186,12
3437,2022-05-24 05:00:00,59,160,11,12,615,463,152,11
3438,2022-05-24 06:00:00,51,267,6,13,540,468,72,12
3439,2022-05-24 07:00:00,100,126,7,10,773,547,226,14
3440,2022-05-24 08:00:00,149,163,9,16,695,599,96,10
3441,2022-05-24 09:00:00,98,250,13,15,585,518,67,11
3442,2022-05-24 10:00:00,127,195,6,16,580,442,138,8
3443,2022-05-24 11:00:00,92,269,7,18,795,577,218,8
3444,2022-05-24 12:00:00,58,279,9,14,551,482,69,6
3445,2022-05-24 13:00:00,59,202,12,15,574,437,137,8
3446,2022-05-24 14:00:00,143,175,8,15,543,386,157,7
3447,2022-05-24 15:00:00,101,122,14,14,614,509,105,10
3448,2022-05-24 16:00:00,64,154,12,18,565,446,119,5
3449,2022-05-24 17:00:00,56,163,14,17,561,413,148,7
3450,2022-05-24 18:00:00,129,112,9,10,601,530,71,13
3451,2022-05-24 19:00:00,118,188,14,12,756,669,87,13
3452,2022-05-24 20:00:00,50,276,7,14,608,461,147,5
3453,2022-05-24 21:00:00,110,176,12,10,561,465,96,13
3454,2022-05-24 22:00:00,148,218,6,15,796,626,170,13
3455,2022-05-24 23:00:00,58,180,11,14,694,517,177,8
3456,2022-05-25 00:00:00,99,157,14,17,620,519,101,7
3457,2022-05-25 01:00:00,148,161,10,11,545,389,156,12
3458,2022-05-25 02:00:00,135,139,8,19,580,511,69,12
3459,2022-05-25 03:00:00,99,181,11,12,575,506,69,8
3460,2022-05-25 04:00:00,65,257,10,15,721,552,169,8
3461,2022-05-25 05:00:00,85,268,14,12,689,521,168,8
3462,2022-05-25 06:00:00,84,183,10,11,676,514,162,5
3463,2022-05-25 07:00:00,74,183,6,14,620,460,160,14
3464,2022-05-25 08:00:00,66,163,14,12,585,519,66,8
3465,2022-05-25 09:00:00,133,170,5,12,673,539,134,8
3466,2022-05-25 10:00:00,76,121,8,14,696,504,192,8
3467,2022-05-25 11:00:00,79,281,11,10,662,555,107,11
3468,2022-05-25 12:00:00,70,208,13,12,794,599,195,14
3469,2022-05-25 13:00:00,72,285,12,14,555,473,82,6
3470,2022-05-25 14:00:00,77,147,7,14,684,492,192,6
3471,2022-05-25 15:00:00,78,208,14,17,660,506,154,14
3472,2022-05-25 16:00:00,143,186,8,11,520,467,53,8
3473,2022-05-25 17:00:00,134,146,14,10,635,570,65,9
3474,2022-05-25 18:00:00,86,151,9,17,625,491,134,5
3475,2022-05-25 19:00:00,72,213,6,19,606,441,165,12
3476,2022-05-25 20:00:00,110,244,9,17,753,563,190,8
3477,2022-05-25 21:00:00,126,227,13,18,649,520,129,10
3478,2022-05-25 22:00:00,60,292,11,17,624,468,156,12
3479,2022-05-25 23:00:00,140,163,6,19,783,570,213,14
3480,2022-05-26 00:00:00,136,201,5,17,546,416,130,13
3481,2022-05-26 01:00:00,114,121,14,13,743,546,197,14
3482,2022-05-26 02:00:00,106,154,6,14,667,473,194,14
3483,2022-05-26 03:00:00,124,266,10,11,577,507,70,13
3484,2022-05-26 04:00:00,73,162,12,13,679,592,87,8
3485,2022-05-26 05:00:00,98,187,9,19,734,580,154,6
3486,2022-05-26 06:00:00,143,184,13,13,735,581,154,9
3487,2022-05-26 07:00:00,132,257,9,16,558,489,69,8
3488,2022-05-26 08:00:00,58,279,7,16,578,466,112,9
3489,2022-05-26 09:00:00,95,299,10,12,743,667,76,13
3490,2022-05-26 10:00:00,59,270,11,14,653,566,87,6
3491,2022-05-26 11:00:00,146,274,14,11,704,590,114,11
3492,2022-05-26 12:00:00,53,242,9,16,758,627,131,6
3493,2022-05-26 13:00:00,86,159,11,16,567,500,67,11
3494,2022-05-26 14:00:00,56,234,12,19,595,474,121,14
3495,2022-05-26 15:00:00,135,286,5,19,630,504,126,9
3496,2022-05-26 16:00:00,137,272,14,11,641,571,70,7
3497,2022-05-26 17:00:00,140,200,13,11,722,617,105,14
3498,2022-05-26 18:00:00,80,160,9,16,582,486,96,5
3499,2022-05-26 19:00:00,147,123,8,10,659,587,72,5
3500,2022-05-26 20:00:00,76,100,13,12,671,573,98,7
3501,2022-05-26 21:00:00,107,159,8,18,554,495,59,5
3502,2022-05-26 22:00:00,118,130,11,11,606,536,70,7
3503,2022-05-26 23:00:00,119,191,12,11,551,454,97,12
3504,2022-05-27 00:00:00,141,145,10,15,645,559,86,14
3505,2022-05-27 01:00:00,77,242,9,14,574,408,166,10
3506,2022-05-27 02:00:00,122,283,8,11,662,467,195,9
3507,2022-05-27 03:00:00,71,176,8,19,653,541,112,7
3508,2022-05-27 04:00:00,125,233,10,13,772,663,109,11
3509,2022-05-27 05:00:00,58,102,14,11,761,676,85,10
3510,2022-05-27 06:00:00,105,176,14,15,501,413,88,12
3511,2022-05-27 07:00:00,88,296,6,16,718,621,97,10
3512,2022-05-27 08:00:00,133,115,9,14,516,393,123,6
3513,2022-05-27 09:00:00,61,188,8,12,613,505,108,6
3514,2022-05-27 10:00:00,105,277,13,13,797,603,194,11
3515,2022-05-27 11:00:00,125,145,8,18,638,451,187,6
3516,2022-05-27 12:00:00,101,213,13,14,603,534,69,6
3517,2022-05-27 13:00:00,110,195,9,19,661,579,82,7
3518,2022-05-27 14:00:00,94,198,9,15,582,428,154,11
3519,2022-05-27 15:00:00,76,294,10,17,649,552,97,8
3520,2022-05-27 16:00:00,88,175,11,10,734,543,191,13
3521,2022-05-27 17:00:00,56,127,14,13,533,386,147,12
3522,2022-05-27 18:00:00,94,190,11,14,634,556,78,13
3523,2022-05-27 19:00:00,69,200,9,11,648,554,94,11
3524,2022-05-27 20:00:00,79,141,9,12,637,530,107,5
3525,2022-05-27 21:00:00,142,192,8,19,691,505,186,7
3526,2022-05-27 22:00:00,113,233,13,15,600,478,122,14
3527,2022-05-27 23:00:00,123,190,14,18,759,627,132,11
3528,2022-05-28 00:00:00,126,113,6,15,687,496,191,6
3529,2022-05-28 01:00:00,72,203,12,17,604,447,157,8
3530,2022-05-28 02:00:00,95,121,6,12,630,524,106,7
3531,2022-05-28 03:00:00,61,166,14,14,744,564,180,5
3532,2022-05-28 04:00:00,135,238,6,12,663,570,93,14
3533,2022-05-28 05:00:00,122,155,5,15,517,408,109,9
3534,2022-05-28 06:00:00,59,243,5,11,652,492,160,14
3535,2022-05-28 07:00:00,71,172,9,15,564,421,143,14
3536,2022-05-28 08:00:00,62,107,14,19,523,465,58,10
3537,2022-05-28 09:00:00,147,153,7,14,588,442,146,5
3538,2022-05-28 10:00:00,111,277,11,12,653,566,87,7
3539,2022-05-28 11:00:00,135,293,8,16,751,552,199,6
3540,2022-05-28 12:00:00,130,216,8,15,709,601,108,7
3541,2022-05-28 13:00:00,84,129,5,13,709,507,202,11
3542,2022-05-28 14:00:00,65,111,8,15,505,356,149,11
3543,2022-05-28 15:00:00,118,161,13,13,616,535,81,14
3544,2022-05-28 16:00:00,55,277,12,10,737,570,167,11
3545,2022-05-28 17:00:00,105,189,14,14,795,611,184,7
3546,2022-05-28 18:00:00,95,149,14,11,723,614,109,11
3547,2022-05-28 19:00:00,105,230,7,17,696,522,174,9
3548,2022-05-28 20:00:00,82,110,14,11,550,441,109,12
3549,2022-05-28 21:00:00,90,131,6,10,656,488,168,13
3550,2022-05-28 22:00:00,127,186,12,15,780,552,228,10
3551,2022-05-28 23:00:00,111,239,9,10,767,543,224,9
3552,2022-05-29 00:00:00,80,116,14,18,757,564,193,13
3553,2022-05-29 01:00:00,126,278,10,10,601,510,91,10
3554,2022-05-29 02:00:00,130,109,9,16,659,557,102,12
3555,2022-05-29 03:00:00,73,298,14,11,777,690,87,7
3556,2022-05-29 04:00:00,81,136,5,11,756,614,142,12
3557,2022-05-29 05:00:00,97,249,8,13,579,438,141,14
3558,2022-05-29 06:00:00,104,215,5,10,756,601,155,14
3559,2022-05-29 07:00:00,103,249,8,15,585,492,93,6
3560,2022-05-29 08:00:00,124,179,7,17,787,589,198,13
3561,2022-05-29 09:00:00,55,121,6,18,653,573,80,13
3562,2022-05-29 10:00:00,120,215,5,18,560,495,65,7
3563,2022-05-29 11:00:00,99,288,8,14,728,521,207,11
3564,2022-05-29 12:00:00,71,290,5,16,667,570,97,10
3565,2022-05-29 13:00:00,60,203,6,16,721,514,207,12
3566,2022-05-29 14:00:00,61,114,14,18,759,632,127,12
3567,2022-05-29 15:00:00,58,211,12,17,572,499,73,13
3568,2022-05-29 16:00:00,119,179,13,16,556,465,91,5
3569,2022-05-29 17:00:00,122,232,5,14,756,574,182,5
3570,2022-05-29 18:00:00,60,128,8,15,757,598,159,8
3571,2022-05-29 19:00:00,67,221,5,12,692,563,129,14
3572,2022-05-29 20:00:00,71,195,14,15,608,546,62,7
3573,2022-05-29 21:00:00,104,149,6,16,757,636,121,14
3574,2022-05-29 22:00:00,63,223,10,12,796,643,153,8
3575,2022-05-29 23:00:00,103,138,10,16,533,393,140,5
3576,2022-05-30 00:00:00,147,158,11,10,574,438,136,7
3577,2022-05-30 01:00:00,102,182,11,18,687,485,202,6
3578,2022-05-30 02:00:00,87,247,12,10,695,611,84,14
3579,2022-05-30 03:00:00,73,111,7,16,631,441,190,11
3580,2022-05-30 04:00:00,50,192,10,19,783,701,82,9
3581,2022-05-30 05:00:00,71,126,7,13,656,556,100,7
3582,2022-05-30 06:00:00,132,143,9,10,548,487,61,8
3583,2022-05-30 07:00:00,148,148,10,18,678,580,98,14
3584,2022-05-30 08:00:00,81,191,14,15,515,420,95,12
3585,2022-05-30 09:00:00,77,151,13,11,671,588,83,14
3586,2022-05-30 10:00:00,66,195,8,13,629,522,107,7
3587,2022-05-30 11:00:00,69,237,7,13,592,456,136,11
3588,2022-05-30 12:00:00,76,197,10,16,527,396,131,13
3589,2022-05-30 13:00:00,76,230,7,15,540,454,86,11
3590,2022-05-30 14:00:00,112,192,8,10,532,435,97,5
3591,2022-05-30 15:00:00,68,200,5,15,613,509,104,9
3592,2022-05-30 16:00:00,106,180,10,16,554,486,68,8
3593,2022-05-30 17:00:00,144,273,8,16,687,582,105,9
3594,2022-05-30 18:00:00,146,195,10,14,715,512,203,10
3595,2022-05-30 19:00:00,109,130,8,10,602,431,171,12
3596,2022-05-30 20:00:00,54,160,5,12,545,423,122,11
3597,2022-05-30 21:00:00,63,115,14,17,704,598,106,9
3598,2022-05-30 22:00:00,96,241,8,10,616,482,134,10
3599,2022-05-30 23:00:00,94,200,11,16,553,492,61,8
3600,2022-05-31 00:00:00,120,217,10,18,696,543,153,12
3601,2022-05-31 01:00:00,64,225,7,14,725,601,124,7
3602,2022-05-31 02:00:00,79,257,5,18,701,540,161,13
3603,2022-05-31 03:00:00,63,103,5,16,523,436,87,8
3604,2022-05-31 04:00:00,77,252,10,12,638,454,184,7
3605,2022-05-31 05:00:00,56,241,9,15,565,486,79,5
3606,2022-05-31 06:00:00,117,207,10,16,778,631,147,5
3607,2022-05-31 07:00:00,88,206,12,12,601,442,159,6
3608,2022-05-31 08:00:00,107,209,10,17,722,619,103,9
3609,2022-05-31 09:00:00,128,150,6,18,722,607,115,13
3610,2022-05-31 10:00:00,93,101,9,11,766,664,102,10
3611,2022-05-31 11:00:00,98,100,8,17,624,520,104,13
3612,2022-05-31 12:00:00,139,118,10,10,670,594,76,7
3613,2022-05-31 13:00:00,120,223,8,11,795,601,194,11
3614,2022-05-31 14:00:00,118,108,13,10,536,476,60,6
3615,2022-05-31 15:00:00,63,181,7,13,755,551,204,5
3616,2022-05-31 16:00:00,77,235,5,13,623,485,138,10
3617,2022-05-31 17:00:00,85,124,12,12,566,409,157,6
3618,2022-05-31 18:00:00,74,145,10,14,593,516,77,6
3619,2022-05-31 19:00:00,107,139,9,17,648,509,139,10
3620,2022-05-31 20:00:00,110,132,7,10,657,547,110,8
3621,2022-05-31 21:00:00,140,191,10,17,729,652,77,7
3622,2022-05-31 22:00:00,136,106,12,15,675,587,88,5
3623,2022-05-31 23:00:00,68,292,11,10,639,567,72,5
3624,2022-06-01 00:00:00,60,173,12,18,546,483,63,13
3625,2022-06-01 01:00:00,90,234,5,18,591,469,122,13
3626,2022-06-01 02:00:00,79,241,6,16,545,488,57,6
3627,2022-06-01 03:00:00,102,103,5,19,765,649,116,5
3628,2022-06-01 04:00:00,106,171,5,15,612,513,99,8
3629,2022-06-01 05:00:00,107,208,13,11,688,525,163,7
3630,2022-06-01 06:00:00,73,284,13,15,606,532,74,14
3631,2022-06-01 07:00:00,82,187,7,14,507,407,100,10
3632,2022-06-01 08:00:00,120,135,13,16,750,617,133,6
3633,2022-06-01 09:00:00,93,208,13,17,729,562,167,10
3634,2022-06-01 10:00:00,148,119,7,18,543,485,58,6
3635,2022-06-01 11:00:00,148,181,14,16,720,576,144,13
3636,2022-06-01 12:00:00,128,179,10,12,748,526,222,5
3637,2022-06-01 13:00:00,112,129,9,18,798,623,175,5
3638,2022-06-01 14:00:00,69,107,11,13,798,587,211,5
3639,2022-06-01 15:00:00,77,272,14,16,774,610,164,14
3640,2022-06-01 16:00:00,141,232,12,18,733,628,105,12
3641,2022-06-01 17:00:00,55,163,14,16,724,533,191,11
3642,2022-06-01 18:00:00,115,261,10,10,587,487,100,10
3643,2022-06-01 19:00:00,80,121,5,14,607,447,160,5
3644,2022-06-01 20:00:00,72,288,9,10,560,460,100,14
3645,2022-06-01 21:00:00,99,171,9,18,734,567,167,5
3646,2022-06-01 22:00:00,131,238,10,16,629,524,105,9
3647,2022-06-01 23:00:00,87,128,6,18,518,443,75,9
3648,2022-06-02 00:00:00,148,272,10,16,602,493,109,12
3649,2022-06-02 01:00:00,53,180,7,14,603,428,175,11
3650,2022-06-02 02:00:00,85,184,8,19,634,554,80,10
3651,2022-06-02 03:00:00,70,175,11,18,652,553,99,11
3652,2022-06-02 04:00:00,113,154,7,12,712,623,89,12
3653,2022-06-02 05:00:00,124,174,7,19,720,510,210,12
3654,2022-06-02 06:00:00,118,243,13,15,630,525,105,10
3655,2022-06-02 07:00:00,111,188,5,10,634,526,108,7
3656,2022-06-02 08:00:00,72,134,12,15,747,569,178,14
3657,2022-06-02 09:00:00,98,101,6,14,680,570,110,7
3658,2022-06-02 10:00:00,132,253,11,10,634,494,140,7
3659,2022-06-02 11:00:00,78,111,11,16,542,457,85,12
3660,2022-06-02 12:00:00,76,100,7,11,759,579,180,11
3661,2022-06-02 13:00:00,145,294,14,15,540,463,77,13
3662,2022-06-02 14:00:00,128,293,6,18,700,588,112,13
3663,2022-06-02 15:00:00,132,159,14,19,707,563,144,11
3664,2022-06-02 16:00:00,61,103,6,17,688,582,106,8
3665,2022-06-02 17:00:00,79,244,6,12,799,640,159,7
3666,2022-06-02 18:00:00,110,109,9,14,507,398,109,8
3667,2022-06-02 19:00:00,120,140,14,10,601,516,85,6
3668,2022-06-02 20:00:00,81,175,14,18,697,564,133,8
3669,2022-06-02 21:00:00,107,194,13,12,752,583,169,10
3670,2022-06-02 22:00:00,149,152,12,18,695,515,180,8
3671,2022-06-02 23:00:00,96,299,11,18,558,474,84,5
3672,2022-06-03 00:00:00,111,185,13,18,554,402,152,10
3673,2022-06-03 01:00:00,113,128,11,16,783,698,85,13
3674,2022-06-03 02:00:00,116,203,10,12,754,576,178,14
3675,2022-06-03 03:00:00,138,235,12,17,673,541,132,5
3676,2022-06-03 04:00:00,131,106,13,19,721,634,87,12
3677,2022-06-03 05:00:00,53,111,10,14,526,442,84,7
3678,2022-06-03 06:00:00,92,108,14,18,681,476,205,11
3679,2022-06-03 07:00:00,128,237,12,13,764,664,100,5
3680,2022-06-03 08:00:00,72,261,5,11,542,400,142,12
3681,2022-06-03 09:00:00,123,229,9,11,705,542,163,5
3682,2022-06-03 10:00:00,116,278,7,10,609,534,75,11
3683,2022-06-03 11:00:00,142,258,7,18,580,462,118,5
3684,2022-06-03 12:00:00,122,252,10,10,707,633,74,13
3685,2022-06-03 13:00:00,83,161,12,13,772,546,226,10
3686,2022-06-03 14:00:00,111,273,5,18,664,514,150,7
3687,2022-06-03 15:00:00,139,197,12,11,506,437,69,11
3688,2022-06-03 16:00:00,121,110,12,10,799,615,184,10
3689,2022-06-03 17:00:00,113,160,6,11,713,634,79,13
3690,2022-06-03 18:00:00,50,202,6,11,606,443,163,10
3691,2022-06-03 19:00:00,98,273,14,12,793,700,93,6
3692,2022-06-03 20:00:00,122,210,12,11,643,554,89,5
3693,2022-06-03 21:00:00,141,213,9,12,535,473,62,11
3694,2022-06-03 22:00:00,63,236,8,14,689,533,156,11
3695,2022-06-03 23:00:00,89,266,9,19,774,622,152,13
3696,2022-06-04 00:00:00,143,151,11,15,563,422,141,5
3697,2022-06-04 01:00:00,50,240,7,14,678,551,127,9
3698,2022-06-04 02:00:00,112,234,13,17,500,397,103,7
3699,2022-06-04 03:00:00,96,110,13,17,752,654,98,8
3700,2022-06-04 04:00:00,118,239,9,19,514,366,148,11
3701,2022-06-04 05:00:00,115,229,9,10,797,676,121,7
3702,2022-06-04 06:00:00,80,169,5,15,566,469,97,7
3703,2022-06-04 07:00:00,115,294,6,12,716,588,128,7
3704,2022-06-04 08:00:00,67,149,13,14,587,437,150,14
3705,2022-06-04 09:00:00,104,297,13,12,715,597,118,13
3706,2022-06-04 10:00:00,84,251,7,18,597,428,169,13
3707,2022-06-04 11:00:00,124,138,6,13,764,550,214,10
3708,2022-06-04 12:00:00,78,282,5,16,662,559,103,5
3709,2022-06-04 13:00:00,113,283,9,17,681,587,94,5
3710,2022-06-04 14:00:00,90,139,13,14,592,490,102,7
3711,2022-06-04 15:00:00,91,131,5,19,668,586,82,5
3712,2022-06-04 16:00:00,118,241,8,13,797,658,139,6
3713,2022-06-04 17:00:00,118,174,7,19,793,668,125,12
3714,2022-06-04 18:00:00,118,155,11,11,676,488,188,12
3715,2022-06-04 19:00:00,80,192,9,17,590,425,165,13
3716,2022-06-04 20:00:00,87,176,14,19,678,573,105,9
3717,2022-06-04 21:00:00,58,220,9,18,584,434,150,6
3718,2022-06-04 22:00:00,90,146,14,12,617,540,77,10
3719,2022-06-04 23:00:00,83,232,6,12,666,485,181,8
3720,2022-06-05 00:00:00,101,195,13,10,611,458,153,6
3721,2022-06-05 01:00:00,95,219,12,13,751,663,88,9
3722,2022-06-05 02:00:00,149,267,6,14,594,497,97,10
3723,2022-06-05 03:00:00,59,223,14,16,641,517,124,10
3724,2022-06-05 04:00:00,87,203,9,12,635,468,167,14
3725,2022-06-05 05:00:00,87,152,12,11,557,465,92,6
3726,2022-06-05 06:00:00,147,118,10,15,698,519,179,12
3727,2022-06-05 07:00:00,104,287,9,18,702,497,205,11
3728,2022-06-05 08:00:00,118,150,7,15,501,372,129,12
3729,2022-06-05 09:00:00,78,252,6,14,602,462,140,8
3730,2022-06-05 10:00:00,73,151,5,17,675,482,193,13
3731,2022-06-05 11:00:00,131,269,9,17,688,587,101,6
3732,2022-06-05 12:00:00,71,204,12,16,555,498,57,14
3733,2022-06-05 13:00:00,87,271,13,19,609,514,95,11
3734,2022-06-05 14:00:00,98,273,12,15,628,565,63,6
3735,2022-06-05 15:00:00,145,254,13,14,620,504,116,12
3736,2022-06-05 16:00:00,62,259,13,19,577,490,87,9
3737,2022-06-05 17:00:00,139,256,6,12,740,619,121,11
3738,2022-06-05 18:00:00,54,290,7,17,574,428,146,8
3739,2022-06-05 19:00:00,109,164,9,14,545,427,118,8
3740,2022-06-05 20:00:00,84,255,13,10,528,399,129,8
3741,2022-06-05 21:00:00,107,162,14,18,748,595,153,14
3742,2022-06-05 22:00:00,141,144,9,17,736,587,149,10
3743,2022-06-05 23:00:00,93,119,12,16,692,591,101,5
3744,2022-06-06 00:00:00,72,188,8,14,642,463,179,11
3745,2022-06-06 01:00:00,90,256,8,12,568,436,132,6
3746,2022-06-06 02:00:00,70,198,7,13,788,623,165,7
3747,2022-06-06 03:00:00,61,225,6,12,504,443,61,14
3748,2022-06-06 04:00:00,126,134,14,12,558,427,131,12
3749,2022-06-06 05:00:00,99,199,11,15,576,490,86,5
3750,2022-06-06 06:00:00,120,251,5,13,620,446,174,10
3751,2022-06-06 07:00:00,126,118,5,11,739,642,97,14
3752,2022-06-06 08:00:00,137,294,10,17,529,434,95,9
3753,2022-06-06 09:00:00,63,258,5,19,545,387,158,6
3754,2022-06-06 10:00:00,73,113,13,12,639,556,83,10
3755,2022-06-06 11:00:00,133,169,6,10,623,465,158,7
3756,2022-06-06 12:00:00,147,210,9,15,644,476,168,9
3757,2022-06-06 13:00:00,144,114,10,16,581,422,159,5
3758,2022-06-06 14:00:00,74,258,8,12,721,521,200,12
3759,2022-06-06 15:00:00,127,213,14,11,631,470,161,8
3760,2022-06-06 16:00:00,80,275,6,10,560,421,139,9
3761,2022-06-06 17:00:00,115,185,12,14,513,404,109,10
3762,2022-06-06 18:00:00,82,100,6,13,659,544,115,11
3763,2022-06-06 19:00:00,69,188,12,17,688,482,206,9
3764,2022-06-06 20:00:00,87,111,6,19,543,450,93,8
3765,2022-06-06 21:00:00,67,299,5,10,651,548,103,13
3766,2022-06-06 22:00:00,69,234,10,14,520,423,97,7
3767,2022-06-06 23:00:00,59,100,6,17,584,440,144,7
3768,2022-06-07 00:00:00,104,146,12,17,524,456,68,9
3769,2022-06-07 01:00:00,60,222,10,10,696,532,164,6
3770,2022-06-07 02:00:00,136,221,10,12,560,479,81,7
3771,2022-06-07 03:00:00,142,167,6,18,575,445,130,14
3772,2022-06-07 04:00:00,97,137,8,14,626,491,135,14
3773,2022-06-07 05:00:00,82,164,14,16,769,598,171,5
3774,2022-06-07 06:00:00,84,111,14,19,651,504,147,5
3775,2022-06-07 07:00:00,86,255,10,13,746,533,213,11
3776,2022-06-07 08:00:00,111,118,6,14,630,477,153,10
3777,2022-06-07 09:00:00,137,141,6,18,600,429,171,11
3778,2022-06-07 10:00:00,58,140,11,16,528,384,144,12
3779,2022-06-07 11:00:00,118,186,10,10,770,663,107,7
3780,2022-06-07 12:00:00,126,125,12,10,783,585,198,9
3781,2022-06-07 13:00:00,57,161,11,19,568,457,111,14
3782,2022-06-07 14:00:00,93,171,7,15,611,429,182,7
3783,2022-06-07 15:00:00,130,205,7,14,522,390,132,6
3784,2022-06-07 16:00:00,61,276,9,16,645,553,92,11
3785,2022-06-07 17:00:00,51,209,8,15,598,510,88,10
3786,2022-06-07 18:00:00,79,140,11,17,581,411,170,9
3787,2022-06-07 19:00:00,51,230,12,15,503,364,139,6
3788,2022-06-07 20:00:00,102,249,14,19,523,390,133,6
3789,2022-06-07 21:00:00,140,109,8,18,701,596,105,10
3790,2022-06-07 22:00:00,105,120,12,11,518,392,126,5
3791,2022-06-07 23:00:00,53,103,5,16,628,475,153,11
3792,2022-06-08 00:00:00,81,167,11,18,773,558,215,11
3793,2022-06-08 01:00:00,94,130,12,12,702,512,190,7
3794,2022-06-08 02:00:00,132,175,13,17,781,684,97,11
3795,2022-06-08 03:00:00,102,187,10,17,584,518,66,9
3796,2022-06-08 04:00:00,128,174,8,19,541,450,91,9
3797,2022-06-08 05:00:00,66,260,14,13,742,566,176,7
3798,2022-06-08 06:00:00,135,236,10,13,687,557,130,12
3799,2022-06-08 07:00:00,126,160,13,19,545,455,90,11
3800,2022-06-08 08:00:00,122,297,12,16,681,528,153,11
3801,2022-06-08 09:00:00,128,193,6,17,526,419,107,10
3802,2022-06-08 10:00:00,85,276,12,11,576,436,140,13
3803,2022-06-08 11:00:00,135,175,12,13,753,666,87,14
3804,2022-06-08 12:00:00,88,274,5,14,581,465,116,10
3805,2022-06-08 13:00:00,141,269,13,19,570,508,62,7
3806,2022-06-08 14:00:00,104,264,12,13,701,585,116,10
3807,2022-06-08 15:00:00,108,274,13,16,544,443,101,6
3808,2022-06-08 16:00:00,149,121,11,16,645,475,170,14
3809,2022-06-08 17:00:00,81,279,14,12,568,491,77,12
3810,2022-06-08 18:00:00,99,209,7,17,522,460,62,6
3811,2022-06-08 19:00:00,139,122,12,12,696,527,169,7
3812,2022-06-08 20:00:00,129,140,13,10,545,402,143,10
3813,2022-06-08 21:00:00,118,264,6,14,677,575,102,11
3814,2022-06-08 22:00:00,134,178,13,12,543,432,111,10
3815,2022-06-08 23:00:00,138,205,10,11,764,543,221,13
3816,2022-06-09 00:00:00,126,112,13,10,576,506,70,5
3817,2022-06-09 01:00:00,78,145,7,18,569,465,104,9
3818,2022-06-09 02:00:00,129,270,13,18,725,649,76,6
3819,2022-06-09 03:00:00,83,165,9,16,538,391,147,5
3820,2022-06-09 04:00:00,99,229,11,17,523,449,74,10
3821,2022-06-09 05:00:00,111,195,6,13,788,662,126,9
3822,2022-06-09 06:00:00,90,237,11,16,541,483,58,8
3823,2022-06-09 07:00:00,91,169,10,10,587,504,83,12
3824,2022-06-09 08:00:00,139,163,8,17,723,569,154,8
3825,2022-06-09 09:00:00,80,165,5,15,579,435,144,11
3826,2022-06-09 10:00:00,102,197,11,18,743,644,99,13
3827,2022-06-09 11:00:00,93,130,9,19,571,498,73,14
3828,2022-06-09 12:00:00,143,217,6,15,573,445,128,8
3829,2022-06-09 13:00:00,123,230,8,11,778,594,184,8
3830,2022-06-09 14:00:00,130,236,8,12,635,467,168,10
3831,2022-06-09 15:00:00,134,223,13,19,584,426,158,14
3832,2022-06-09 16:00:00,134,233,5,19,585,414,171,6
3833,2022-06-09 17:00:00,106,206,13,18,632,461,171,8
3834,2022-06-09 18:00:00,67,145,6,16,748,592,156,9
3835,2022-06-09 19:00:00,143,221,14,15,783,628,155,14
3836,2022-06-09 20:00:00,64,298,14,19,727,529,198,12
3837,2022-06-09 21:00:00,144,184,12,11,711,628,83,11
3838,2022-06-09 22:00:00,125,245,12,16,567,455,112,9
3839,2022-06-09 23:00:00,85,267,10,18,733,517,216,5
3840,2022-06-10 00:00:00,68,263,6,10,660,571,89,13
3841,2022-06-10 01:00:00,133,296,11,11,619,441,178,12
3842,2022-06-10 02:00:00,96,153,13,12,694,577,117,6
3843,2022-06-10 03:00:00,117,198,13,16,775,554,221,5
3844,2022-06-10 04:00:00,75,185,8,11,549,491,58,9
3845,2022-06-10 05:00:00,82,160,10,15,788,699,89,5
3846,2022-06-10 06:00:00,125,148,11,15,628,447,181,12
3847,2022-06-10 07:00:00,118,100,7,10,750,611,139,11
3848,2022-06-10 08:00:00,55,121,12,11,783,559,224,7
3849,2022-06-10 09:00:00,95,205,10,18,731,554,177,9
3850,2022-06-10 10:00:00,128,113,13,16,693,516,177,7
3851,2022-06-10 11:00:00,63,297,5,17,746,655,91,6
3852,2022-06-10 12:00:00,59,159,8,14,529,458,71,7
3853,2022-06-10 13:00:00,114,207,5,19,714,556,158,11
3854,2022-06-10 14:00:00,133,189,11,17,511,382,129,5
3855,2022-06-10 15:00:00,68,143,6,12,506,416,90,11
3856,2022-06-10 16:00:00,92,209,9,17,759,664,95,6
3857,2022-06-10 17:00:00,143,189,12,15,581,493,88,11
3858,2022-06-10 18:00:00,74,105,6,17,746,570,176,10
3859,2022-06-10 19:00:00,83,156,12,13,717,600,117,12
3860,2022-06-10 20:00:00,133,236,8,10,581,471,110,12
3861,2022-06-10 21:00:00,143,129,5,16,510,420,90,11
3862,2022-06-10 22:00:00,74,183,10,13,643,509,134,8
3863,2022-06-10 23:00:00,67,279,7,19,678,491,187,9
3864,2022-06-11 00:00:00,63,123,5,18,677,592,85,10
3865,2022-06-11 01:00:00,98,294,5,17,787,563,224,7
3866,2022-06-11 02:00:00,104,128,6,19,751,539,212,14
3867,2022-06-11 03:00:00,101,248,13,17,576,431,145,11
3868,2022-06-11 04:00:00,136,241,5,14,505,450,55,8
3869,2022-06-11 05:00:00,90,108,12,10,583,461,122,9
3870,2022-06-11 06:00:00,57,100,13,10,577,507,70,8
3871,2022-06-11 07:00:00,80,248,11,12,560,411,149,6
3872,2022-06-11 08:00:00,77,264,12,12,774,641,133,8
3873,2022-06-11 09:00:00,119,236,9,17,582,493,89,14
3874,2022-06-11 10:00:00,109,146,11,19,699,575,124,6
3875,2022-06-11 11:00:00,50,164,9,19,558,435,123,12
3876,2022-06-11 12:00:00,105,265,8,18,647,468,179,11
3877,2022-06-11 13:00:00,101,189,6,11,665,476,189,9
3878,2022-06-11 14:00:00,85,107,13,11,540,454,86,13
3879,2022-06-11 15:00:00,51,264,9,13,640,529,111,10
3880,2022-06-11 16:00:00,74,121,5,14,579,410,169,6
3881,2022-06-11 17:00:00,141,158,13,19,636,552,84,5
3882,2022-06-11 18:00:00,80,194,9,16,708,521,187,9
3883,2022-06-11 19:00:00,90,166,14,10,759,652,107,8
3884,2022-06-11 20:00:00,68,188,11,11,706,525,181,5
3885,2022-06-11 21:00:00,57,190,14,18,719,589,130,12
3886,2022-06-11 22:00:00,105,265,14,14,727,553,174,12
3887,2022-06-11 23:00:00,50,127,12,18,621,435,186,9
3888,2022-06-12 00:00:00,125,154,11,18,557,428,129,6
3889,2022-06-12 01:00:00,106,179,11,17,543,481,62,12
3890,2022-06-12 02:00:00,55,195,12,18,683,508,175,13
3891,2022-06-12 03:00:00,128,270,9,17,519,400,119,10
3892,2022-06-12 04:00:00,98,128,10,11,758,589,169,10
3893,2022-06-12 05:00:00,93,100,9,19,754,593,161,11
3894,2022-06-12 06:00:00,143,100,12,10,586,440,146,14
3895,2022-06-12 07:00:00,129,210,13,13,528,440,88,7
3896,2022-06-12 08:00:00,111,265,6,13,650,458,192,8
3897,2022-06-12 09:00:00,116,217,11,13,660,546,114,13
3898,2022-06-12 10:00:00,106,123,6,10,702,548,154,6
3899,2022-06-12 11:00:00,147,108,11,10,535,441,94,13
3900,2022-06-12 12:00:00,144,208,6,16,547,439,108,5
3901,2022-06-12 13:00:00,89,243,7,17,700,583,117,10
3902,2022-06-12 14:00:00,90,179,11,13,675,507,168,13
3903,2022-06-12 15:00:00,67,273,13,13,616,450,166,7
3904,2022-06-12 16:00:00,136,292,12,15,567,476,91,9
3905,2022-06-12 17:00:00,79,113,10,16,579,414,165,5
3906,2022-06-12 18:00:00,134,161,6,17,737,557,180,7
3907,2022-06-12 19:00:00,100,205,6,10,626,545,81,12
3908,2022-06-12 20:00:00,141,239,6,14,667,542,125,9
3909,2022-06-12 21:00:00,53,160,14,18,590,513,77,13
3910,2022-06-12 22:00:00,71,176,10,11,619,491,128,12
3911,2022-06-12 23:00:00,84,158,7,15,670,587,83,8
3912,2022-06-13 00:00:00,118,108,7,14,546,406,140,10
3913,2022-06-13 01:00:00,114,105,9,10,756,668,88,8
3914,2022-06-13 02:00:00,99,218,7,14,723,567,156,11
3915,2022-06-13 03:00:00,94,177,11,18,731,618,113,11
3916,2022-06-13 04:00:00,88,145,6,15,580,518,62,6
3917,2022-06-13 05:00:00,113,219,10,11,604,428,176,7
3918,2022-06-13 06:00:00,148,121,5,15,617,508,109,13
3919,2022-06-13 07:00:00,113,286,10,10,551,494,57,13
3920,2022-06-13 08:00:00,101,196,13,12,650,569,81,6
3921,2022-06-13 09:00:00,91,105,8,14,572,470,102,14
3922,2022-06-13 10:00:00,53,199,14,15,672,474,198,8
3923,2022-06-13 11:00:00,71,287,6,11,755,539,216,6
3924,2022-06-13 12:00:00,106,225,13,14,563,496,67,12
3925,2022-06-13 13:00:00,120,125,11,17,587,488,99,13
3926,2022-06-13 14:00:00,76,177,5,19,718,525,193,11
3927,2022-06-13 15:00:00,120,229,6,16,602,443,159,8
3928,2022-06-13 16:00:00,141,201,13,15,715,562,153,5
3929,2022-06-13 17:00:00,127,107,8,12,753,667,86,6
3930,2022-06-13 18:00:00,88,229,7,11,764,676,88,9
3931,2022-06-13 19:00:00,76,198,6,19,580,462,118,9
3932,2022-06-13 20:00:00,115,294,11,15,609,463,146,14
3933,2022-06-13 21:00:00,61,268,6,18,591,508,83,6
3934,2022-06-13 22:00:00,96,191,5,15,518,445,73,7
3935,2022-06-13 23:00:00,60,225,13,11,599,422,177,5
3936,2022-06-14 00:00:00,70,153,8,12,576,440,136,12
3937,2022-06-14 01:00:00,64,136,10,16,646,577,69,9
3938,2022-06-14 02:00:00,106,272,7,10,517,374,143,10
3939,2022-06-14 03:00:00,94,169,12,11,636,489,147,7
3940,2022-06-14 04:00:00,120,251,12,15,703,571,132,11
3941,2022-06-14 05:00:00,57,252,6,11,586,428,158,10
3942,2022-06-14 06:00:00,122,207,14,11,603,516,87,7
3943,2022-06-14 07:00:00,62,133,14,13,582,468,114,13
3944,2022-06-14 08:00:00,75,228,13,12,682,507,175,5
3945,2022-06-14 09:00:00,81,139,14,14,683,578,105,8
3946,2022-06-14 10:00:00,66,298,10,15,739,581,158,14
3947,2022-06-14 11:00:00,116,180,8,18,725,571,154,14
3948,2022-06-14 12:00:00,98,282,7,11,766,562,204,13
3949,2022-06-14 13:00:00,122,167,7,14,630,458,172,5
3950,2022-06-14 14:00:00,126,119,10,17,748,657,91,5
3951,2022-06-14 15:00:00,95,138,14,13,692,516,176,10
3952,2022-06-14 16:00:00,93,111,12,15,646,534,112,14
3953,2022-06-14 17:00:00,148,161,6,14,540,388,152,11
3954,2022-06-14 18:00:00,94,279,9,18,586,457,129,13
3955,2022-06-14 19:00:00,122,155,10,11,648,555,93,11
3956,2022-06-14 20:00:00,50,232,8,10,512,393,119,12
3957,2022-06-14 21:00:00,89,292,11,16,772,596,176,7
3958,2022-06-14 22:00:00,115,231,13,12,783,675,108,11
3959,2022-06-14 23:00:00,71,229,7,15,799,662,137,8
3960,2022-06-15 00:00:00,128,107,6,14,659,465,194,9
3961,2022-06-15 01:00:00,143,110,8,15,769,552,217,7
3962,2022-06-15 02:00:00,87,220,12,16,663,581,82,11
3963,2022-06-15 03:00:00,122,185,14,18,688,500,188,13
3964,2022-06-15 04:00:00,75,195,5,12,724,556,168,10
3965,2022-06-15 05:00:00,71,218,10,16,689,567,122,14
3966,2022-06-15 06:00:00,74,276,10,12,651,498,153,12
3967,2022-06-15 07:00:00,54,162,8,15,655,540,115,7
3968,2022-06-15 08:00:00,128,200,5,16,785,640,145,13
3969,2022-06-15 09:00:00,95,119,9,10,692,533,159,5
3970,2022-06-15 10:00:00,93,246,13,10,744,626,118,9
3971,2022-06-15 11:00:00,110,243,8,11,669,535,134,13
3972,2022-06-15 12:00:00,51,250,8,19,544,444,100,14
3973,2022-06-15 13:00:00,143,146,10,16,758,669,89,12
3974,2022-06-15 14:00:00,52,254,5,10,694,539,155,8
3975,2022-06-15 15:00:00,114,131,12,11,577,479,98,7
3976,2022-06-15 16:00:00,75,133,6,14,560,410,150,8
3977,2022-06-15 17:00:00,112,292,13,10,671,582,89,11
3978,2022-06-15 18:00:00,73,124,11,12,523,373,150,6
3979,2022-06-15 19:00:00,141,288,7,12,693,591,102,10
3980,2022-06-15 20:00:00,140,193,12,11,592,464,128,5
3981,2022-06-15 21:00:00,90,122,7,18,593,485,108,10
3982,2022-06-15 22:00:00,135,100,10,13,717,520,197,12
3983,2022-06-15 23:00:00,127,200,12,17,627,530,97,7
3984,2022-06-16 00:00:00,53,213,9,14,781,591,190,7
3985,2022-06-16 01:00:00,51,111,12,13,563,427,136,13
3986,2022-06-16 02:00:00,137,107,10,15,674,486,188,11
3987,2022-06-16 03:00:00,70,248,10,13,686,518,168,14
3988,2022-06-16 04:00:00,66,104,13,16,572,503,69,6
3989,2022-06-16 05:00:00,84,158,9,13,604,484,120,12
3990,2022-06-16 06:00:00,99,190,13,16,545,397,148,9
3991,2022-06-16 07:00:00,111,164,11,11,795,589,206,11
3992,2022-06-16 08:00:00,54,120,11,18,641,573,68,7
3993,2022-06-16 09:00:00,91,207,8,13,514,409,105,5
3994,2022-06-16 10:00:00,140,173,6,19,573,468,105,10
3995,2022-06-16 11:00:00,80,110,11,19,558,405,153,7
3996,2022-06-16 12:00:00,145,106,13,15,666,581,85,7
3997,2022-06-16 13:00:00,93,185,9,12,770,636,134,14
3998,2022-06-16 14:00:00,104,298,8,13,681,485,196,11
3999,2022-06-16 15:00:00,88,105,10,12,573,450,123,13
4000,2022-06-16 16:00:00,77,248,14,10,530,408,122,8
4001,2022-06-16 17:00:00,102,148,11,11,539,426,113,7
4002,2022-06-16 18:00:00,83,105,12,18,764,577,187,11
4003,2022-06-16 19:00:00,142,163,13,11,795,691,104,14
4004,2022-06-16 20:00:00,139,228,5,11,714,601,113,11
4005,2022-06-16 21:00:00,131,105,6,16,757,550,207,5
4006,2022-06-16 22:00:00,119,253,8,16,551,471,80,9
4007,2022-06-16 23:00:00,97,233,5,19,680,489,191,9
4008,2022-06-17 00:00:00,68,255,6,15,592,513,79,13
4009,2022-06-17 01:00:00,67,121,6,10,741,591,150,14
4010,2022-06-17 02:00:00,72,135,10,17,578,448,130,11
4011,2022-06-17 03:00:00,135,253,14,14,754,535,219,5
4012,2022-06-17 04:00:00,130,299,11,17,512,382,130,5
4013,2022-06-17 05:00:00,134,254,12,10,701,570,131,6
4014,2022-06-17 06:00:00,101,180,12,19,640,529,111,11
4015,2022-06-17 07:00:00,87,247,12,13,615,504,111,13
4016,2022-06-17 08:00:00,136,287,6,14,701,549,152,13
4017,2022-06-17 09:00:00,90,102,10,10,587,508,79,14
4018,2022-06-17 10:00:00,132,135,13,13,748,554,194,7
4019,2022-06-17 11:00:00,116,104,10,17,522,403,119,11
4020,2022-06-17 12:00:00,75,164,8,18,570,511,59,10
4021,2022-06-17 13:00:00,94,135,11,15,677,495,182,11
4022,2022-06-17 14:00:00,122,147,14,18,705,619,86,7
4023,2022-06-17 15:00:00,80,131,8,15,633,534,99,10
4024,2022-06-17 16:00:00,84,201,13,17,506,354,152,11
4025,2022-06-17 17:00:00,86,171,5,13,663,492,171,14
4026,2022-06-17 18:00:00,54,173,7,17,679,600,79,5
4027,2022-06-17 19:00:00,84,179,14,12,760,605,155,13
4028,2022-06-17 20:00:00,105,114,12,10,554,404,150,13
4029,2022-06-17 21:00:00,107,244,14,13,763,597,166,5
4030,2022-06-17 22:00:00,125,245,12,17,757,558,199,11
4031,2022-06-17 23:00:00,87,153,11,18,536,382,154,7
4032,2022-06-18 00:00:00,86,253,13,18,746,666,80,6
4033,2022-06-18 01:00:00,79,149,8,14,586,432,154,8
4034,2022-06-18 02:00:00,140,240,10,13,658,535,123,14
4035,2022-06-18 03:00:00,122,182,13,18,776,576,200,13
4036,2022-06-18 04:00:00,114,159,10,17,783,598,185,9
4037,2022-06-18 05:00:00,79,228,10,16,772,552,220,12
4038,2022-06-18 06:00:00,97,239,12,19,747,653,94,14
4039,2022-06-18 07:00:00,64,135,8,14,519,375,144,7
4040,2022-06-18 08:00:00,61,292,13,17,594,487,107,9
4041,2022-06-18 09:00:00,81,150,11,13,746,548,198,6
4042,2022-06-18 10:00:00,115,281,9,11,628,458,170,11
4043,2022-06-18 11:00:00,61,211,7,11,759,624,135,13
4044,2022-06-18 12:00:00,91,227,10,11,710,536,174,7
4045,2022-06-18 13:00:00,135,154,13,14,731,642,89,14
4046,2022-06-18 14:00:00,118,139,8,11,790,638,152,8
4047,2022-06-18 15:00:00,86,161,8,15,550,422,128,13
4048,2022-06-18 16:00:00,55,129,12,14,562,495,67,10
4049,2022-06-18 17:00:00,73,276,7,18,713,554,159,13
4050,2022-06-18 18:00:00,68,110,10,17,706,542,164,13
4051,2022-06-18 19:00:00,125,293,11,15,504,375,129,12
4052,2022-06-18 20:00:00,102,179,6,19,641,554,87,10
4053,2022-06-18 21:00:00,106,206,6,11,798,562,236,13
4054,2022-06-18 22:00:00,135,143,9,19,687,496,191,6
4055,2022-06-18 23:00:00,79,245,13,16,543,425,118,10
4056,2022-06-19 00:00:00,145,114,5,16,555,472,83,11
4057,2022-06-19 01:00:00,74,118,10,11,602,538,64,11
4058,2022-06-19 02:00:00,56,224,6,12,706,620,86,10
4059,2022-06-19 03:00:00,68,243,13,15,670,541,129,9
4060,2022-06-19 04:00:00,51,179,6,12,739,531,208,12
4061,2022-06-19 05:00:00,99,286,6,10,590,425,165,12
4062,2022-06-19 06:00:00,67,207,6,14,776,638,138,9
4063,2022-06-19 07:00:00,126,229,13,10,682,479,203,8
4064,2022-06-19 08:00:00,77,250,8,13,692,575,117,8
4065,2022-06-19 09:00:00,133,299,6,17,794,557,237,13
4066,2022-06-19 10:00:00,89,106,5,15,729,623,106,5
4067,2022-06-19 11:00:00,51,101,13,15,505,412,93,7
4068,2022-06-19 12:00:00,96,109,5,15,775,694,81,13
4069,2022-06-19 13:00:00,52,100,8,13,533,441,92,13
4070,2022-06-19 14:00:00,130,185,11,14,762,678,84,11
4071,2022-06-19 15:00:00,94,100,10,19,573,503,70,9
4072,2022-06-19 16:00:00,114,175,13,14,696,544,152,12
4073,2022-06-19 17:00:00,70,165,8,11,620,481,139,10
4074,2022-06-19 18:00:00,110,271,7,15,755,557,198,13
4075,2022-06-19 19:00:00,132,108,8,11,534,376,158,13
4076,2022-06-19 20:00:00,95,150,12,15,718,581,137,10
4077,2022-06-19 21:00:00,53,203,8,12,583,437,146,5
4078,2022-06-19 22:00:00,102,246,13,19,601,538,63,5
4079,2022-06-19 23:00:00,115,168,8,18,755,591,164,9
4080,2022-06-20 00:00:00,70,153,11,10,517,395,122,13
4081,2022-06-20 01:00:00,58,122,10,11,741,600,141,14
4082,2022-06-20 02:00:00,61,101,7,11,714,518,196,14
4083,2022-06-20 03:00:00,54,275,11,12,683,551,132,13
4084,2022-06-20 04:00:00,88,195,8,13,675,604,71,7
4085,2022-06-20 05:00:00,144,250,14,15,763,590,173,11
4086,2022-06-20 06:00:00,123,129,10,11,605,525,80,12
4087,2022-06-20 07:00:00,141,225,10,17,754,539,215,10
4088,2022-06-20 08:00:00,68,113,13,18,772,544,228,14
4089,2022-06-20 09:00:00,57,199,11,13,618,540,78,8
4090,2022-06-20 10:00:00,94,128,13,10,594,469,125,13
4091,2022-06-20 11:00:00,91,139,10,10,702,542,160,7
4092,2022-06-20 12:00:00,97,192,8,18,741,661,80,10
4093,2022-06-20 13:00:00,130,144,5,14,622,494,128,13
4094,2022-06-20 14:00:00,122,224,8,13,546,408,138,9
4095,2022-06-20 15:00:00,66,278,5,14,713,503,210,8
4096,2022-06-20 16:00:00,107,102,6,15,623,546,77,12
4097,2022-06-20 17:00:00,102,258,11,19,620,478,142,8
4098,2022-06-20 18:00:00,55,237,14,16,796,673,123,6
4099,2022-06-20 19:00:00,106,163,12,11,774,614,160,9
4100,2022-06-20 20:00:00,101,237,13,10,724,582,142,5
4101,2022-06-20 21:00:00,133,285,9,12,632,477,155,6
4102,2022-06-20 22:00:00,76,252,10,17,561,424,137,11
4103,2022-06-20 23:00:00,125,206,5,11,602,485,117,10
4104,2022-06-21 00:00:00,110,275,5,14,528,388,140,7
4105,2022-06-21 01:00:00,66,154,12,10,675,492,183,5
4106,2022-06-21 02:00:00,60,172,6,16,797,579,218,8
4107,2022-06-21 03:00:00,51,252,6,14,720,550,170,8
4108,2022-06-21 04:00:00,140,180,13,18,722,568,154,5
4109,2022-06-21 05:00:00,101,153,13,19,540,459,81,8
4110,2022-06-21 06:00:00,146,184,5,13,660,496,164,5
4111,2022-06-21 07:00:00,68,226,12,11,792,649,143,10
4112,2022-06-21 08:00:00,148,152,11,18,725,530,195,8
4113,2022-06-21 09:00:00,96,219,8,16,747,534,213,10
4114,2022-06-21 10:00:00,143,198,12,17,794,703,91,10
4115,2022-06-21 11:00:00,67,248,11,15,732,657,75,5
4116,2022-06-21 12:00:00,146,291,7,14,787,558,229,11
4117,2022-06-21 13:00:00,132,109,7,17,523,423,100,5
4118,2022-06-21 14:00:00,91,245,13,14,758,660,98,8
4119,2022-06-21 15:00:00,118,275,7,16,655,572,83,5
4120,2022-06-21 16:00:00,145,138,10,11,797,699,98,12
4121,2022-06-21 17:00:00,94,279,7,11,759,653,106,7
4122,2022-06-21 18:00:00,143,146,8,13,713,606,107,8
4123,2022-06-21 19:00:00,57,267,5,15,681,595,86,13
4124,2022-06-21 20:00:00,99,262,7,15,646,555,91,10
4125,2022-06-21 21:00:00,112,140,8,19,539,404,135,8
4126,2022-06-21 22:00:00,122,295,12,19,617,465,152,6
4127,2022-06-21 23:00:00,50,150,10,19,740,521,219,13
4128,2022-06-22 00:00:00,69,204,9,18,660,503,157,9
4129,2022-06-22 01:00:00,143,221,10,16,794,694,100,11
4130,2022-06-22 02:00:00,113,167,9,17,548,403,145,9
4131,2022-06-22 03:00:00,65,118,6,14,756,591,165,5
4132,2022-06-22 04:00:00,64,203,8,14,502,378,124,11
4133,2022-06-22 05:00:00,51,183,9,19,549,389,160,12
4134,2022-06-22 06:00:00,99,284,12,10,613,546,67,9
4135,2022-06-22 07:00:00,68,122,9,13,789,662,127,14
4136,2022-06-22 08:00:00,102,210,6,16,789,566,223,14
4137,2022-06-22 09:00:00,125,217,11,13,615,452,163,14
4138,2022-06-22 10:00:00,65,116,5,13,703,554,149,8
4139,2022-06-22 11:00:00,92,203,11,13,504,359,145,8
4140,2022-06-22 12:00:00,145,116,14,19,624,515,109,13
4141,2022-06-22 13:00:00,141,236,7,16,606,516,90,14
4142,2022-06-22 14:00:00,122,118,6,11,687,520,167,5
4143,2022-06-22 15:00:00,111,105,7,13,521,422,99,5
4144,2022-06-22 16:00:00,56,298,7,12,555,492,63,9
4145,2022-06-22 17:00:00,54,110,12,19,725,581,144,12
4146,2022-06-22 18:00:00,53,263,12,15,608,518,90,11
4147,2022-06-22 19:00:00,110,227,13,17,523,438,85,10
4148,2022-06-22 20:00:00,125,153,6,19,667,485,182,7
4149,2022-06-22 21:00:00,132,258,11,19,687,520,167,8
4150,2022-06-22 22:00:00,124,274,8,10,793,665,128,11
4151,2022-06-22 23:00:00,122,222,9,15,757,617,140,12
4152,2022-06-23 00:00:00,84,244,12,12,543,464,79,5
4153,2022-06-23 01:00:00,74,170,11,15,564,460,104,6
4154,2022-06-23 02:00:00,97,277,10,17,574,485,89,10
4155,2022-06-23 03:00:00,144,187,11,15,580,488,92,6
4156,2022-06-23 04:00:00,97,236,7,12,582,454,128,13
4157,2022-06-23 05:00:00,79,135,14,12,793,682,111,12
4158,2022-06-23 06:00:00,56,257,5,19,747,671,76,14
4159,2022-06-23 07:00:00,138,145,14,15,692,589,103,6
4160,2022-06-23 08:00:00,100,252,11,18,631,522,109,6
4161,2022-06-23 09:00:00,55,117,10,17,767,641,126,10
4162,2022-06-23 10:00:00,149,152,10,17,736,552,184,8
4163,2022-06-23 11:00:00,66,133,13,16,796,694,102,12
4164,2022-06-23 12:00:00,107,239,12,11,622,509,113,12
4165,2022-06-23 13:00:00,79,252,9,16,559,422,137,8
4166,2022-06-23 14:00:00,112,134,14,14,516,402,114,11
4167,2022-06-23 15:00:00,95,289,10,13,577,426,151,9
4168,2022-06-23 16:00:00,134,186,5,18,524,425,99,6
4169,2022-06-23 17:00:00,109,254,5,11,745,658,87,6
4170,2022-06-23 18:00:00,134,247,11,17,581,449,132,13
4171,2022-06-23 19:00:00,87,273,7,18,758,577,181,11
4172,2022-06-23 20:00:00,62,182,10,12,753,631,122,13
4173,2022-06-23 21:00:00,56,115,9,11,782,640,142,5
4174,2022-06-23 22:00:00,109,193,11,10,694,534,160,11
4175,2022-06-23 23:00:00,142,281,7,18,655,507,148,10
4176,2022-06-24 00:00:00,147,215,10,14,515,442,73,9
4177,2022-06-24 01:00:00,84,277,13,15,538,382,156,9
4178,2022-06-24 02:00:00,100,292,13,13,524,371,153,11
4179,2022-06-24 03:00:00,131,191,11,12,529,428,101,8
4180,2022-06-24 04:00:00,135,135,11,19,643,456,187,9
4181,2022-06-24 05:00:00,92,296,5,19,557,490,67,8
4182,2022-06-24 06:00:00,68,279,12,16,738,562,176,10
4183,2022-06-24 07:00:00,105,126,10,11,728,535,193,12
4184,2022-06-24 08:00:00,139,100,13,17,583,497,86,14
4185,2022-06-24 09:00:00,143,260,6,17,641,496,145,11
4186,2022-06-24 10:00:00,108,120,10,14,787,651,136,13
4187,2022-06-24 11:00:00,55,256,12,10,797,641,156,12
4188,2022-06-24 12:00:00,143,262,14,11,630,564,66,6
4189,2022-06-24 13:00:00,75,278,6,16,797,688,109,5
4190,2022-06-24 14:00:00,138,185,12,13,504,363,141,13
4191,2022-06-24 15:00:00,121,176,7,11,718,521,197,8
4192,2022-06-24 16:00:00,87,242,14,14,793,688,105,14
4193,2022-06-24 17:00:00,73,261,9,14,563,412,151,14
4194,2022-06-24 18:00:00,123,186,6,16,680,530,150,12
4195,2022-06-24 19:00:00,117,232,11,11,650,457,193,6
4196,2022-06-24 20:00:00,148,200,10,16,793,663,130,9
4197,2022-06-24 21:00:00,80,206,7,10,595,426,169,8
4198,2022-06-24 22:00:00,99,134,8,13,517,449,68,14
4199,2022-06-24 23:00:00,147,264,6,11,785,599,186,14
4200,2022-06-25 00:00:00,53,161,7,13,737,636,101,9
4201,2022-06-25 01:00:00,83,252,9,19,562,407,155,13
4202,2022-06-25 02:00:00,144,162,13,18,731,620,111,11
4203,2022-06-25 03:00:00,108,249,9,13,721,609,112,10
4204,2022-06-25 04:00:00,121,286,7,13,716,565,151,12
4205,2022-06-25 05:00:00,90,159,14,12,653,575,78,6
4206,2022-06-25 06:00:00,140,165,10,13,791,582,209,8
4207,2022-06-25 07:00:00,74,235,6,17,627,546,81,10
4208,2022-06-25 08:00:00,63,109,8,15,502,368,134,6
4209,2022-06-25 09:00:00,50,281,7,11,784,586,198,9
4210,2022-06-25 10:00:00,67,220,13,19,562,422,140,13
4211,2022-06-25 11:00:00,85,143,12,10,647,498,149,13
4212,2022-06-25 12:00:00,122,270,11,17,601,472,129,12
4213,2022-06-25 13:00:00,87,206,14,18,788,658,130,6
4214,2022-06-25 14:00:00,63,243,9,17,677,569,108,10
4215,2022-06-25 15:00:00,68,263,6,17,762,627,135,7
4216,2022-06-25 16:00:00,72,171,11,12,664,510,154,5
4217,2022-06-25 17:00:00,52,254,5,11,716,637,79,5
4218,2022-06-25 18:00:00,122,135,7,12,663,559,104,14
4219,2022-06-25 19:00:00,80,147,13,19,502,418,84,6
4220,2022-06-25 20:00:00,149,153,7,11,722,583,139,7
4221,2022-06-25 21:00:00,144,202,14,15,598,433,165,10
4222,2022-06-25 22:00:00,71,151,14,16,691,534,157,14
4223,2022-06-25 23:00:00,76,282,14,10,770,686,84,14
4224,2022-06-26 00:00:00,53,242,5,16,712,605,107,8
4225,2022-06-26 01:00:00,61,162,7,11,553,453,100,13
4226,2022-06-26 02:00:00,74,284,10,13,513,435,78,6
4227,2022-06-26 03:00:00,84,260,5,14,782,548,234,10
4228,2022-06-26 04:00:00,145,202,12,13,603,428,175,7
4229,2022-06-26 05:00:00,103,124,11,14,548,431,117,10
4230,2022-06-26 06:00:00,94,257,9,16,629,512,117,12
4231,2022-06-26 07:00:00,113,260,5,12,685,511,174,7
4232,2022-06-26 08:00:00,75,244,10,17,563,506,57,12
4233,2022-06-26 09:00:00,71,121,9,14,537,476,61,6
4234,2022-06-26 10:00:00,145,207,14,17,792,635,157,6
4235,2022-06-26 11:00:00,74,200,14,10,776,689,87,7
4236,2022-06-26 12:00:00,125,192,11,16,787,603,184,8
4237,2022-06-26 13:00:00,112,100,12,12,551,388,163,6
4238,2022-06-26 14:00:00,68,193,6,16,745,623,122,10
4239,2022-06-26 15:00:00,56,291,14,15,531,397,134,8
4240,2022-06-26 16:00:00,131,222,6,11,686,514,172,7
4241,2022-06-26 17:00:00,106,266,5,17,681,548,133,5
4242,2022-06-26 18:00:00,67,162,7,10,523,411,112,10
4243,2022-06-26 19:00:00,93,109,13,16,636,535,101,14
4244,2022-06-26 20:00:00,70,252,9,15,551,385,166,5
4245,2022-06-26 21:00:00,133,132,14,13,514,420,94,10
4246,2022-06-26 22:00:00,140,208,5,18,596,492,104,10
4247,2022-06-26 23:00:00,116,208,5,15,594,515,79,11
4248,2022-06-27 00:00:00,105,120,13,11,568,474,94,6
4249,2022-06-27 01:00:00,115,232,10,17,542,436,106,11
4250,2022-06-27 02:00:00,143,158,7,14,740,651,89,12
4251,2022-06-27 03:00:00,53,215,7,13,766,556,210,6
4252,2022-06-27 04:00:00,142,254,10,13,565,500,65,10
4253,2022-06-27 05:00:00,87,239,11,18,743,642,101,9
4254,2022-06-27 06:00:00,92,138,14,14,534,430,104,12
4255,2022-06-27 07:00:00,98,105,10,11,540,469,71,8
4256,2022-06-27 08:00:00,140,234,11,18,714,640,74,7
4257,2022-06-27 09:00:00,99,293,5,10,707,504,203,9
4258,2022-06-27 10:00:00,120,143,13,17,788,604,184,12
4259,2022-06-27 11:00:00,51,120,13,14,608,500,108,10
4260,2022-06-27 12:00:00,143,176,6,12,780,644,136,8
4261,2022-06-27 13:00:00,142,287,12,17,590,496,94,12
4262,2022-06-27 14:00:00,119,186,12,11,618,495,123,6
4263,2022-06-27 15:00:00,119,143,10,18,611,512,99,11
4264,2022-06-27 16:00:00,120,281,14,10,666,470,196,9
4265,2022-06-27 17:00:00,53,189,10,12,774,655,119,5
4266,2022-06-27 18:00:00,119,121,9,18,700,508,192,7
4267,2022-06-27 19:00:00,124,108,8,16,785,617,168,9
4268,2022-06-27 20:00:00,52,234,11,19,597,513,84,7
4269,2022-06-27 21:00:00,87,133,5,17,787,653,134,5
4270,2022-06-27 22:00:00,113,297,12,16,534,427,107,11
4271,2022-06-27 23:00:00,59,102,7,14,579,475,104,6
4272,2022-06-28 00:00:00,121,243,6,18,559,403,156,5
4273,2022-06-28 01:00:00,78,245,13,16,614,433,181,12
4274,2022-06-28 02:00:00,136,158,10,12,637,458,179,8
4275,2022-06-28 03:00:00,144,292,11,12,512,428,84,13
4276,2022-06-28 04:00:00,83,258,10,14,779,589,190,5
4277,2022-06-28 05:00:00,85,173,13,18,560,439,121,5
4278,2022-06-28 06:00:00,133,116,9,12,527,467,60,7
4279,2022-06-28 07:00:00,129,203,10,18,757,664,93,6
4280,2022-06-28 08:00:00,75,138,9,15,772,656,116,12
4281,2022-06-28 09:00:00,67,120,12,12,634,502,132,9
4282,2022-06-28 10:00:00,88,105,9,14,564,465,99,8
4283,2022-06-28 11:00:00,80,273,10,11,694,556,138,13
4284,2022-06-28 12:00:00,116,162,6,18,596,450,146,12
4285,2022-06-28 13:00:00,104,238,12,19,627,556,71,6
4286,2022-06-28 14:00:00,57,202,14,15,687,545,142,11
4287,2022-06-28 15:00:00,69,149,10,10,745,552,193,12
4288,2022-06-28 16:00:00,91,139,6,16,572,499,73,12
4289,2022-06-28 17:00:00,142,287,6,19,521,416,105,7
4290,2022-06-28 18:00:00,128,222,9,14,500,382,118,8
4291,2022-06-28 19:00:00,74,215,6,16,603,466,137,14
4292,2022-06-28 20:00:00,68,248,9,15,638,488,150,11
4293,2022-06-28 21:00:00,133,224,7,11,743,663,80,11
4294,2022-06-28 22:00:00,102,296,7,10,528,457,71,7
4295,2022-06-28 23:00:00,80,194,10,19,641,452,189,9
4296,2022-06-29 00:00:00,125,227,9,15,757,620,137,14
4297,2022-06-29 01:00:00,106,152,13,10,750,672,78,9
4298,2022-06-29 02:00:00,100,157,11,15,670,577,93,8
4299,2022-06-29 03:00:00,63,155,11,19,792,705,87,6
4300,2022-06-29 04:00:00,66,227,6,19,543,400,143,11
4301,2022-06-29 05:00:00,102,134,8,17,763,595,168,14
4302,2022-06-29 06:00:00,66,100,11,13,750,551,199,7
4303,2022-06-29 07:00:00,111,186,5,19,577,467,110,10
4304,2022-06-29 08:00:00,50,114,14,18,712,562,150,13
4305,2022-06-29 09:00:00,74,129,12,14,636,562,74,13
4306,2022-06-29 10:00:00,104,105,5,10,576,480,96,12
4307,2022-06-29 11:00:00,89,112,11,13,559,427,132,13
4308,2022-06-29 12:00:00,145,185,12,16,524,408,116,14
4309,2022-06-29 13:00:00,54,164,11,14,796,642,154,8
4310,2022-06-29 14:00:00,67,272,9,13,728,645,83,6
4311,2022-06-29 15:00:00,67,256,5,16,674,594,80,13
4312,2022-06-29 16:00:00,120,298,7,19,571,504,67,6
4313,2022-06-29 17:00:00,109,282,10,16,754,602,152,13
4314,2022-06-29 18:00:00,82,151,14,12,627,507,120,14
4315,2022-06-29 19:00:00,145,155,12,12,683,484,199,9
4316,2022-06-29 20:00:00,82,160,10,13,650,575,75,11
4317,2022-06-29 21:00:00,61,283,5,10,771,571,200,12
4318,2022-06-29 22:00:00,57,134,9,19,681,590,91,11
4319,2022-06-29 23:00:00,83,121,9,10,517,446,71,9
4320,2022-06-30 00:00:00,110,203,5,13,551,463,88,11
4321,2022-06-30 01:00:00,144,217,12,11,714,532,182,6
4322,2022-06-30 02:00:00,71,277,6,17,659,500,159,5
4323,2022-06-30 03:00:00,72,172,9,10,737,596,141,8
4324,2022-06-30 04:00:00,67,157,8,10,626,488,138,9
4325,2022-06-30 05:00:00,89,286,12,13,715,530,185,7
4326,2022-06-30 06:00:00,115,211,9,18,674,577,97,14
4327,2022-06-30 07:00:00,149,222,11,18,636,493,143,6
4328,2022-06-30 08:00:00,75,136,10,16,702,565,137,8
4329,2022-06-30 09:00:00,76,265,9,13,676,524,152,7
4330,2022-06-30 10:00:00,68,179,9,17,786,565,221,5
4331,2022-06-30 11:00:00,84,285,13,16,679,525,154,7
4332,2022-06-30 12:00:00,88,234,10,19,544,480,64,10
4333,2022-06-30 13:00:00,58,240,5,12,585,497,88,5
4334,2022-06-30 14:00:00,141,174,11,15,676,509,167,8
4335,2022-06-30 15:00:00,138,106,6,18,675,511,164,13
4336,2022-06-30 16:00:00,84,283,10,15,799,566,233,12
4337,2022-06-30 17:00:00,97,179,9,17,616,550,66,6
4338,2022-06-30 18:00:00,143,289,12,10,609,456,153,12
4339,2022-06-30 19:00:00,132,165,13,14,665,562,103,12
4340,2022-06-30 20:00:00,120,275,12,11,745,663,82,7
4341,2022-06-30 21:00:00,95,137,10,11,739,633,106,5
4342,2022-06-30 22:00:00,81,243,12,16,638,452,186,8
4343,2022-06-30 23:00:00,149,179,8,11,765,612,153,9
4344,2022-07-01 00:00:00,51,255,6,13,717,535,182,8
4345,2022-07-01 01:00:00,143,176,9,16,593,435,158,9
4346,2022-07-01 02:00:00,129,143,7,12,538,412,126,7
4347,2022-07-01 03:00:00,94,107,9,11,689,617,72,8
4348,2022-07-01 04:00:00,108,180,13,13,683,532,151,12
4349,2022-07-01 05:00:00,131,212,6,16,633,497,136,11
4350,2022-07-01 06:00:00,50,255,5,16,554,413,141,9
4351,2022-07-01 07:00:00,113,208,5,11,675,589,86,7
4352,2022-07-01 08:00:00,121,267,5,19,514,400,114,10
4353,2022-07-01 09:00:00,71,171,12,13,585,494,91,12
4354,2022-07-01 10:00:00,111,290,12,17,624,490,134,13
4355,2022-07-01 11:00:00,54,252,5,14,699,509,190,7
4356,2022-07-01 12:00:00,134,284,5,10,688,520,168,5
4357,2022-07-01 13:00:00,77,167,10,12,508,404,104,13
4358,2022-07-01 14:00:00,81,227,12,11,512,393,119,14
4359,2022-07-01 15:00:00,83,208,7,13,582,461,121,5
4360,2022-07-01 16:00:00,107,225,6,10,697,501,196,7
4361,2022-07-01 17:00:00,107,112,8,17,740,616,124,12
4362,2022-07-01 18:00:00,114,114,13,10,769,604,165,6
4363,2022-07-01 19:00:00,65,228,13,11,656,482,174,9
4364,2022-07-01 20:00:00,85,265,5,10,520,385,135,13
4365,2022-07-01 21:00:00,89,208,9,13,742,548,194,5
4366,2022-07-01 22:00:00,95,162,14,16,559,414,145,12
4367,2022-07-01 23:00:00,138,147,5,12,674,558,116,5
4368,2022-07-02 00:00:00,140,267,9,11,567,404,163,6
4369,2022-07-02 01:00:00,103,231,10,15,511,422,89,14
4370,2022-07-02 02:00:00,87,275,5,14,583,497,86,5
4371,2022-07-02 03:00:00,62,192,11,15,709,501,208,11
4372,2022-07-02 04:00:00,55,200,14,12,648,577,71,5
4373,2022-07-02 05:00:00,145,220,12,18,587,424,163,10
4374,2022-07-02 06:00:00,64,240,8,13,556,421,135,6
4375,2022-07-02 07:00:00,53,155,7,13,607,445,162,13
4376,2022-07-02 08:00:00,126,118,9,18,679,574,105,8
4377,2022-07-02 09:00:00,64,184,9,13,654,576,78,13
4378,2022-07-02 10:00:00,97,220,6,13,568,432,136,13
4379,2022-07-02 11:00:00,52,249,7,14,703,624,79,13
4380,2022-07-02 12:00:00,129,236,7,16,665,494,171,13
4381,2022-07-02 13:00:00,121,179,10,17,738,570,168,6
4382,2022-07-02 14:00:00,57,275,8,12,541,482,59,13
4383,2022-07-02 15:00:00,124,244,9,17,749,636,113,12
4384,2022-07-02 16:00:00,103,269,12,13,591,486,105,6
4385,2022-07-02 17:00:00,90,126,7,14,791,628,163,5
4386,2022-07-02 18:00:00,128,262,7,13,623,488,135,8
4387,2022-07-02 19:00:00,135,224,13,11,533,418,115,14
4388,2022-07-02 20:00:00,71,286,11,15,590,507,83,8
4389,2022-07-02 21:00:00,139,183,13,11,630,531,99,9
4390,2022-07-02 22:00:00,54,247,12,15,549,441,108,8
4391,2022-07-02 23:00:00,86,266,8,17,706,591,115,11
4392,2022-07-03 00:00:00,61,218,7,16,642,561,81,13
4393,2022-07-03 01:00:00,104,161,8,12,756,624,132,8
4394,2022-07-03 02:00:00,77,199,5,12,778,638,140,8
4395,2022-07-03 03:00:00,79,263,5,16,720,595,125,9
4396,2022-07-03 04:00:00,56,164,11,12,679,522,157,9
4397,2022-07-03 05:00:00,140,111,9,10,540,431,109,11
4398,2022-07-03 06:00:00,98,262,14,15,676,474,202,9
4399,2022-07-03 07:00:00,134,273,10,19,560,421,139,9
4400,2022-07-03 08:00:00,105,215,7,13,735,564,171,5
4401,2022-07-03 09:00:00,78,224,10,14,665,556,109,5
4402,2022-07-03 10:00:00,123,174,5,11,534,467,67,13
4403,2022-07-03 11:00:00,62,133,8,14,524,421,103,12
4404,2022-07-03 12:00:00,92,288,10,17,776,577,199,6
4405,2022-07-03 13:00:00,62,170,14,13,754,539,215,8
4406,2022-07-03 14:00:00,143,103,14,15,562,412,150,14
4407,2022-07-03 15:00:00,140,271,9,18,631,548,83,13
4408,2022-07-03 16:00:00,60,148,7,11,758,629,129,7
4409,2022-07-03 17:00:00,52,264,11,15,543,441,102,5
4410,2022-07-03 18:00:00,64,166,11,18,767,638,129,9
4411,2022-07-03 19:00:00,100,184,11,17,677,494,183,13
4412,2022-07-03 20:00:00,109,280,9,14,646,510,136,14
4413,2022-07-03 21:00:00,123,246,8,16,625,462,163,7
4414,2022-07-03 22:00:00,130,170,14,14,648,495,153,5
4415,2022-07-03 23:00:00,87,220,6,16,773,664,109,12
4416,2022-07-04 00:00:00,126,287,8,13,528,390,138,11
4417,2022-07-04 01:00:00,60,195,10,15,569,503,66,5
4418,2022-07-04 02:00:00,125,211,14,13,742,572,170,9
4419,2022-07-04 03:00:00,87,279,8,12,690,596,94,6
4420,2022-07-04 04:00:00,128,145,9,16,587,464,123,7
4421,2022-07-04 05:00:00,87,144,12,13,509,440,69,13
4422,2022-07-04 06:00:00,118,138,14,19,790,605,185,13
4423,2022-07-04 07:00:00,136,263,8,15,723,592,131,5
4424,2022-07-04 08:00:00,94,293,5,13,684,604,80,12
4425,2022-07-04 09:00:00,103,299,8,16,507,363,144,14
4426,2022-07-04 10:00:00,95,248,8,13,744,523,221,11
4427,2022-07-04 11:00:00,56,166,9,12,589,421,168,10
4428,2022-07-04 12:00:00,117,193,12,14,741,663,78,9
4429,2022-07-04 13:00:00,127,249,11,11,759,618,141,8
4430,2022-07-04 14:00:00,116,150,8,12,607,452,155,9
4431,2022-07-04 15:00:00,62,282,7,16,790,556,234,12
4432,2022-07-04 16:00:00,70,181,6,19,531,390,141,9
4433,2022-07-04 17:00:00,61,231,7,16,624,505,119,12
4434,2022-07-04 18:00:00,125,100,13,12,797,668,129,9
4435,2022-07-04 19:00:00,95,132,11,18,721,507,214,5
4436,2022-07-04 20:00:00,50,246,8,11,677,555,122,13
4437,2022-07-04 21:00:00,100,142,6,17,726,525,201,11
4438,2022-07-04 22:00:00,50,134,7,11,703,586,117,5
4439,2022-07-04 23:00:00,123,242,12,19,547,453,94,13
4440,2022-07-05 00:00:00,110,111,9,11,696,578,118,11
4441,2022-07-05 01:00:00,106,146,5,12,733,642,91,7
4442,2022-07-05 02:00:00,94,243,7,17,663,520,143,9
4443,2022-07-05 03:00:00,74,123,9,15,700,570,130,10
4444,2022-07-05 04:00:00,123,125,8,13,767,676,91,8
4445,2022-07-05 05:00:00,70,162,12,13,739,639,100,9
4446,2022-07-05 06:00:00,87,172,13,10,578,477,101,12
4447,2022-07-05 07:00:00,79,282,6,14,619,531,88,6
4448,2022-07-05 08:00:00,83,286,14,13,580,422,158,10
4449,2022-07-05 09:00:00,102,157,12,10,577,416,161,11
4450,2022-07-05 10:00:00,126,167,9,19,781,669,112,10
4451,2022-07-05 11:00:00,97,127,10,19,606,511,95,13
4452,2022-07-05 12:00:00,139,232,12,15,633,540,93,9
4453,2022-07-05 13:00:00,121,244,10,17,652,553,99,14
4454,2022-07-05 14:00:00,61,176,9,10,569,443,126,10
4455,2022-07-05 15:00:00,106,129,11,14,796,637,159,14
4456,2022-07-05 16:00:00,125,121,11,14,734,596,138,14
4457,2022-07-05 17:00:00,58,169,12,18,533,439,94,9
4458,2022-07-05 18:00:00,105,196,6,13,527,449,78,9
4459,2022-07-05 19:00:00,127,135,8,17,672,599,73,13
4460,2022-07-05 20:00:00,94,168,10,19,726,600,126,12
4461,2022-07-05 21:00:00,111,191,5,16,700,629,71,11
4462,2022-07-05 22:00:00,75,131,9,19,654,523,131,8
4463,2022-07-05 23:00:00,116,170,14,14,566,482,84,8
4464,2022-07-06 00:00:00,99,193,8,13,602,490,112,14
4465,2022-07-06 01:00:00,57,298,10,19,782,554,228,10
4466,2022-07-06 02:00:00,143,271,10,12,600,430,170,5
4467,2022-07-06 03:00:00,62,270,13,18,653,475,178,9
4468,2022-07-06 04:00:00,107,270,9,13,546,461,85,14
4469,2022-07-06 05:00:00,110,185,9,11,636,474,162,14
4470,2022-07-06 06:00:00,85,182,11,10,617,487,130,14
4471,2022-07-06 07:00:00,119,258,11,13,712,550,162,13
4472,2022-07-06 08:00:00,53,226,11,14,601,428,173,14
4473,2022-07-06 09:00:00,97,185,5,18,725,649,76,7
4474,2022-07-06 10:00:00,128,280,9,10,630,477,153,12
4475,2022-07-06 11:00:00,53,251,12,11,697,524,173,7
4476,2022-07-06 12:00:00,55,149,10,18,702,503,199,5
4477,2022-07-06 13:00:00,88,152,9,12,750,637,113,11
4478,2022-07-06 14:00:00,149,218,6,14,799,566,233,9
4479,2022-07-06 15:00:00,108,213,8,10,758,676,82,8
4480,2022-07-06 16:00:00,96,186,9,12,791,648,143,6
4481,2022-07-06 17:00:00,89,252,12,15,724,595,129,11
4482,2022-07-06 18:00:00,122,194,11,15,641,521,120,14
4483,2022-07-06 19:00:00,84,247,14,11,554,435,119,9
4484,2022-07-06 20:00:00,102,251,5,14,751,644,107,10
4485,2022-07-06 21:00:00,109,254,12,13,582,485,97,7
4486,2022-07-06 22:00:00,144,182,6,12,771,670,101,13
4487,2022-07-06 23:00:00,69,199,10,13,606,530,76,6
4488,2022-07-07 00:00:00,141,274,10,19,711,613,98,13
4489,2022-07-07 01:00:00,102,206,6,15,631,562,69,11
4490,2022-07-07 02:00:00,117,163,14,19,509,365,144,7
4491,2022-07-07 03:00:00,106,208,5,10,776,664,112,6
4492,2022-07-07 04:00:00,63,272,5,11,783,628,155,12
4493,2022-07-07 05:00:00,136,177,6,19,717,573,144,8
4494,2022-07-07 06:00:00,54,164,7,14,763,538,225,11
4495,2022-07-07 07:00:00,112,140,8,10,535,396,139,8
4496,2022-07-07 08:00:00,91,289,8,18,555,398,157,8
4497,2022-07-07 09:00:00,102,192,9,18,621,531,90,10
4498,2022-07-07 10:00:00,133,262,13,10,535,386,149,13
4499,2022-07-07 11:00:00,133,276,9,19,781,615,166,11
4500,2022-07-07 12:00:00,105,235,10,18,522,419,103,7
4501,2022-07-07 13:00:00,58,252,5,10,530,427,103,14
4502,2022-07-07 14:00:00,58,158,6,15,532,467,65,6
4503,2022-07-07 15:00:00,138,166,11,14,671,503,168,5
4504,2022-07-07 16:00:00,122,231,6,12,544,427,117,14
4505,2022-07-07 17:00:00,62,293,6,14,685,559,126,11
4506,2022-07-07 18:00:00,138,194,12,17,626,490,136,11
4507,2022-07-07 19:00:00,57,123,12,10,647,581,66,5
4508,2022-07-07 20:00:00,81,181,8,16,745,660,85,6
4509,2022-07-07 21:00:00,79,187,14,11,709,594,115,6
4510,2022-07-07 22:00:00,58,216,7,17,649,510,139,11
4511,2022-07-07 23:00:00,82,182,5,11,780,652,128,5
4512,2022-07-08 00:00:00,64,109,14,15,686,495,191,12
4513,2022-07-08 01:00:00,142,190,14,17,767,613,154,7
4514,2022-07-08 02:00:00,114,181,12,18,759,651,108,12
4515,2022-07-08 03:00:00,142,277,8,11,740,531,209,14
4516,2022-07-08 04:00:00,66,162,9,11,543,485,58,9
4517,2022-07-08 05:00:00,124,249,12,17,576,490,86,14
4518,2022-07-08 06:00:00,108,137,8,13,591,446,145,10
4519,2022-07-08 07:00:00,126,253,14,19,769,581,188,14
4520,2022-07-08 08:00:00,127,189,12,17,726,533,193,7
4521,2022-07-08 09:00:00,121,148,5,19,722,605,117,6
4522,2022-07-08 10:00:00,64,149,11,16,792,689,103,10
4523,2022-07-08 11:00:00,120,177,14,16,779,583,196,13
4524,2022-07-08 12:00:00,94,283,6,10,751,608,143,13
4525,2022-07-08 13:00:00,144,217,7,14,623,513,110,9
4526,2022-07-08 14:00:00,67,290,10,11,553,406,147,12
4527,2022-07-08 15:00:00,50,259,9,11,684,498,186,10
4528,2022-07-08 16:00:00,63,100,11,12,697,539,158,9
4529,2022-07-08 17:00:00,72,230,12,18,618,468,150,13
4530,2022-07-08 18:00:00,142,281,8,17,700,574,126,5
4531,2022-07-08 19:00:00,98,162,9,11,671,603,68,11
4532,2022-07-08 20:00:00,100,213,5,10,737,614,123,12
4533,2022-07-08 21:00:00,62,281,6,19,733,601,132,12
4534,2022-07-08 22:00:00,68,247,13,16,515,445,70,12
4535,2022-07-08 23:00:00,110,110,9,19,591,530,61,13
4536,2022-07-09 00:00:00,126,285,10,10,645,506,139,6
4537,2022-07-09 01:00:00,60,221,6,12,626,559,67,7
4538,2022-07-09 02:00:00,67,214,11,18,716,600,116,7
4539,2022-07-09 03:00:00,78,138,9,11,764,624,140,8
4540,2022-07-09 04:00:00,112,156,9,15,726,544,182,12
4541,2022-07-09 05:00:00,111,113,6,10,776,645,131,11
4542,2022-07-09 06:00:00,67,136,10,15,702,622,80,6
4543,2022-07-09 07:00:00,59,108,10,19,777,567,210,12
4544,2022-07-09 08:00:00,128,124,8,18,515,450,65,13
4545,2022-07-09 09:00:00,142,136,11,17,747,632,115,7
4546,2022-07-09 10:00:00,73,241,5,16,618,442,176,9
4547,2022-07-09 11:00:00,90,128,6,11,548,410,138,12
4548,2022-07-09 12:00:00,121,185,5,16,695,605,90,12
4549,2022-07-09 13:00:00,61,202,8,10,709,554,155,14
4550,2022-07-09 14:00:00,78,128,9,10,722,527,195,11
4551,2022-07-09 15:00:00,148,229,5,13,668,503,165,5
4552,2022-07-09 16:00:00,130,104,11,17,669,508,161,5
4553,2022-07-09 17:00:00,61,202,13,12,756,544,212,12
4554,2022-07-09 18:00:00,88,171,9,11,628,557,71,6
4555,2022-07-09 19:00:00,106,186,10,11,531,393,138,6
4556,2022-07-09 20:00:00,74,208,5,13,755,641,114,13
4557,2022-07-09 21:00:00,138,168,9,11,685,569,116,13
4558,2022-07-09 22:00:00,118,147,12,15,696,577,119,10
4559,2022-07-09 23:00:00,136,173,6,13,579,472,107,10
4560,2022-07-10 00:00:00,89,162,8,18,626,448,178,8
4561,2022-07-10 01:00:00,129,241,13,19,760,623,137,9
4562,2022-07-10 02:00:00,85,243,10,12,729,586,143,14
4563,2022-07-10 03:00:00,142,166,12,12,712,638,74,9
4564,2022-07-10 04:00:00,103,267,5,16,659,586,73,12
4565,2022-07-10 05:00:00,140,133,14,15,548,485,63,10
4566,2022-07-10 06:00:00,81,248,14,15,620,487,133,9
4567,2022-07-10 07:00:00,91,115,8,14,547,439,108,13
4568,2022-07-10 08:00:00,54,231,14,16,602,534,68,13
4569,2022-07-10 09:00:00,147,130,10,14,760,620,140,5
4570,2022-07-10 10:00:00,134,257,7,13,610,513,97,9
4571,2022-07-10 11:00:00,106,217,11,17,723,541,182,14
4572,2022-07-10 12:00:00,82,221,9,17,795,582,213,7
4573,2022-07-10 13:00:00,85,239,9,17,539,437,102,13
4574,2022-07-10 14:00:00,102,287,8,14,630,561,69,8
4575,2022-07-10 15:00:00,146,260,9,10,679,601,78,6
4576,2022-07-10 16:00:00,87,210,9,15,777,587,190,14
4577,2022-07-10 17:00:00,96,267,5,18,566,423,143,9
4578,2022-07-10 18:00:00,70,138,8,13,555,426,129,9
4579,2022-07-10 19:00:00,125,136,7,17,787,668,119,9
4580,2022-07-10 20:00:00,88,225,9,11,690,598,92,13
4581,2022-07-10 21:00:00,100,115,11,15,751,658,93,7
4582,2022-07-10 22:00:00,128,127,9,18,712,515,197,10
4583,2022-07-10 23:00:00,140,203,5,19,758,613,145,6
4584,2022-07-11 00:00:00,102,298,5,19,650,569,81,11
4585,2022-07-11 01:00:00,63,133,10,15,598,504,94,8
4586,2022-07-11 02:00:00,104,287,9,10,647,484,163,14
4587,2022-07-11 03:00:00,85,255,11,18,502,380,122,9
4588,2022-07-11 04:00:00,58,285,12,12,501,417,84,10
4589,2022-07-11 05:00:00,143,266,12,11,566,453,113,12
4590,2022-07-11 06:00:00,111,299,11,16,631,560,71,11
4591,2022-07-11 07:00:00,69,177,5,13,746,616,130,13
4592,2022-07-11 08:00:00,142,191,13,13,669,500,169,12
4593,2022-07-11 09:00:00,134,176,7,16,654,563,91,10
4594,2022-07-11 10:00:00,68,238,6,17,619,555,64,7
4595,2022-07-11 11:00:00,59,208,12,17,597,460,137,12
4596,2022-07-11 12:00:00,126,199,10,14,706,634,72,13
4597,2022-07-11 13:00:00,83,279,6,17,662,554,108,10
4598,2022-07-11 14:00:00,86,189,14,13,731,612,119,8
4599,2022-07-11 15:00:00,132,134,14,17,576,481,95,12
4600,2022-07-11 16:00:00,137,296,8,17,549,404,145,8
4601,2022-07-11 17:00:00,131,299,13,11,757,620,137,11
4602,2022-07-11 18:00:00,133,261,6,15,518,409,109,12
4603,2022-07-11 19:00:00,111,168,5,14,546,396,150,10
4604,2022-07-11 20:00:00,98,194,8,12,539,454,85,9
4605,2022-07-11 21:00:00,81,223,13,15,669,516,153,12
4606,2022-07-11 22:00:00,120,233,13,19,624,498,126,10
4607,2022-07-11 23:00:00,104,119,12,15,588,424,164,14
4608,2022-07-12 00:00:00,103,145,9,18,761,609,152,12
4609,2022-07-12 01:00:00,104,160,5,11,614,502,112,6
4610,2022-07-12 02:00:00,109,230,7,19,739,648,91,10
4611,2022-07-12 03:00:00,66,108,9,13,618,452,166,11
4612,2022-07-12 04:00:00,58,228,13,12,615,434,181,13
4613,2022-07-12 05:00:00,75,147,11,12,566,429,137,11
4614,2022-07-12 06:00:00,82,267,13,13,610,498,112,12
4615,2022-07-12 07:00:00,91,137,10,14,506,358,148,11
4616,2022-07-12 08:00:00,67,162,8,16,677,601,76,10
4617,2022-07-12 09:00:00,126,228,5,14,659,562,97,8
4618,2022-07-12 10:00:00,142,185,14,17,673,510,163,10
4619,2022-07-12 11:00:00,61,197,14,18,699,516,183,12
4620,2022-07-12 12:00:00,121,236,12,16,742,586,156,14
4621,2022-07-12 13:00:00,65,146,8,10,651,481,170,7
4622,2022-07-12 14:00:00,139,114,8,13,772,642,130,10
4623,2022-07-12 15:00:00,93,184,10,19,626,541,85,9
4624,2022-07-12 16:00:00,64,104,12,11,742,636,106,9
4625,2022-07-12 17:00:00,89,179,8,11,695,543,152,11
4626,2022-07-12 18:00:00,60,160,9,13,642,545,97,5
4627,2022-07-12 19:00:00,51,267,6,19,780,597,183,11
4628,2022-07-12 20:00:00,110,159,6,16,696,506,190,10
4629,2022-07-12 21:00:00,99,134,7,11,589,447,142,11
4630,2022-07-12 22:00:00,123,253,7,14,629,469,160,6
4631,2022-07-12 23:00:00,124,243,6,13,761,674,87,10
4632,2022-07-13 00:00:00,133,191,5,17,621,499,122,7
4633,2022-07-13 01:00:00,61,143,8,10,531,402,129,11
4634,2022-07-13 02:00:00,129,195,14,12,673,556,117,14
4635,2022-07-13 03:00:00,99,150,14,12,635,545,90,5
4636,2022-07-13 04:00:00,68,222,5,16,514,407,107,12
4637,2022-07-13 05:00:00,100,142,14,14,557,460,97,5
4638,2022-07-13 06:00:00,133,128,8,19,695,524,171,5
4639,2022-07-13 07:00:00,123,271,5,19,610,465,145,9
4640,2022-07-13 08:00:00,63,232,13,19,564,467,97,10
4641,2022-07-13 09:00:00,147,194,9,19,776,581,195,5
4642,2022-07-13 10:00:00,57,214,13,13,707,555,152,7
4643,2022-07-13 11:00:00,54,135,9,16,681,582,99,6
4644,2022-07-13 12:00:00,108,221,12,17,770,637,133,14
4645,2022-07-13 13:00:00,56,131,13,12,670,560,110,5
4646,2022-07-13 14:00:00,127,252,6,10,777,654,123,6
4647,2022-07-13 15:00:00,133,157,14,13,702,496,206,11
4648,2022-07-13 16:00:00,115,107,12,13,533,414,119,8
4649,2022-07-13 17:00:00,80,297,6,13,754,581,173,6
4650,2022-07-13 18:00:00,104,167,9,15,679,561,118,13
4651,2022-07-13 19:00:00,144,258,13,11,515,401,114,5
4652,2022-07-13 20:00:00,100,158,12,13,635,483,152,11
4653,2022-07-13 21:00:00,142,146,9,10,501,355,146,9
4654,2022-07-13 22:00:00,130,152,14,10,580,454,126,11
4655,2022-07-13 23:00:00,121,270,11,10,504,407,97,10
4656,2022-07-14 00:00:00,63,275,8,12,523,392,131,10
4657,2022-07-14 01:00:00,121,240,7,13,717,528,189,14
4658,2022-07-14 02:00:00,91,133,8,11,775,665,110,12
4659,2022-07-14 03:00:00,95,229,6,17,548,469,79,5
4660,2022-07-14 04:00:00,54,276,14,18,519,407,112,6
4661,2022-07-14 05:00:00,149,185,14,13,650,532,118,6
4662,2022-07-14 06:00:00,111,211,11,19,673,555,118,14
4663,2022-07-14 07:00:00,96,150,14,10,772,589,183,8
4664,2022-07-14 08:00:00,65,120,8,12,693,540,153,10
4665,2022-07-14 09:00:00,134,295,13,15,606,524,82,5
4666,2022-07-14 10:00:00,59,286,5,15,786,585,201,5
4667,2022-07-14 11:00:00,105,194,7,14,780,554,226,10
4668,2022-07-14 12:00:00,67,289,11,16,515,462,53,13
4669,2022-07-14 13:00:00,88,290,11,17,595,464,131,14
4670,2022-07-14 14:00:00,82,213,9,16,598,475,123,12
4671,2022-07-14 15:00:00,142,115,11,13,558,473,85,8
4672,2022-07-14 16:00:00,50,287,5,19,787,594,193,10
4673,2022-07-14 17:00:00,145,205,12,16,629,482,147,13
4674,2022-07-14 18:00:00,105,244,13,10,506,431,75,13
4675,2022-07-14 19:00:00,106,260,7,10,781,621,160,8
4676,2022-07-14 20:00:00,92,271,11,13,781,692,89,8
4677,2022-07-14 21:00:00,50,223,10,10,748,667,81,6
4678,2022-07-14 22:00:00,142,101,12,10,597,452,145,5
4679,2022-07-14 23:00:00,81,227,14,10,661,488,173,11
4680,2022-07-15 00:00:00,136,150,7,14,574,493,81,6
4681,2022-07-15 01:00:00,82,166,8,19,565,500,65,5
4682,2022-07-15 02:00:00,123,275,14,15,674,594,80,8
4683,2022-07-15 03:00:00,66,204,7,10,739,586,153,13
4684,2022-07-15 04:00:00,127,243,11,14,649,577,72,7
4685,2022-07-15 05:00:00,86,169,8,11,671,490,181,7
4686,2022-07-15 06:00:00,99,250,5,19,790,698,92,12
4687,2022-07-15 07:00:00,80,125,13,12,675,543,132,9
4688,2022-07-15 08:00:00,103,160,9,14,517,378,139,14
4689,2022-07-15 09:00:00,59,114,6,19,593,420,173,14
4690,2022-07-15 10:00:00,140,150,14,12,612,463,149,7
4691,2022-07-15 11:00:00,120,134,9,10,550,463,87,5
4692,2022-07-15 12:00:00,52,247,6,13,664,548,116,11
4693,2022-07-15 13:00:00,73,295,13,10,764,608,156,13
4694,2022-07-15 14:00:00,77,138,11,19,616,549,67,13
4695,2022-07-15 15:00:00,143,231,6,14,683,606,77,11
4696,2022-07-15 16:00:00,99,239,6,15,632,448,184,9
4697,2022-07-15 17:00:00,93,292,13,16,700,544,156,13
4698,2022-07-15 18:00:00,50,182,8,13,774,651,123,12
4699,2022-07-15 19:00:00,51,167,5,18,599,537,62,6
4700,2022-07-15 20:00:00,106,277,6,13,722,619,103,10
4701,2022-07-15 21:00:00,136,242,12,17,772,656,116,6
4702,2022-07-15 22:00:00,146,272,14,19,526,424,102,9
4703,2022-07-15 23:00:00,110,198,8,11,768,542,226,5
4704,2022-07-16 00:00:00,99,272,6,13,697,553,144,5
4705,2022-07-16 01:00:00,114,234,13,18,612,454,158,14
4706,2022-07-16 02:00:00,115,114,8,13,698,497,201,7
4707,2022-07-16 03:00:00,132,258,14,19,504,368,136,13
4708,2022-07-16 04:00:00,133,245,13,11,778,668,110,12
4709,2022-07-16 05:00:00,56,188,6,11,529,438,91,10
4710,2022-07-16 06:00:00,130,228,11,10,773,690,83,13
4711,2022-07-16 07:00:00,73,128,8,10,790,650,140,14
4712,2022-07-16 08:00:00,68,224,10,11,697,527,170,12
4713,2022-07-16 09:00:00,125,252,5,12,632,478,154,6
4714,2022-07-16 10:00:00,115,118,9,12,650,504,146,12
4715,2022-07-16 11:00:00,54,214,6,12,795,620,175,13
4716,2022-07-16 12:00:00,75,166,10,10,644,455,189,6
4717,2022-07-16 13:00:00,90,193,13,15,601,438,163,14
4718,2022-07-16 14:00:00,126,206,11,13,561,474,87,10
4719,2022-07-16 15:00:00,142,139,12,11,646,536,110,9
4720,2022-07-16 16:00:00,75,243,5,15,571,471,100,8
4721,2022-07-16 17:00:00,72,175,6,12,738,593,145,5
4722,2022-07-16 18:00:00,105,234,14,12,736,624,112,13
4723,2022-07-16 19:00:00,134,200,6,11,685,576,109,5
4724,2022-07-16 20:00:00,99,249,6,17,713,560,153,11
4725,2022-07-16 21:00:00,74,107,13,14,566,449,117,10
4726,2022-07-16 22:00:00,78,250,9,10,519,413,106,9
4727,2022-07-16 23:00:00,93,128,9,19,543,433,110,5
4728,2022-07-17 00:00:00,95,258,10,11,563,497,66,5
4729,2022-07-17 01:00:00,131,190,11,15,592,442,150,12
4730,2022-07-17 02:00:00,123,117,11,10,673,527,146,14
4731,2022-07-17 03:00:00,59,252,11,16,778,631,147,7
4732,2022-07-17 04:00:00,104,250,14,16,708,628,80,8
4733,2022-07-17 05:00:00,92,172,8,15,668,553,115,5
4734,2022-07-17 06:00:00,127,174,13,12,641,481,160,14
4735,2022-07-17 07:00:00,110,177,11,16,632,552,80,9
4736,2022-07-17 08:00:00,77,214,10,10,688,485,203,11
4737,2022-07-17 09:00:00,143,266,11,15,563,505,58,9
4738,2022-07-17 10:00:00,83,166,12,12,653,526,127,11
4739,2022-07-17 11:00:00,75,134,14,11,771,652,119,8
4740,2022-07-17 12:00:00,53,219,8,14,795,619,176,6
4741,2022-07-17 13:00:00,101,101,14,11,526,423,103,5
4742,2022-07-17 14:00:00,57,292,12,12,543,450,93,13
4743,2022-07-17 15:00:00,143,150,8,10,565,480,85,6
4744,2022-07-17 16:00:00,149,264,9,15,680,529,151,10
4745,2022-07-17 17:00:00,100,290,13,17,631,511,120,14
4746,2022-07-17 18:00:00,110,184,6,12,709,588,121,10
4747,2022-07-17 19:00:00,56,106,6,14,589,529,60,5
4748,2022-07-17 20:00:00,97,191,12,19,502,394,108,9
4749,2022-07-17 21:00:00,124,257,10,15,751,584,167,8
4750,2022-07-17 22:00:00,122,119,12,16,653,468,185,9
4751,2022-07-17 23:00:00,59,110,13,17,527,411,116,8
4752,2022-07-18 00:00:00,65,177,6,18,528,418,110,9
4753,2022-07-18 01:00:00,108,222,14,16,788,560,228,12
4754,2022-07-18 02:00:00,130,103,13,18,572,417,155,9
4755,2022-07-18 03:00:00,51,167,9,19,663,495,168,7
4756,2022-07-18 04:00:00,113,152,13,12,586,517,69,11
4757,2022-07-18 05:00:00,102,297,7,13,690,542,148,8
4758,2022-07-18 06:00:00,143,235,11,14,593,480,113,7
4759,2022-07-18 07:00:00,105,218,12,17,720,524,196,14
4760,2022-07-18 08:00:00,134,139,5,19,763,535,228,12
4761,2022-07-18 09:00:00,89,199,6,15,777,545,232,5
4762,2022-07-18 10:00:00,72,197,13,11,630,447,183,6
4763,2022-07-18 11:00:00,144,138,6,18,694,569,125,14
4764,2022-07-18 12:00:00,113,190,12,17,763,652,111,14
4765,2022-07-18 13:00:00,88,222,11,17,694,570,124,8
4766,2022-07-18 14:00:00,147,231,7,19,725,606,119,9
4767,2022-07-18 15:00:00,90,239,11,12,642,543,99,8
4768,2022-07-18 16:00:00,54,159,7,10,703,563,140,11
4769,2022-07-18 17:00:00,62,254,5,10,744,587,157,13
4770,2022-07-18 18:00:00,53,260,14,18,775,688,87,7
4771,2022-07-18 19:00:00,125,173,5,10,671,486,185,12
4772,2022-07-18 20:00:00,72,255,5,11,733,518,215,10
4773,2022-07-18 21:00:00,137,169,14,13,521,419,102,13
4774,2022-07-18 22:00:00,94,185,8,10,742,610,132,6
4775,2022-07-18 23:00:00,84,234,11,12,506,408,98,12
4776,2022-07-19 00:00:00,132,250,10,18,663,568,95,14
4777,2022-07-19 01:00:00,69,145,14,17,648,512,136,8
4778,2022-07-19 02:00:00,82,135,8,13,574,425,149,7
4779,2022-07-19 03:00:00,137,161,6,17,707,557,150,7
4780,2022-07-19 04:00:00,137,260,10,11,608,427,181,9
4781,2022-07-19 05:00:00,82,125,14,12,512,454,58,10
4782,2022-07-19 06:00:00,110,174,14,16,746,665,81,13
4783,2022-07-19 07:00:00,65,270,10,13,692,496,196,13
4784,2022-07-19 08:00:00,91,116,10,13,680,506,174,13
4785,2022-07-19 09:00:00,69,131,12,10,706,555,151,11
4786,2022-07-19 10:00:00,104,176,5,18,517,373,144,7
4787,2022-07-19 11:00:00,82,262,14,14,774,674,100,13
4788,2022-07-19 12:00:00,132,147,14,15,782,632,150,13
4789,2022-07-19 13:00:00,66,261,10,19,731,513,218,13
4790,2022-07-19 14:00:00,123,108,7,12,672,591,81,10
4791,2022-07-19 15:00:00,143,210,10,15,709,514,195,5
4792,2022-07-19 16:00:00,60,154,13,16,527,443,84,12
4793,2022-07-19 17:00:00,58,280,13,13,535,391,144,14
4794,2022-07-19 18:00:00,95,186,8,14,679,572,107,11
4795,2022-07-19 19:00:00,110,286,9,13,607,489,118,7
4796,2022-07-19 20:00:00,90,280,12,12,794,691,103,6
4797,2022-07-19 21:00:00,90,219,10,11,537,448,89,13
4798,2022-07-19 22:00:00,61,175,6,15,540,392,148,13
4799,2022-07-19 23:00:00,104,180,6,19,723,527,196,7
4800,2022-07-20 00:00:00,99,255,13,11,671,486,185,8
4801,2022-07-20 01:00:00,137,163,10,19,560,452,108,10
4802,2022-07-20 02:00:00,52,143,8,11,548,437,111,13
4803,2022-07-20 03:00:00,133,174,9,17,688,511,177,7
4804,2022-07-20 04:00:00,74,154,6,19,765,657,108,13
4805,2022-07-20 05:00:00,79,175,8,17,721,637,84,8
4806,2022-07-20 06:00:00,50,181,6,18,699,540,159,13
4807,2022-07-20 07:00:00,64,181,9,18,718,538,180,7
4808,2022-07-20 08:00:00,66,166,5,15,541,465,76,9
4809,2022-07-20 09:00:00,55,216,12,17,775,684,91,9
4810,2022-07-20 10:00:00,64,217,11,14,783,566,217,11
4811,2022-07-20 11:00:00,102,223,7,16,710,556,154,9
4812,2022-07-20 12:00:00,122,299,13,16,590,507,83,6
4813,2022-07-20 13:00:00,123,159,6,13,609,527,82,13
4814,2022-07-20 14:00:00,83,286,7,18,669,490,179,12
4815,2022-07-20 15:00:00,112,264,13,18,631,483,148,13
4816,2022-07-20 16:00:00,137,106,9,17,786,651,135,13
4817,2022-07-20 17:00:00,105,172,7,11,539,426,113,12
4818,2022-07-20 18:00:00,119,137,5,12,776,680,96,13
4819,2022-07-20 19:00:00,137,151,12,19,763,544,219,8
4820,2022-07-20 20:00:00,125,231,9,19,785,640,145,8
4821,2022-07-20 21:00:00,117,237,8,13,791,695,96,6
4822,2022-07-20 22:00:00,70,157,9,17,620,489,131,9
4823,2022-07-20 23:00:00,73,237,13,16,633,485,148,9
4824,2022-07-21 00:00:00,132,114,5,10,765,633,132,13
4825,2022-07-21 01:00:00,74,224,5,13,600,489,111,13
4826,2022-07-21 02:00:00,95,106,10,15,795,559,236,12
4827,2022-07-21 03:00:00,149,149,8,14,558,452,106,7
4828,2022-07-21 04:00:00,100,273,5,15,593,510,83,14
4829,2022-07-21 05:00:00,143,179,11,12,572,455,117,12
4830,2022-07-21 06:00:00,143,290,9,12,730,526,204,9
4831,2022-07-21 07:00:00,108,131,10,11,678,526,152,8
4832,2022-07-21 08:00:00,94,223,14,17,588,450,138,9
4833,2022-07-21 09:00:00,76,135,9,11,715,512,203,14
4834,2022-07-21 10:00:00,135,234,7,12,632,453,179,6
4835,2022-07-21 11:00:00,118,137,12,14,723,531,192,7
4836,2022-07-21 12:00:00,140,237,8,11,707,597,110,9
4837,2022-07-21 13:00:00,114,221,5,14,582,491,91,13
4838,2022-07-21 14:00:00,84,112,14,13,519,433,86,12
4839,2022-07-21 15:00:00,146,238,7,11,602,506,96,10
4840,2022-07-21 16:00:00,107,161,6,10,618,543,75,9
4841,2022-07-21 17:00:00,96,217,10,12,756,667,89,7
4842,2022-07-21 18:00:00,70,223,9,12,524,436,88,13
4843,2022-07-21 19:00:00,56,189,7,14,731,550,181,7
4844,2022-07-21 20:00:00,118,186,14,19,580,454,126,14
4845,2022-07-21 21:00:00,122,143,7,19,790,629,161,5
4846,2022-07-21 22:00:00,56,153,14,13,648,538,110,11
4847,2022-07-21 23:00:00,90,172,14,19,522,430,92,11
4848,2022-07-22 00:00:00,65,218,7,14,667,474,193,14
4849,2022-07-22 01:00:00,85,240,6,18,543,470,73,6
4850,2022-07-22 02:00:00,73,183,11,11,536,477,59,12
4851,2022-07-22 03:00:00,61,157,9,12,562,474,88,13
4852,2022-07-22 04:00:00,79,184,11,12,505,402,103,11
4853,2022-07-22 05:00:00,111,200,7,19,673,484,189,13
4854,2022-07-22 06:00:00,128,172,10,10,691,616,75,11
4855,2022-07-22 07:00:00,62,283,13,15,610,484,126,8
4856,2022-07-22 08:00:00,135,232,11,10,752,547,205,10
4857,2022-07-22 09:00:00,125,280,9,14,770,671,99,12
4858,2022-07-22 10:00:00,77,242,14,17,774,585,189,5
4859,2022-07-22 11:00:00,119,298,13,11,599,524,75,6
4860,2022-07-22 12:00:00,114,232,13,11,799,583,216,7
4861,2022-07-22 13:00:00,81,107,10,10,537,476,61,6
4862,2022-07-22 14:00:00,143,182,14,19,687,574,113,11
4863,2022-07-22 15:00:00,58,175,5,17,667,477,190,5
4864,2022-07-22 16:00:00,93,167,9,19,762,685,77,8
4865,2022-07-22 17:00:00,55,212,13,18,521,414,107,12
4866,2022-07-22 18:00:00,149,179,9,12,755,672,83,12
4867,2022-07-22 19:00:00,78,246,10,13,625,489,136,13
4868,2022-07-22 20:00:00,55,175,7,14,541,400,141,11
4869,2022-07-22 21:00:00,141,260,10,10,773,612,161,6
4870,2022-07-22 22:00:00,130,179,11,10,687,506,181,14
4871,2022-07-22 23:00:00,128,263,5,19,638,479,159,14
4872,2022-07-23 00:00:00,84,123,9,11,728,539,189,14
4873,2022-07-23 01:00:00,61,198,7,18,543,414,129,12
4874,2022-07-23 02:00:00,83,228,11,19,592,435,157,5
4875,2022-07-23 03:00:00,61,287,12,17,791,649,142,7
4876,2022-07-23 04:00:00,116,293,9,10,722,642,80,14
4877,2022-07-23 05:00:00,61,294,6,12,591,416,175,13
4878,2022-07-23 06:00:00,59,191,12,16,742,638,104,13
4879,2022-07-23 07:00:00,88,218,9,17,622,460,162,9
4880,2022-07-23 08:00:00,53,140,12,10,509,411,98,14
4881,2022-07-23 09:00:00,130,277,6,10,782,682,100,8
4882,2022-07-23 10:00:00,137,143,13,14,642,558,84,13
4883,2022-07-23 11:00:00,77,227,6,17,686,565,121,10
4884,2022-07-23 12:00:00,95,221,10,14,528,448,80,6
4885,2022-07-23 13:00:00,127,213,6,10,540,386,154,14
4886,2022-07-23 14:00:00,91,280,10,10,596,460,136,7
4887,2022-07-23 15:00:00,85,236,10,16,628,558,70,14
4888,2022-07-23 16:00:00,145,227,14,18,728,614,114,7
4889,2022-07-23 17:00:00,75,139,8,19,676,558,118,14
4890,2022-07-23 18:00:00,57,146,5,15,787,567,220,7
4891,2022-07-23 19:00:00,90,255,8,18,623,464,159,8
4892,2022-07-23 20:00:00,130,238,5,13,539,432,107,13
4893,2022-07-23 21:00:00,66,299,11,14,616,513,103,14
4894,2022-07-23 22:00:00,133,203,13,16,767,660,107,12
4895,2022-07-23 23:00:00,95,237,9,17,745,571,174,6
4896,2022-07-24 00:00:00,80,286,8,13,739,583,156,13
4897,2022-07-24 01:00:00,59,112,6,11,574,450,124,10
4898,2022-07-24 02:00:00,133,224,11,14,675,474,201,11
4899,2022-07-24 03:00:00,131,131,13,12,713,532,181,11
4900,2022-07-24 04:00:00,128,107,9,15,586,512,74,10
4901,2022-07-24 05:00:00,97,215,14,13,630,489,141,7
4902,2022-07-24 06:00:00,134,201,9,16,640,567,73,10
4903,2022-07-24 07:00:00,104,165,9,17,600,485,115,10
4904,2022-07-24 08:00:00,122,280,9,14,640,487,153,12
4905,2022-07-24 09:00:00,125,225,7,19,726,625,101,7
4906,2022-07-24 10:00:00,99,139,9,12,760,588,172,12
4907,2022-07-24 11:00:00,122,258,14,17,739,648,91,7
4908,2022-07-24 12:00:00,136,158,8,16,722,603,119,7
4909,2022-07-24 13:00:00,141,181,13,17,586,444,142,9
4910,2022-07-24 14:00:00,122,289,10,12,697,535,162,13
4911,2022-07-24 15:00:00,106,298,7,15,772,599,173,7
4912,2022-07-24 16:00:00,124,200,13,12,699,602,97,8
4913,2022-07-24 17:00:00,140,193,10,14,677,555,122,14
4914,2022-07-24 18:00:00,117,141,12,14,666,497,169,5
4915,2022-07-24 19:00:00,119,268,13,11,623,547,76,9
4916,2022-07-24 20:00:00,138,201,12,14,526,440,86,10
4917,2022-07-24 21:00:00,141,213,11,15,549,397,152,8
4918,2022-07-24 22:00:00,126,236,12,19,540,437,103,8
4919,2022-07-24 23:00:00,129,269,12,19,674,519,155,10
4920,2022-07-25 00:00:00,67,175,9,17,569,480,89,5
4921,2022-07-25 01:00:00,109,143,8,16,566,437,129,5
4922,2022-07-25 02:00:00,105,162,12,18,500,393,107,9
4923,2022-07-25 03:00:00,111,118,7,19,649,517,132,5
4924,2022-07-25 04:00:00,74,275,7,17,672,496,176,8
4925,2022-07-25 05:00:00,134,195,14,17,568,419,149,14
4926,2022-07-25 06:00:00,71,291,10,16,656,520,136,14
4927,2022-07-25 07:00:00,87,221,8,10,765,657,108,8
4928,2022-07-25 08:00:00,115,109,13,12,501,440,61,10
4929,2022-07-25 09:00:00,50,248,6,12,606,455,151,8
4930,2022-07-25 10:00:00,70,243,11,17,518,453,65,10
4931,2022-07-25 11:00:00,136,244,11,18,599,439,160,6
4932,2022-07-25 12:00:00,85,297,6,16,615,493,122,7
4933,2022-07-25 13:00:00,140,297,6,19,729,620,109,11
4934,2022-07-25 14:00:00,89,100,8,15,789,636,153,12
4935,2022-07-25 15:00:00,108,214,7,17,648,514,134,10
4936,2022-07-25 16:00:00,106,253,13,18,569,432,137,12
4937,2022-07-25 17:00:00,95,195,10,11,639,486,153,11
4938,2022-07-25 18:00:00,114,179,10,19,558,397,161,13
4939,2022-07-25 19:00:00,93,196,5,13,595,482,113,5
4940,2022-07-25 20:00:00,89,197,10,11,751,642,109,10
4941,2022-07-25 21:00:00,149,104,8,18,566,488,78,9
4942,2022-07-25 22:00:00,75,200,7,14,639,488,151,13
4943,2022-07-25 23:00:00,117,138,14,11,742,565,177,6
4944,2022-07-26 00:00:00,124,286,8,18,593,505,88,12
4945,2022-07-26 01:00:00,113,193,13,18,775,669,106,7
4946,2022-07-26 02:00:00,65,189,13,17,750,562,188,5
4947,2022-07-26 03:00:00,130,298,14,14,718,604,114,9
4948,2022-07-26 04:00:00,145,166,6,13,711,572,139,6
4949,2022-07-26 05:00:00,101,199,6,12,593,420,173,6
4950,2022-07-26 06:00:00,80,259,14,11,790,647,143,10
4951,2022-07-26 07:00:00,86,275,11,15,562,477,85,13
4952,2022-07-26 08:00:00,61,119,12,19,561,446,115,14
4953,2022-07-26 09:00:00,121,260,10,10,539,446,93,14
4954,2022-07-26 10:00:00,56,137,8,17,793,607,186,9
4955,2022-07-26 11:00:00,142,109,5,13,532,410,122,8
4956,2022-07-26 12:00:00,94,291,11,12,534,409,125,7
4957,2022-07-26 13:00:00,108,155,11,19,797,663,134,10
4958,2022-07-26 14:00:00,83,173,5,10,697,509,188,7
4959,2022-07-26 15:00:00,106,207,6,13,671,594,77,12
4960,2022-07-26 16:00:00,104,114,14,18,573,457,116,5
4961,2022-07-26 17:00:00,67,173,12,14,548,400,148,14
4962,2022-07-26 18:00:00,107,200,7,11,572,442,130,10
4963,2022-07-26 19:00:00,61,118,13,16,796,676,120,8
4964,2022-07-26 20:00:00,130,117,14,15,609,450,159,11
4965,2022-07-26 21:00:00,78,285,10,17,680,523,157,5
4966,2022-07-26 22:00:00,90,131,12,13,590,425,165,11
4967,2022-07-26 23:00:00,120,290,12,11,663,551,112,13
4968,2022-07-27 00:00:00,108,269,9,18,558,426,132,9
4969,2022-07-27 01:00:00,90,144,9,11,674,499,175,5
4970,2022-07-27 02:00:00,64,132,5,19,641,538,103,12
4971,2022-07-27 03:00:00,138,178,5,12,547,410,137,14
4972,2022-07-27 04:00:00,94,135,13,15,680,592,88,14
4973,2022-07-27 05:00:00,89,217,6,13,590,530,60,6
4974,2022-07-27 06:00:00,82,258,7,18,681,482,199,5
4975,2022-07-27 07:00:00,53,290,14,13,764,559,205,7
4976,2022-07-27 08:00:00,125,268,14,16,700,595,105,9
4977,2022-07-27 09:00:00,101,240,7,13,706,623,83,7
4978,2022-07-27 10:00:00,59,234,11,17,516,367,149,12
4979,2022-07-27 11:00:00,125,263,10,10,665,538,127,12
4980,2022-07-27 12:00:00,148,172,10,12,765,543,222,7
4981,2022-07-27 13:00:00,123,226,13,14,653,461,192,14
4982,2022-07-27 14:00:00,142,177,7,19,682,525,157,7
4983,2022-07-27 15:00:00,98,111,10,17,643,551,92,8
4984,2022-07-27 16:00:00,70,271,10,10,778,548,230,9
4985,2022-07-27 17:00:00,118,276,5,11,721,554,167,5
4986,2022-07-27 18:00:00,59,138,14,13,554,472,82,9
4987,2022-07-27 19:00:00,110,170,5,13,548,450,98,12
4988,2022-07-27 20:00:00,84,192,10,12,606,495,111,6
4989,2022-07-27 21:00:00,87,217,9,16,558,435,123,6
4990,2022-07-27 22:00:00,51,181,9,11,591,507,84,8
4991,2022-07-27 23:00:00,92,190,7,10,716,638,78,10
4992,2022-07-28 00:00:00,93,146,14,14,671,489,182,9
4993,2022-07-28 01:00:00,138,209,7,17,725,586,139,5
4994,2022-07-28 02:00:00,80,124,11,13,532,380,152,7
4995,2022-07-28 03:00:00,53,250,9,11,745,643,102,12
4996,2022-07-28 04:00:00,67,190,11,16,518,399,119,14
4997,2022-07-28 05:00:00,141,212,12,10,623,550,73,11
4998,2022-07-28 06:00:00,94,186,13,10,727,563,164,6
4999,2022-07-28 07:00:00,113,202,11,11,535,450,85,13
5000,2022-07-28 08:00:00,50,142,7,16,576,479,97,6
5001,2022-07-28 09:00:00,89,156,7,14,624,445,179,13
5002,2022-07-28 10:00:00,107,125,5,15,789,557,232,5
5003,2022-07-28 11:00:00,128,249,5,16,651,493,158,13
5004,2022-07-28 12:00:00,113,297,13,16,573,404,169,9
5005,2022-07-28 13:00:00,76,134,6,14,640,532,108,13
5006,2022-07-28 14:00:00,103,215,11,18,738,622,116,6
5007,2022-07-28 15:00:00,104,163,8,15,695,618,77,8
5008,2022-07-28 16:00:00,91,163,6,19,697,537,160,6
5009,2022-07-28 17:00:00,74,264,12,18,623,448,175,6
5010,2022-07-28 18:00:00,115,266,9,12,546,460,86,10
5011,2022-07-28 19:00:00,149,283,9,10,651,460,191,12
5012,2022-07-28 20:00:00,103,111,8,12,573,474,99,7
5013,2022-07-28 21:00:00,79,262,14,12,643,569,74,11
5014,2022-07-28 22:00:00,147,153,11,14,730,598,132,11
5015,2022-07-28 23:00:00,113,118,8,16,511,404,107,10
5016,2022-07-29 00:00:00,148,143,13,13,779,570,209,6
5017,2022-07-29 01:00:00,62,290,8,16,590,496,94,7
5018,2022-07-29 02:00:00,79,258,8,15,651,498,153,9
5019,2022-07-29 03:00:00,97,147,11,19,507,413,94,11
5020,2022-07-29 04:00:00,143,205,5,14,753,644,109,12
5021,2022-07-29 05:00:00,84,206,7,10,707,510,197,8
5022,2022-07-29 06:00:00,135,204,10,15,612,488,124,14
5023,2022-07-29 07:00:00,111,135,8,14,791,569,222,11
5024,2022-07-29 08:00:00,69,202,5,10,688,487,201,14
5025,2022-07-29 09:00:00,114,108,13,10,695,522,173,10
5026,2022-07-29 10:00:00,79,157,7,16,640,548,92,14
5027,2022-07-29 11:00:00,140,263,9,12,506,397,109,11
5028,2022-07-29 12:00:00,115,155,14,13,541,402,139,12
5029,2022-07-29 13:00:00,135,126,12,16,559,461,98,14
5030,2022-07-29 14:00:00,137,258,5,17,660,500,160,9
5031,2022-07-29 15:00:00,71,142,11,17,627,549,78,14
5032,2022-07-29 16:00:00,129,222,13,16,560,455,105,8
5033,2022-07-29 17:00:00,114,276,9,12,523,395,128,12
5034,2022-07-29 18:00:00,95,238,12,16,644,455,189,7
5035,2022-07-29 19:00:00,131,299,9,16,503,428,75,8
5036,2022-07-29 20:00:00,97,185,14,14,598,526,72,8
5037,2022-07-29 21:00:00,110,136,6,12,599,468,131,7
5038,2022-07-29 22:00:00,139,160,7,16,610,488,122,9
5039,2022-07-29 23:00:00,109,172,11,14,601,442,159,10
5040,2022-07-30 00:00:00,89,254,9,12,518,450,68,10
5041,2022-07-30 01:00:00,143,200,8,10,508,453,55,5
5042,2022-07-30 02:00:00,63,104,9,17,749,616,133,8
5043,2022-07-30 03:00:00,78,279,9,14,769,614,155,9
5044,2022-07-30 04:00:00,88,232,8,18,577,480,97,11
5045,2022-07-30 05:00:00,83,236,8,15,620,472,148,6
5046,2022-07-30 06:00:00,111,210,10,18,670,570,100,12
5047,2022-07-30 07:00:00,86,153,10,13,517,412,105,10
5048,2022-07-30 08:00:00,78,144,5,15,658,501,157,7
5049,2022-07-30 09:00:00,140,105,12,19,763,583,180,13
5050,2022-07-30 10:00:00,89,279,11,16,632,487,145,9
5051,2022-07-30 11:00:00,82,250,13,19,621,533,88,5
5052,2022-07-30 12:00:00,64,285,7,18,782,586,196,8
5053,2022-07-30 13:00:00,110,247,6,11,603,472,131,6
5054,2022-07-30 14:00:00,112,150,5,14,546,414,132,12
5055,2022-07-30 15:00:00,140,132,13,13,505,358,147,14
5056,2022-07-30 16:00:00,77,194,7,16,774,581,193,12
5057,2022-07-30 17:00:00,77,167,10,11,606,431,175,10
5058,2022-07-30 18:00:00,125,135,10,11,536,412,124,12
5059,2022-07-30 19:00:00,51,164,7,12,696,604,92,7
5060,2022-07-30 20:00:00,57,142,7,18,550,448,102,6
5061,2022-07-30 21:00:00,91,239,13,19,755,623,132,14
5062,2022-07-30 22:00:00,140,291,6,16,536,415,121,12
5063,2022-07-30 23:00:00,77,167,10,11,605,507,98,5
5064,2022-07-31 00:00:00,73,160,5,12,524,442,82,9
5065,2022-07-31 01:00:00,74,136,10,15,745,648,97,13
5066,2022-07-31 02:00:00,108,104,10,19,598,476,122,10
5067,2022-07-31 03:00:00,114,236,14,12,685,612,73,12
5068,2022-07-31 04:00:00,109,281,11,16,718,527,191,10
5069,2022-07-31 05:00:00,124,207,11,15,649,583,66,8
5070,2022-07-31 06:00:00,67,210,14,13,628,510,118,6
5071,2022-07-31 07:00:00,94,227,13,17,721,506,215,8
5072,2022-07-31 08:00:00,110,159,9,11,519,407,112,12
5073,2022-07-31 09:00:00,125,175,7,14,651,458,193,8
5074,2022-07-31 10:00:00,102,118,9,11,761,536,225,11
5075,2022-07-31 11:00:00,70,209,7,19,602,467,135,9
5076,2022-07-31 12:00:00,108,120,13,11,774,687,87,11
5077,2022-07-31 13:00:00,108,166,5,18,712,513,199,14
5078,2022-07-31 14:00:00,132,231,9,16,567,475,92,10
5079,2022-07-31 15:00:00,51,178,11,13,755,557,198,7
5080,2022-07-31 16:00:00,122,227,14,12,534,416,118,11
5081,2022-07-31 17:00:00,62,164,10,14,786,594,192,9
5082,2022-07-31 18:00:00,142,176,7,11,509,368,141,6
5083,2022-07-31 19:00:00,85,237,8,17,513,445,68,6
5084,2022-07-31 20:00:00,54,212,11,18,755,617,138,5
5085,2022-07-31 21:00:00,141,195,13,18,550,472,78,8
5086,2022-07-31 22:00:00,88,288,9,16,616,551,65,7
5087,2022-07-31 23:00:00,82,260,10,15,715,624,91,5
5088,2022-08-01 00:00:00,115,208,9,16,552,419,133,7
5089,2022-08-01 01:00:00,67,185,14,15,776,629,147,11
5090,2022-08-01 02:00:00,68,254,11,11,609,428,181,6
5091,2022-08-01 03:00:00,60,186,12,13,614,484,130,10
5092,2022-08-01 04:00:00,115,268,12,19,763,568,195,7
5093,2022-08-01 05:00:00,84,231,9,18,639,507,132,6
5094,2022-08-01 06:00:00,71,154,6,13,674,577,97,6
5095,2022-08-01 07:00:00,75,128,13,18,689,605,84,5
5096,2022-08-01 08:00:00,89,198,6,17,675,595,80,14
5097,2022-08-01 09:00:00,115,275,9,14,710,534,176,9
5098,2022-08-01 10:00:00,98,204,10,12,675,581,94,5
5099,2022-08-01 11:00:00,112,177,7,14,696,590,106,11
5100,2022-08-01 12:00:00,121,219,8,16,552,429,123,8
5101,2022-08-01 13:00:00,108,276,6,15,506,368,138,10
5102,2022-08-01 14:00:00,83,182,11,13,635,465,170,8
5103,2022-08-01 15:00:00,104,206,12,19,785,612,173,10
5104,2022-08-01 16:00:00,65,236,8,15,791,561,230,11
5105,2022-08-01 17:00:00,66,150,13,16,734,532,202,11
5106,2022-08-01 18:00:00,123,231,7,13,579,491,88,5
5107,2022-08-01 19:00:00,130,185,14,12,704,575,129,13
5108,2022-08-01 20:00:00,142,248,12,15,642,547,95,11
5109,2022-08-01 21:00:00,86,117,11,14,529,376,153,9
5110,2022-08-01 22:00:00,76,101,7,17,640,519,121,10
5111,2022-08-01 23:00:00,92,177,11,12,618,448,170,11
5112,2022-08-02 00:00:00,93,155,5,19,561,498,63,9
5113,2022-08-02 01:00:00,109,264,10,14,522,419,103,14
5114,2022-08-02 02:00:00,125,214,9,12,789,668,121,7
5115,2022-08-02 03:00:00,59,108,13,16,582,460,122,6
5116,2022-08-02 04:00:00,131,281,7,11,611,465,146,6
5117,2022-08-02 05:00:00,131,118,8,18,507,452,55,6
5118,2022-08-02 06:00:00,130,243,9,17,538,465,73,12
5119,2022-08-02 07:00:00,138,257,12,15,794,634,160,10
5120,2022-08-02 08:00:00,101,254,7,14,732,514,218,12
5121,2022-08-02 09:00:00,57,250,14,11,587,492,95,5
5122,2022-08-02 10:00:00,130,157,9,18,538,415,123,10
5123,2022-08-02 11:00:00,81,198,11,16,696,501,195,11
5124,2022-08-02 12:00:00,54,116,14,15,660,576,84,13
5125,2022-08-02 13:00:00,147,183,8,18,768,628,140,8
5126,2022-08-02 14:00:00,116,142,11,10,503,378,125,14
5127,2022-08-02 15:00:00,101,144,5,13,755,665,90,14
5128,2022-08-02 16:00:00,131,112,7,18,743,547,196,5
5129,2022-08-02 17:00:00,149,211,8,11,504,437,67,9
5130,2022-08-02 18:00:00,134,170,6,17,559,440,119,7
5131,2022-08-02 19:00:00,124,177,9,15,663,465,198,9
5132,2022-08-02 20:00:00,145,219,10,18,556,449,107,13
5133,2022-08-02 21:00:00,91,225,5,18,645,514,131,5
5134,2022-08-02 22:00:00,103,264,12,19,511,417,94,14
5135,2022-08-02 23:00:00,80,281,11,16,609,507,102,12
5136,2022-08-03 00:00:00,149,181,12,15,745,659,86,7
5137,2022-08-03 01:00:00,75,283,8,18,667,577,90,8
5138,2022-08-03 02:00:00,127,121,7,12,678,557,121,6
5139,2022-08-03 03:00:00,148,254,11,16,601,479,122,7
5140,2022-08-03 04:00:00,98,184,8,12,764,565,199,12
5141,2022-08-03 05:00:00,101,260,5,13,546,457,89,14
5142,2022-08-03 06:00:00,51,148,9,18,709,511,198,10
5143,2022-08-03 07:00:00,84,214,12,18,738,597,141,5
5144,2022-08-03 08:00:00,96,132,6,17,528,442,86,9
5145,2022-08-03 09:00:00,91,257,5,11,699,501,198,14
5146,2022-08-03 10:00:00,123,219,10,12,664,471,193,6
5147,2022-08-03 11:00:00,59,293,14,10,732,569,163,5
5148,2022-08-03 12:00:00,88,118,7,15,746,540,206,9
5149,2022-08-03 13:00:00,58,112,8,12,770,544,226,6
5150,2022-08-03 14:00:00,83,155,5,18,539,387,152,14
5151,2022-08-03 15:00:00,53,271,14,10,603,516,87,6
5152,2022-08-03 16:00:00,106,295,10,11,784,551,233,11
5153,2022-08-03 17:00:00,92,269,11,18,596,463,133,5
5154,2022-08-03 18:00:00,90,192,13,16,723,515,208,11
5155,2022-08-03 19:00:00,126,226,8,12,549,407,142,7
5156,2022-08-03 20:00:00,70,109,8,19,573,497,76,8
5157,2022-08-03 21:00:00,61,251,14,17,771,678,93,8
5158,2022-08-03 22:00:00,82,148,9,10,541,481,60,6
5159,2022-08-03 23:00:00,141,156,13,14,576,455,121,7
5160,2022-08-04 00:00:00,105,224,11,18,784,703,81,10
5161,2022-08-04 01:00:00,76,253,12,12,615,485,130,14
5162,2022-08-04 02:00:00,103,187,14,13,590,523,67,7
5163,2022-08-04 03:00:00,131,283,9,13,640,504,136,6
5164,2022-08-04 04:00:00,89,106,6,16,511,431,80,9
5165,2022-08-04 05:00:00,86,235,10,14,692,532,160,9
5166,2022-08-04 06:00:00,61,284,12,19,536,380,156,8
5167,2022-08-04 07:00:00,93,140,5,18,676,522,154,13
5168,2022-08-04 08:00:00,65,168,9,11,639,467,172,8
5169,2022-08-04 09:00:00,131,187,7,10,506,413,93,12
5170,2022-08-04 10:00:00,74,265,8,11,635,452,183,13
5171,2022-08-04 11:00:00,130,105,14,12,622,524,98,14
5172,2022-08-04 12:00:00,64,255,7,18,794,567,227,14
5173,2022-08-04 13:00:00,58,194,5,14,790,572,218,9
5174,2022-08-04 14:00:00,135,264,9,18,761,615,146,10
5175,2022-08-04 15:00:00,130,264,5,12,723,563,160,10
5176,2022-08-04 16:00:00,123,130,12,14,514,370,144,7
5177,2022-08-04 17:00:00,117,139,13,12,695,511,184,8
5178,2022-08-04 18:00:00,125,101,9,12,766,559,207,11
5179,2022-08-04 19:00:00,89,217,12,12,758,629,129,14
5180,2022-08-04 20:00:00,92,139,11,18,682,557,125,9
5181,2022-08-04 21:00:00,53,210,10,19,576,457,119,12
5182,2022-08-04 22:00:00,67,105,12,15,636,518,118,8
5183,2022-08-04 23:00:00,104,269,9,11,626,559,67,6
5184,2022-08-05 00:00:00,145,187,7,13,633,460,173,12
5185,2022-08-05 01:00:00,117,276,10,19,773,689,84,9
5186,2022-08-05 02:00:00,64,175,13,17,601,450,151,6
5187,2022-08-05 03:00:00,69,266,7,15,543,416,127,6
5188,2022-08-05 04:00:00,139,126,9,12,673,555,118,8
5189,2022-08-05 05:00:00,80,168,12,11,767,590,177,11
5190,2022-08-05 06:00:00,55,164,14,12,534,421,113,6
5191,2022-08-05 07:00:00,118,249,7,17,502,431,71,12
5192,2022-08-05 08:00:00,96,194,9,18,530,450,80,9
5193,2022-08-05 09:00:00,148,222,10,18,609,470,139,13
5194,2022-08-05 10:00:00,55,278,14,18,707,525,182,5
5195,2022-08-05 11:00:00,99,292,10,16,620,471,149,8
5196,2022-08-05 12:00:00,100,249,9,17,720,628,92,14
5197,2022-08-05 13:00:00,138,289,6,13,529,461,68,12
5198,2022-08-05 14:00:00,143,262,13,14,533,388,145,7
5199,2022-08-05 15:00:00,81,208,14,10,765,596,169,13
5200,2022-08-05 16:00:00,59,296,12,16,621,510,111,8
5201,2022-08-05 17:00:00,54,233,12,17,617,490,127,12
5202,2022-08-05 18:00:00,126,100,14,14,694,505,189,6
5203,2022-08-05 19:00:00,120,243,8,18,524,380,144,9
5204,2022-08-05 20:00:00,147,178,5,12,651,498,153,8
5205,2022-08-05 21:00:00,139,201,10,12,577,459,118,9
5206,2022-08-05 22:00:00,59,101,10,11,532,445,87,13
5207,2022-08-05 23:00:00,64,227,9,17,579,438,141,12
5208,2022-08-06 00:00:00,121,175,5,17,540,465,75,11
5209,2022-08-06 01:00:00,66,280,13,19,533,434,99,6
5210,2022-08-06 02:00:00,149,257,7,14,596,504,92,5
5211,2022-08-06 03:00:00,121,298,13,16,568,403,165,7
5212,2022-08-06 04:00:00,95,265,8,18,772,661,111,12
5213,2022-08-06 05:00:00,56,128,13,16,777,599,178,14
5214,2022-08-06 06:00:00,90,248,12,18,536,474,62,8
5215,2022-08-06 07:00:00,146,222,7,10,514,414,100,11
5216,2022-08-06 08:00:00,125,161,12,15,602,495,107,9
5217,2022-08-06 09:00:00,141,283,10,13,562,500,62,13
5218,2022-08-06 10:00:00,125,116,13,13,682,553,129,13
5219,2022-08-06 11:00:00,63,230,5,12,646,521,125,12
5220,2022-08-06 12:00:00,95,104,9,18,763,566,197,14
5221,2022-08-06 13:00:00,50,266,11,15,717,522,195,14
5222,2022-08-06 14:00:00,147,297,14,17,625,465,160,13
5223,2022-08-06 15:00:00,102,238,10,10,650,510,140,14
5224,2022-08-06 16:00:00,138,246,9,15,724,627,97,10
5225,2022-08-06 17:00:00,148,157,5,17,627,556,71,7
5226,2022-08-06 18:00:00,147,133,10,10,636,454,182,6
5227,2022-08-06 19:00:00,68,123,5,13,650,512,138,13
5228,2022-08-06 20:00:00,142,106,5,17,787,592,195,7
5229,2022-08-06 21:00:00,107,112,8,17,739,654,85,10
5230,2022-08-06 22:00:00,55,298,13,11,686,604,82,14
5231,2022-08-06 23:00:00,94,252,10,10,751,651,100,12
5232,2022-08-07 00:00:00,120,242,13,15,636,487,149,5
5233,2022-08-07 01:00:00,102,113,10,18,670,582,88,9
5234,2022-08-07 02:00:00,53,211,8,15,718,551,167,12
5235,2022-08-07 03:00:00,81,175,9,11,777,581,196,9
5236,2022-08-07 04:00:00,94,189,6,15,650,537,113,6
5237,2022-08-07 05:00:00,127,287,13,17,695,543,152,14
5238,2022-08-07 06:00:00,130,122,11,10,540,445,95,10
5239,2022-08-07 07:00:00,61,200,9,11,646,524,122,8
5240,2022-08-07 08:00:00,129,226,9,17,733,535,198,5
5241,2022-08-07 09:00:00,92,227,9,14,783,678,105,14
5242,2022-08-07 10:00:00,108,146,14,15,501,428,73,12
5243,2022-08-07 11:00:00,83,252,12,14,764,616,148,10
5244,2022-08-07 12:00:00,77,272,9,18,680,607,73,12
5245,2022-08-07 13:00:00,149,276,5,18,652,567,85,5
5246,2022-08-07 14:00:00,124,219,10,13,623,485,138,11
5247,2022-08-07 15:00:00,91,153,7,17,652,477,175,6
5248,2022-08-07 16:00:00,110,256,12,14,769,583,186,11
5249,2022-08-07 17:00:00,97,136,11,11,603,525,78,9
5250,2022-08-07 18:00:00,119,250,9,17,558,471,87,9
5251,2022-08-07 19:00:00,124,101,11,17,625,451,174,6
5252,2022-08-07 20:00:00,102,227,14,16,627,559,68,11
5253,2022-08-07 21:00:00,72,234,10,16,557,441,116,9
5254,2022-08-07 22:00:00,93,147,11,12,533,397,136,8
5255,2022-08-07 23:00:00,124,248,14,18,646,483,163,7
5256,2022-08-08 00:00:00,128,256,10,19,693,607,86,7
5257,2022-08-08 01:00:00,143,288,8,12,745,621,124,9
5258,2022-08-08 02:00:00,106,177,9,12,570,434,136,6
5259,2022-08-08 03:00:00,133,298,12,16,547,424,123,6
5260,2022-08-08 04:00:00,124,100,7,15,559,466,93,9
5261,2022-08-08 05:00:00,102,282,14,13,710,515,195,14
5262,2022-08-08 06:00:00,141,277,8,13,670,488,182,5
5263,2022-08-08 07:00:00,129,285,10,13,608,480,128,11
5264,2022-08-08 08:00:00,74,186,7,19,760,535,225,6
5265,2022-08-08 09:00:00,89,263,14,14,601,481,120,11
5266,2022-08-08 10:00:00,92,219,10,14,767,676,91,14
5267,2022-08-08 11:00:00,59,255,9,12,692,487,205,13
5268,2022-08-08 12:00:00,129,289,9,19,766,685,81,10
5269,2022-08-08 13:00:00,135,201,7,11,713,588,125,7
5270,2022-08-08 14:00:00,76,140,13,15,680,565,115,8
5271,2022-08-08 15:00:00,90,214,10,14,548,444,104,7
5272,2022-08-08 16:00:00,123,143,9,13,693,539,154,11
5273,2022-08-08 17:00:00,53,128,11,18,783,549,234,10
5274,2022-08-08 18:00:00,122,163,14,14,733,626,107,10
5275,2022-08-08 19:00:00,125,138,10,15,693,526,167,6
5276,2022-08-08 20:00:00,62,219,14,16,671,515,156,9
5277,2022-08-08 21:00:00,98,218,8,18,637,518,119,13
5278,2022-08-08 22:00:00,113,213,7,11,712,547,165,12
5279,2022-08-08 23:00:00,148,134,9,16,760,543,217,10
5280,2022-08-09 00:00:00,84,169,13,10,610,526,84,14
5281,2022-08-09 01:00:00,144,169,6,10,772,569,203,12
5282,2022-08-09 02:00:00,127,294,10,10,598,491,107,11
5283,2022-08-09 03:00:00,113,171,11,16,604,479,125,14
5284,2022-08-09 04:00:00,127,196,9,11,758,586,172,11
5285,2022-08-09 05:00:00,124,164,8,11,613,469,144,11
5286,2022-08-09 06:00:00,104,282,12,14,535,381,154,7
5287,2022-08-09 07:00:00,64,122,10,16,607,545,62,6
5288,2022-08-09 08:00:00,104,279,13,11,702,609,93,10
5289,2022-08-09 09:00:00,76,269,5,15,721,567,154,12
5290,2022-08-09 10:00:00,56,253,13,17,725,585,140,6
5291,2022-08-09 11:00:00,90,190,12,11,691,564,127,9
5292,2022-08-09 12:00:00,110,162,5,16,646,523,123,5
5293,2022-08-09 13:00:00,110,239,10,16,693,522,171,14
5294,2022-08-09 14:00:00,90,112,12,13,729,617,112,5
5295,2022-08-09 15:00:00,54,255,14,17,630,520,110,8
5296,2022-08-09 16:00:00,95,159,8,17,653,575,78,12
5297,2022-08-09 17:00:00,149,165,7,11,702,545,157,13
5298,2022-08-09 18:00:00,56,123,6,12,563,476,87,14
5299,2022-08-09 19:00:00,77,216,13,13,744,615,129,14
5300,2022-08-09 20:00:00,146,192,6,10,676,558,118,13
5301,2022-08-09 21:00:00,148,139,10,12,574,438,136,10
5302,2022-08-09 22:00:00,63,104,8,11,546,462,84,9
5303,2022-08-09 23:00:00,134,264,8,10,627,450,177,13
5304,2022-08-10 00:00:00,86,148,12,15,524,426,98,6
5305,2022-08-10 01:00:00,128,117,9,15,631,535,96,12
5306,2022-08-10 02:00:00,143,231,9,13,747,635,112,11
5307,2022-08-10 03:00:00,141,259,5,15,515,447,68,13
5308,2022-08-10 04:00:00,130,216,12,14,581,472,109,12
5309,2022-08-10 05:00:00,124,113,7,16,608,458,150,7
5310,2022-08-10 06:00:00,115,110,6,14,772,644,128,11
5311,2022-08-10 07:00:00,119,195,8,17,577,429,148,7
5312,2022-08-10 08:00:00,128,180,5,12,742,612,130,7
5313,2022-08-10 09:00:00,75,223,14,11,729,638,91,9
5314,2022-08-10 10:00:00,92,148,8,13,508,414,94,8
5315,2022-08-10 11:00:00,60,162,10,10,745,549,196,11
5316,2022-08-10 12:00:00,149,216,11,19,622,468,154,10
5317,2022-08-10 13:00:00,56,158,12,11,533,432,101,8
5318,2022-08-10 14:00:00,86,251,10,17,605,543,62,8
5319,2022-08-10 15:00:00,65,253,9,10,704,568,136,5
5320,2022-08-10 16:00:00,90,122,14,13,750,639,111,5
5321,2022-08-10 17:00:00,141,235,12,15,633,547,86,14
5322,2022-08-10 18:00:00,123,288,14,16,757,539,218,10
5323,2022-08-10 19:00:00,78,114,9,11,579,452,127,14
5324,2022-08-10 20:00:00,147,261,5,18,746,612,134,5
5325,2022-08-10 21:00:00,104,186,14,13,651,527,124,10
5326,2022-08-10 22:00:00,60,164,10,12,541,388,153,12
5327,2022-08-10 23:00:00,57,218,5,19,591,523,68,11
5328,2022-08-11 00:00:00,84,148,12,11,786,578,208,14
5329,2022-08-11 01:00:00,103,147,5,18,691,554,137,9
5330,2022-08-11 02:00:00,139,283,11,10,607,518,89,5
5331,2022-08-11 03:00:00,117,271,6,12,715,619,96,5
5332,2022-08-11 04:00:00,107,246,7,12,577,473,104,8
5333,2022-08-11 05:00:00,62,244,11,16,631,448,183,10
5334,2022-08-11 06:00:00,99,209,5,17,694,513,181,12
5335,2022-08-11 07:00:00,98,210,7,13,742,522,220,14
5336,2022-08-11 08:00:00,94,191,5,10,609,492,117,10
5337,2022-08-11 09:00:00,112,155,9,19,753,621,132,5
5338,2022-08-11 10:00:00,134,287,5,16,756,560,196,13
5339,2022-08-11 11:00:00,147,185,14,16,567,451,116,11
5340,2022-08-11 12:00:00,113,125,9,11,695,494,201,11
5341,2022-08-11 13:00:00,101,109,5,19,747,565,182,13
5342,2022-08-11 14:00:00,106,245,9,10,517,443,74,13
5343,2022-08-11 15:00:00,71,275,11,15,604,438,166,8
5344,2022-08-11 16:00:00,110,103,8,13,785,554,231,10
5345,2022-08-11 17:00:00,149,277,6,17,711,610,101,9
5346,2022-08-11 18:00:00,66,110,11,14,643,543,100,8
5347,2022-08-11 19:00:00,50,292,8,13,639,501,138,14
5348,2022-08-11 20:00:00,67,283,12,18,782,629,153,14
5349,2022-08-11 21:00:00,101,136,8,18,676,575,101,14
5350,2022-08-11 22:00:00,100,190,7,17,645,544,101,9
5351,2022-08-11 23:00:00,135,236,14,13,513,368,145,14
5352,2022-08-12 00:00:00,60,185,12,17,530,401,129,14
5353,2022-08-12 01:00:00,53,187,6,15,578,449,129,8
5354,2022-08-12 02:00:00,73,270,5,17,569,398,171,8
5355,2022-08-12 03:00:00,88,280,10,13,566,413,153,5
5356,2022-08-12 04:00:00,111,278,12,17,759,588,171,7
5357,2022-08-12 05:00:00,91,154,6,14,627,495,132,14
5358,2022-08-12 06:00:00,96,158,6,10,745,553,192,7
5359,2022-08-12 07:00:00,130,244,14,19,540,407,133,12
5360,2022-08-12 08:00:00,67,203,10,14,629,486,143,6
5361,2022-08-12 09:00:00,69,140,9,19,649,530,119,6
5362,2022-08-12 10:00:00,57,133,14,16,539,458,81,14
5363,2022-08-12 11:00:00,96,217,8,13,526,456,70,7
5364,2022-08-12 12:00:00,55,176,11,19,718,618,100,6
5365,2022-08-12 13:00:00,110,235,12,12,538,435,103,9
5366,2022-08-12 14:00:00,92,204,5,13,682,489,193,9
5367,2022-08-12 15:00:00,100,239,7,19,746,544,202,10
5368,2022-08-12 16:00:00,100,184,8,13,767,627,140,8
5369,2022-08-12 17:00:00,87,142,13,13,720,613,107,14
5370,2022-08-12 18:00:00,144,256,10,13,546,390,156,9
5371,2022-08-12 19:00:00,56,259,6,13,505,372,133,5
5372,2022-08-12 20:00:00,125,141,8,14,746,615,131,9
5373,2022-08-12 21:00:00,124,297,11,10,586,485,101,13
5374,2022-08-12 22:00:00,123,213,9,14,761,674,87,10
5375,2022-08-12 23:00:00,121,259,14,11,765,600,165,7
5376,2022-08-13 00:00:00,68,260,6,10,626,475,151,12
5377,2022-08-13 01:00:00,110,119,5,16,704,555,149,5
5378,2022-08-13 02:00:00,143,266,11,17,720,541,179,11
5379,2022-08-13 03:00:00,126,254,7,12,593,495,98,13
5380,2022-08-13 04:00:00,134,163,12,11,599,478,121,13
5381,2022-08-13 05:00:00,69,222,5,12,558,464,94,5
5382,2022-08-13 06:00:00,53,289,9,12,666,469,197,9
5383,2022-08-13 07:00:00,132,194,7,11,736,599,137,7
5384,2022-08-13 08:00:00,64,285,12,11,692,497,195,8
5385,2022-08-13 09:00:00,56,101,7,18,779,625,154,6
5386,2022-08-13 10:00:00,148,110,14,16,678,562,116,8
5387,2022-08-13 11:00:00,116,114,6,12,734,537,197,14
5388,2022-08-13 12:00:00,115,147,9,15,759,609,150,13
5389,2022-08-13 13:00:00,147,109,9,16,617,475,142,8
5390,2022-08-13 14:00:00,69,298,7,15,508,390,118,13
5391,2022-08-13 15:00:00,117,274,11,10,654,474,180,6
5392,2022-08-13 16:00:00,67,262,7,18,523,437,86,14
5393,2022-08-13 17:00:00,124,270,10,16,648,507,141,12
5394,2022-08-13 18:00:00,65,135,12,19,686,613,73,12
5395,2022-08-13 19:00:00,147,263,13,18,591,478,113,12
5396,2022-08-13 20:00:00,103,247,9,10,776,602,174,14
5397,2022-08-13 21:00:00,119,254,14,19,581,515,66,11
5398,2022-08-13 22:00:00,138,275,14,11,579,489,90,5
5399,2022-08-13 23:00:00,92,188,9,13,772,553,219,9
5400,2022-08-14 00:00:00,122,255,11,11,514,444,70,9
5401,2022-08-14 01:00:00,136,120,14,13,727,574,153,14
5402,2022-08-14 02:00:00,86,132,7,19,641,522,119,14
5403,2022-08-14 03:00:00,147,186,13,15,648,525,123,8
5404,2022-08-14 04:00:00,147,285,5,18,745,613,132,8
5405,2022-08-14 05:00:00,94,251,5,14,668,502,166,5
5406,2022-08-14 06:00:00,148,165,9,11,687,568,119,5
5407,2022-08-14 07:00:00,138,275,10,18,616,478,138,10
5408,2022-08-14 08:00:00,91,250,8,11,557,447,110,7
5409,2022-08-14 09:00:00,142,129,14,12,584,417,167,14
5410,2022-08-14 10:00:00,94,164,12,15,501,403,98,8
5411,2022-08-14 11:00:00,115,222,13,19,594,431,163,5
5412,2022-08-14 12:00:00,51,196,14,17,523,376,147,11
5413,2022-08-14 13:00:00,130,203,7,18,525,402,123,8
5414,2022-08-14 14:00:00,116,256,7,15,711,533,178,10
5415,2022-08-14 15:00:00,143,152,10,18,637,555,82,10
5416,2022-08-14 16:00:00,58,279,8,13,651,539,112,9
5417,2022-08-14 17:00:00,78,250,11,14,622,516,106,13
5418,2022-08-14 18:00:00,129,249,7,14,768,627,141,9
5419,2022-08-14 19:00:00,107,108,5,14,633,449,184,14
5420,2022-08-14 20:00:00,141,133,7,10,690,539,151,9
5421,2022-08-14 21:00:00,101,128,10,17,777,631,146,8
5422,2022-08-14 22:00:00,62,144,13,11,607,445,162,12
5423,2022-08-14 23:00:00,88,212,6,13,777,673,104,11
5424,2022-08-15 00:00:00,90,101,12,15,580,470,110,10
5425,2022-08-15 01:00:00,81,210,6,13,664,552,112,9
5426,2022-08-15 02:00:00,91,272,7,19,571,422,149,14
5427,2022-08-15 03:00:00,95,175,6,10,751,596,155,8
5428,2022-08-15 04:00:00,112,214,6,18,646,456,190,14
5429,2022-08-15 05:00:00,64,106,12,11,583,496,87,5
5430,2022-08-15 06:00:00,136,135,10,11,536,398,138,9
5431,2022-08-15 07:00:00,72,198,8,18,703,537,166,7
5432,2022-08-15 08:00:00,71,185,12,12,616,453,163,12
5433,2022-08-15 09:00:00,58,111,7,12,593,517,76,5
5434,2022-08-15 10:00:00,106,189,7,19,580,408,172,6
5435,2022-08-15 11:00:00,107,262,13,16,775,625,150,14
5436,2022-08-15 12:00:00,135,126,6,10,752,636,116,14
5437,2022-08-15 13:00:00,63,233,5,10,797,611,186,12
5438,2022-08-15 14:00:00,111,235,8,16,749,579,170,9
5439,2022-08-15 15:00:00,132,161,10,12,521,456,65,11
5440,2022-08-15 16:00:00,76,139,6,10,761,609,152,5
5441,2022-08-15 17:00:00,111,295,6,18,587,496,91,14
5442,2022-08-15 18:00:00,118,224,11,14,773,643,130,8
5443,2022-08-15 19:00:00,93,162,11,12,555,418,137,6
5444,2022-08-15 20:00:00,70,140,9,14,562,504,58,9
5445,2022-08-15 21:00:00,125,107,7,13,789,672,117,10
5446,2022-08-15 22:00:00,102,221,12,18,667,549,118,7
5447,2022-08-15 23:00:00,129,105,9,15,516,385,131,7
5448,2022-08-16 00:00:00,55,103,10,10,601,460,141,10
5449,2022-08-16 01:00:00,140,212,8,19,750,557,193,14
5450,2022-08-16 02:00:00,149,143,11,11,583,484,99,6
5451,2022-08-16 03:00:00,84,280,11,16,774,620,154,6
5452,2022-08-16 04:00:00,117,281,9,14,747,566,181,7
5453,2022-08-16 05:00:00,57,215,7,16,590,518,72,5
5454,2022-08-16 06:00:00,85,117,6,19,702,510,192,14
5455,2022-08-16 07:00:00,128,288,8,17,502,445,57,7
5456,2022-08-16 08:00:00,52,102,14,10,644,517,127,6
5457,2022-08-16 09:00:00,105,266,5,14,542,487,55,10
5458,2022-08-16 10:00:00,114,169,12,10,612,493,119,11
5459,2022-08-16 11:00:00,53,168,11,18,708,617,91,14
5460,2022-08-16 12:00:00,146,118,12,14,602,478,124,12
5461,2022-08-16 13:00:00,101,192,5,17,659,591,68,10
5462,2022-08-16 14:00:00,105,198,11,17,696,598,98,7
5463,2022-08-16 15:00:00,57,256,8,12,759,548,211,5
5464,2022-08-16 16:00:00,92,177,9,15,758,669,89,11
5465,2022-08-16 17:00:00,88,257,10,11,524,389,135,5
5466,2022-08-16 18:00:00,111,207,14,10,741,559,182,9
5467,2022-08-16 19:00:00,77,201,11,15,520,426,94,14
5468,2022-08-16 20:00:00,107,280,10,16,635,461,174,6
5469,2022-08-16 21:00:00,116,185,13,19,516,376,140,11
5470,2022-08-16 22:00:00,129,203,6,10,757,626,131,11
5471,2022-08-16 23:00:00,70,152,5,12,596,466,130,10
5472,2022-08-17 00:00:00,132,218,14,17,793,677,116,9
5473,2022-08-17 01:00:00,100,101,9,17,544,425,119,8
5474,2022-08-17 02:00:00,97,228,12,19,644,464,180,8
5475,2022-08-17 03:00:00,70,178,9,18,517,366,151,8
5476,2022-08-17 04:00:00,80,244,14,17,768,637,131,11
5477,2022-08-17 05:00:00,74,223,12,14,539,401,138,13
5478,2022-08-17 06:00:00,51,286,8,17,571,511,60,6
5479,2022-08-17 07:00:00,96,158,8,12,715,548,167,14
5480,2022-08-17 08:00:00,51,214,13,14,638,484,154,9
5481,2022-08-17 09:00:00,111,185,10,19,626,513,113,9
5482,2022-08-17 10:00:00,133,242,9,17,675,525,150,10
5483,2022-08-17 11:00:00,138,142,5,10,645,515,130,12
5484,2022-08-17 12:00:00,69,255,6,19,741,614,127,9
5485,2022-08-17 13:00:00,90,273,7,14,625,509,116,8
5486,2022-08-17 14:00:00,130,158,6,15,783,640,143,13
5487,2022-08-17 15:00:00,81,216,13,14,560,486,74,13
5488,2022-08-17 16:00:00,107,151,14,16,663,548,115,13
5489,2022-08-17 17:00:00,147,170,7,19,758,539,219,13
5490,2022-08-17 18:00:00,55,204,10,10,514,422,92,13
5491,2022-08-17 19:00:00,110,127,12,12,536,465,71,5
5492,2022-08-17 20:00:00,120,197,6,15,741,530,211,5
5493,2022-08-17 21:00:00,125,266,14,13,596,525,71,6
5494,2022-08-17 22:00:00,142,260,6,14,601,516,85,14
5495,2022-08-17 23:00:00,69,190,14,13,544,420,124,10
5496,2022-08-18 00:00:00,56,186,11,13,798,609,189,9
5497,2022-08-18 01:00:00,131,226,11,10,594,450,144,8
5498,2022-08-18 02:00:00,107,121,13,10,552,444,108,12
5499,2022-08-18 03:00:00,146,132,12,14,731,597,134,9
5500,2022-08-18 04:00:00,91,196,10,14,662,557,105,10
5501,2022-08-18 05:00:00,144,282,9,10,656,473,183,13
5502,2022-08-18 06:00:00,99,150,6,15,702,519,183,8
5503,2022-08-18 07:00:00,149,150,9,15,665,488,177,7
5504,2022-08-18 08:00:00,62,165,13,17,610,433,177,13
5505,2022-08-18 09:00:00,73,127,6,11,711,501,210,14
5506,2022-08-18 10:00:00,137,145,6,16,530,372,158,13
5507,2022-08-18 11:00:00,135,230,7,10,618,530,88,12
5508,2022-08-18 12:00:00,101,211,9,18,627,522,105,10
5509,2022-08-18 13:00:00,61,163,5,15,524,370,154,14
5510,2022-08-18 14:00:00,60,240,11,11,664,473,191,10
5511,2022-08-18 15:00:00,127,112,14,15,552,489,63,10
5512,2022-08-18 16:00:00,130,259,7,14,635,529,106,14
5513,2022-08-18 17:00:00,92,121,6,14,706,544,162,11
5514,2022-08-18 18:00:00,137,270,8,17,527,427,100,13
5515,2022-08-18 19:00:00,115,144,13,18,692,579,113,13
5516,2022-08-18 20:00:00,78,114,7,19,789,705,84,8
5517,2022-08-18 21:00:00,63,152,7,11,612,493,119,8
5518,2022-08-18 22:00:00,91,231,6,13,619,461,158,14
5519,2022-08-18 23:00:00,61,155,7,19,748,599,149,13
5520,2022-08-19 00:00:00,62,129,11,12,511,456,55,6
5521,2022-08-19 01:00:00,76,111,8,18,754,642,112,5
5522,2022-08-19 02:00:00,97,277,13,17,731,513,218,13
5523,2022-08-19 03:00:00,137,106,6,16,613,476,137,6
5524,2022-08-19 04:00:00,88,207,9,12,538,463,75,7
5525,2022-08-19 05:00:00,113,183,12,18,590,510,80,5
5526,2022-08-19 06:00:00,94,219,13,11,587,469,118,6
5527,2022-08-19 07:00:00,120,267,7,17,501,386,115,12
5528,2022-08-19 08:00:00,148,254,11,19,568,436,132,11
5529,2022-08-19 09:00:00,149,289,5,19,657,558,99,14
5530,2022-08-19 10:00:00,146,230,6,18,729,528,201,10
5531,2022-08-19 11:00:00,109,133,7,14,791,631,160,7
5532,2022-08-19 12:00:00,111,280,8,17,692,503,189,10
5533,2022-08-19 13:00:00,138,163,9,14,637,451,186,6
5534,2022-08-19 14:00:00,127,230,9,16,628,512,116,6
5535,2022-08-19 15:00:00,54,288,8,11,678,588,90,10
5536,2022-08-19 16:00:00,120,117,12,14,591,419,172,7
5537,2022-08-19 17:00:00,53,187,11,14,573,403,170,7
5538,2022-08-19 18:00:00,60,219,8,16,702,506,196,11
5539,2022-08-19 19:00:00,118,153,9,15,744,586,158,5
5540,2022-08-19 20:00:00,90,179,5,10,667,549,118,12
5541,2022-08-19 21:00:00,82,144,14,19,610,482,128,11
5542,2022-08-19 22:00:00,141,217,8,16,755,561,194,11
5543,2022-08-19 23:00:00,127,188,12,15,653,462,191,5
5544,2022-08-20 00:00:00,111,251,9,13,677,497,180,8
5545,2022-08-20 01:00:00,144,156,9,18,759,583,176,12
5546,2022-08-20 02:00:00,86,245,13,15,518,369,149,12
5547,2022-08-20 03:00:00,68,205,9,16,553,466,87,14
5548,2022-08-20 04:00:00,100,270,5,13,775,580,195,5
5549,2022-08-20 05:00:00,92,151,14,18,728,528,200,9
5550,2022-08-20 06:00:00,65,279,5,17,749,615,134,5
5551,2022-08-20 07:00:00,66,146,8,19,647,536,111,5
5552,2022-08-20 08:00:00,137,159,12,16,540,416,124,9
5553,2022-08-20 09:00:00,104,167,10,12,640,533,107,5
5554,2022-08-20 10:00:00,113,215,12,14,733,556,177,7
5555,2022-08-20 11:00:00,144,278,13,17,546,405,141,14
5556,2022-08-20 12:00:00,54,121,5,16,702,510,192,5
5557,2022-08-20 13:00:00,131,171,13,18,702,529,173,10
5558,2022-08-20 14:00:00,53,153,12,14,615,552,63,11
5559,2022-08-20 15:00:00,115,194,5,10,512,393,119,6
5560,2022-08-20 16:00:00,71,193,13,10,654,550,104,8
5561,2022-08-20 17:00:00,84,236,10,14,663,552,111,11
5562,2022-08-20 18:00:00,98,183,8,13,524,454,70,13
5563,2022-08-20 19:00:00,71,120,10,19,567,464,103,12
5564,2022-08-20 20:00:00,132,229,7,13,684,604,80,14
5565,2022-08-20 21:00:00,58,209,7,10,726,541,185,13
5566,2022-08-20 22:00:00,51,226,5,19,755,558,197,7
5567,2022-08-20 23:00:00,93,155,11,15,650,469,181,6
5568,2022-08-21 00:00:00,63,202,7,10,656,572,84,6
5569,2022-08-21 01:00:00,132,240,13,14,664,525,139,9
5570,2022-08-21 02:00:00,55,290,14,12,520,388,132,10
5571,2022-08-21 03:00:00,67,205,12,18,647,478,169,14
5572,2022-08-21 04:00:00,110,239,12,18,768,620,148,5
5573,2022-08-21 05:00:00,143,137,6,13,695,561,134,10
5574,2022-08-21 06:00:00,148,136,13,13,565,502,63,6
5575,2022-08-21 07:00:00,60,176,8,12,569,472,97,8
5576,2022-08-21 08:00:00,78,147,12,14,765,619,146,6
5577,2022-08-21 09:00:00,82,143,7,16,538,472,66,8
5578,2022-08-21 10:00:00,72,296,14,13,548,385,163,14
5579,2022-08-21 11:00:00,138,149,12,18,651,526,125,8
5580,2022-08-21 12:00:00,97,205,13,19,761,607,154,10
5581,2022-08-21 13:00:00,116,255,13,10,633,512,121,7
5582,2022-08-21 14:00:00,76,134,7,13,698,594,104,5
5583,2022-08-21 15:00:00,67,206,6,16,755,594,161,7
5584,2022-08-21 16:00:00,145,220,12,17,536,383,153,8
5585,2022-08-21 17:00:00,73,121,9,13,620,434,186,12
5586,2022-08-21 18:00:00,88,100,12,19,606,503,103,7
5587,2022-08-21 19:00:00,73,246,10,18,706,551,155,14
5588,2022-08-21 20:00:00,97,273,10,13,584,524,60,9
5589,2022-08-21 21:00:00,100,124,6,11,540,404,136,10
5590,2022-08-21 22:00:00,148,282,8,10,744,605,139,5
5591,2022-08-21 23:00:00,136,201,9,11,546,387,159,9
5592,2022-08-22 00:00:00,61,173,11,18,612,470,142,12
5593,2022-08-22 01:00:00,130,293,5,13,574,483,91,14
5594,2022-08-22 02:00:00,91,117,9,19,729,653,76,10
5595,2022-08-22 03:00:00,128,281,6,14,527,414,113,12
5596,2022-08-22 04:00:00,65,153,5,15,520,396,124,13
5597,2022-08-22 05:00:00,91,141,5,12,516,385,131,9
5598,2022-08-22 06:00:00,124,144,13,17,614,544,70,5
5599,2022-08-22 07:00:00,125,151,12,18,648,492,156,10
5600,2022-08-22 08:00:00,103,149,9,11,664,487,177,7
5601,2022-08-22 09:00:00,134,293,6,14,750,652,98,12
5602,2022-08-22 10:00:00,134,100,8,13,778,643,135,7
5603,2022-08-22 11:00:00,104,269,13,16,722,524,198,12
5604,2022-08-22 12:00:00,100,211,9,13,736,592,144,11
5605,2022-08-22 13:00:00,95,160,10,12,686,487,199,12
5606,2022-08-22 14:00:00,79,111,13,15,547,413,134,5
5607,2022-08-22 15:00:00,53,259,7,13,695,487,208,9
5608,2022-08-22 16:00:00,51,106,6,19,762,538,224,11
5609,2022-08-22 17:00:00,122,232,12,16,556,393,163,8
5610,2022-08-22 18:00:00,143,146,5,12,587,523,64,9
5611,2022-08-22 19:00:00,113,228,11,18,777,662,115,9
5612,2022-08-22 20:00:00,125,211,13,18,581,413,168,11
5613,2022-08-22 21:00:00,75,154,14,10,661,576,85,9
5614,2022-08-22 22:00:00,68,222,8,11,563,454,109,8
5615,2022-08-22 23:00:00,113,121,9,18,528,436,92,12
5616,2022-08-23 00:00:00,125,250,7,13,509,429,80,13
5617,2022-08-23 01:00:00,116,180,5,16,630,467,163,7
5618,2022-08-23 02:00:00,128,282,6,11,651,470,181,5
5619,2022-08-23 03:00:00,104,218,6,10,685,605,80,9
5620,2022-08-23 04:00:00,83,126,14,17,654,490,164,7
5621,2022-08-23 05:00:00,95,214,13,18,665,490,175,11
5622,2022-08-23 06:00:00,69,174,6,17,663,472,191,12
5623,2022-08-23 07:00:00,86,123,10,19,770,656,114,13
5624,2022-08-23 08:00:00,132,267,10,11,619,531,88,14
5625,2022-08-23 09:00:00,116,147,9,17,621,514,107,5
5626,2022-08-23 10:00:00,75,248,9,13,787,696,91,13
5627,2022-08-23 11:00:00,56,272,13,13,758,656,102,8
5628,2022-08-23 12:00:00,56,236,5,19,654,495,159,11
5629,2022-08-23 13:00:00,140,144,12,12,558,467,91,5
5630,2022-08-23 14:00:00,88,182,9,13,573,495,78,5
5631,2022-08-23 15:00:00,134,147,11,13,752,536,216,5
5632,2022-08-23 16:00:00,91,180,10,17,546,469,77,14
5633,2022-08-23 17:00:00,115,154,9,10,544,420,124,14
5634,2022-08-23 18:00:00,71,187,11,19,794,665,129,9
5635,2022-08-23 19:00:00,95,269,12,18,661,508,153,14
5636,2022-08-23 20:00:00,118,240,5,17,773,563,210,14
5637,2022-08-23 21:00:00,120,299,13,19,609,434,175,5
5638,2022-08-23 22:00:00,79,252,10,18,558,440,118,9
5639,2022-08-23 23:00:00,71,159,12,18,707,626,81,8
5640,2022-08-24 00:00:00,69,254,9,13,654,486,168,7
5641,2022-08-24 01:00:00,146,122,8,11,799,682,117,12
5642,2022-08-24 02:00:00,115,259,5,11,727,576,151,8
5643,2022-08-24 03:00:00,101,286,9,11,602,452,150,12
5644,2022-08-24 04:00:00,139,101,6,16,698,538,160,10
5645,2022-08-24 05:00:00,129,173,8,14,538,430,108,6
5646,2022-08-24 06:00:00,72,206,9,12,592,489,103,9
5647,2022-08-24 07:00:00,129,250,8,11,644,542,102,6
5648,2022-08-24 08:00:00,111,293,13,17,654,577,77,12
5649,2022-08-24 09:00:00,86,243,13,13,765,619,146,7
5650,2022-08-24 10:00:00,116,166,9,12,619,439,180,14
5651,2022-08-24 11:00:00,75,246,8,13,737,558,179,13
5652,2022-08-24 12:00:00,73,101,7,19,705,600,105,6
5653,2022-08-24 13:00:00,106,230,13,13,792,592,200,10
5654,2022-08-24 14:00:00,144,187,9,16,651,465,186,13
5655,2022-08-24 15:00:00,61,194,5,12,736,555,181,7
5656,2022-08-24 16:00:00,78,262,14,16,578,405,173,14
5657,2022-08-24 17:00:00,87,230,14,18,541,409,132,7
5658,2022-08-24 18:00:00,69,275,10,17,714,512,202,5
5659,2022-08-24 19:00:00,124,290,7,16,565,486,79,9
5660,2022-08-24 20:00:00,80,149,7,14,600,522,78,8
5661,2022-08-24 21:00:00,54,238,14,14,634,481,153,14
5662,2022-08-24 22:00:00,66,246,11,12,663,524,139,11
5663,2022-08-24 23:00:00,101,181,10,19,786,627,159,11
5664,2022-08-25 00:00:00,91,241,11,12,621,544,77,5
5665,2022-08-25 01:00:00,131,122,14,11,734,650,84,9
5666,2022-08-25 02:00:00,63,123,6,16,602,453,149,10
5667,2022-08-25 03:00:00,94,161,12,10,737,607,130,11
5668,2022-08-25 04:00:00,123,296,10,17,523,385,138,7
5669,2022-08-25 05:00:00,65,106,11,15,544,410,134,13
5670,2022-08-25 06:00:00,111,158,5,12,673,502,171,7
5671,2022-08-25 07:00:00,75,150,9,18,632,444,188,8
5672,2022-08-25 08:00:00,108,227,5,18,715,574,141,6
5673,2022-08-25 09:00:00,78,258,8,18,598,446,152,11
5674,2022-08-25 10:00:00,101,149,10,11,550,449,101,14
5675,2022-08-25 11:00:00,91,211,11,16,769,598,171,13
5676,2022-08-25 12:00:00,129,230,12,15,645,510,135,14
5677,2022-08-25 13:00:00,75,289,9,12,740,524,216,14
5678,2022-08-25 14:00:00,121,185,7,12,561,444,117,12
5679,2022-08-25 15:00:00,92,127,6,17,731,583,148,13
5680,2022-08-25 16:00:00,88,147,10,18,528,421,107,10
5681,2022-08-25 17:00:00,55,138,11,16,619,510,109,12
5682,2022-08-25 18:00:00,146,239,9,13,790,605,185,6
5683,2022-08-25 19:00:00,79,122,10,17,527,440,87,13
5684,2022-08-25 20:00:00,91,145,7,15,687,499,188,9
5685,2022-08-25 21:00:00,114,108,10,18,641,522,119,13
5686,2022-08-25 22:00:00,68,154,8,16,799,581,218,8
5687,2022-08-25 23:00:00,54,137,13,18,534,477,57,9
5688,2022-08-26 00:00:00,121,163,8,14,532,474,58,11
5689,2022-08-26 01:00:00,75,245,10,12,606,491,115,8
5690,2022-08-26 02:00:00,131,186,6,19,586,418,168,9
5691,2022-08-26 03:00:00,70,278,12,17,665,475,190,14
5692,2022-08-26 04:00:00,93,297,11,11,600,506,94,6
5693,2022-08-26 05:00:00,97,133,5,10,781,595,186,8
5694,2022-08-26 06:00:00,109,200,5,13,775,679,96,6
5695,2022-08-26 07:00:00,95,242,5,19,697,495,202,11
5696,2022-08-26 08:00:00,144,165,12,14,602,519,83,9
5697,2022-08-26 09:00:00,121,137,6,18,761,680,81,8
5698,2022-08-26 10:00:00,141,216,9,13,792,589,203,6
5699,2022-08-26 11:00:00,147,170,7,14,789,680,109,11
5700,2022-08-26 12:00:00,118,109,12,18,709,631,78,14
5701,2022-08-26 13:00:00,145,148,8,16,769,691,78,13
5702,2022-08-26 14:00:00,115,189,12,17,697,538,159,9
5703,2022-08-26 15:00:00,127,202,14,14,721,600,121,7
5704,2022-08-26 16:00:00,84,251,5,14,675,575,100,9
5705,2022-08-26 17:00:00,115,171,12,11,739,613,126,8
5706,2022-08-26 18:00:00,63,107,14,15,756,594,162,5
5707,2022-08-26 19:00:00,56,202,12,16,618,500,118,7
5708,2022-08-26 20:00:00,61,106,14,19,530,451,79,12
5709,2022-08-26 21:00:00,96,194,5,18,619,509,110,10
5710,2022-08-26 22:00:00,110,115,7,12,501,440,61,5
5711,2022-08-26 23:00:00,58,204,13,10,769,572,197,14
5712,2022-08-27 00:00:00,68,210,7,10,768,563,205,8
5713,2022-08-27 01:00:00,78,295,5,13,793,650,143,11
5714,2022-08-27 02:00:00,65,228,6,19,614,527,87,5
5715,2022-08-27 03:00:00,108,237,6,16,584,479,105,5
5716,2022-08-27 04:00:00,108,134,7,10,528,386,142,5
5717,2022-08-27 05:00:00,69,242,10,17,798,566,232,8
5718,2022-08-27 06:00:00,97,220,11,10,527,401,126,6
5719,2022-08-27 07:00:00,138,166,14,19,671,557,114,8
5720,2022-08-27 08:00:00,117,140,10,12,605,531,74,8
5721,2022-08-27 09:00:00,68,104,5,10,751,642,109,7
5722,2022-08-27 10:00:00,88,117,6,14,659,522,137,14
5723,2022-08-27 11:00:00,100,119,12,19,594,424,170,6
5724,2022-08-27 12:00:00,114,201,5,19,642,482,160,8
5725,2022-08-27 13:00:00,107,127,10,12,670,538,132,7
5726,2022-08-27 14:00:00,107,158,9,17,690,542,148,12
5727,2022-08-27 15:00:00,98,199,11,19,755,637,118,5
5728,2022-08-27 16:00:00,96,137,12,18,772,679,93,8
5729,2022-08-27 17:00:00,72,104,9,18,579,471,108,10
5730,2022-08-27 18:00:00,130,164,9,16,608,509,99,9
5731,2022-08-27 19:00:00,133,223,11,11,730,654,76,7
5732,2022-08-27 20:00:00,54,271,11,18,756,580,176,6
5733,2022-08-27 21:00:00,51,234,9,13,618,472,146,14
5734,2022-08-27 22:00:00,70,259,7,12,618,446,172,9
5735,2022-08-27 23:00:00,78,289,6,11,706,542,164,10
5736,2022-08-28 00:00:00,64,165,9,17,625,493,132,9
5737,2022-08-28 01:00:00,66,165,11,11,758,654,104,7
5738,2022-08-28 02:00:00,55,127,10,13,632,566,66,14
5739,2022-08-28 03:00:00,80,254,12,11,632,473,159,13
5740,2022-08-28 04:00:00,144,149,10,18,623,507,116,13
5741,2022-08-28 05:00:00,62,243,7,18,727,596,131,13
5742,2022-08-28 06:00:00,70,206,12,16,539,471,68,11
5743,2022-08-28 07:00:00,104,244,12,11,665,490,175,13
5744,2022-08-28 08:00:00,93,194,5,19,533,449,84,7
5745,2022-08-28 09:00:00,149,111,6,18,636,560,76,13
5746,2022-08-28 10:00:00,126,176,10,14,713,512,201,8
5747,2022-08-28 11:00:00,115,127,11,19,671,501,170,12
5748,2022-08-28 12:00:00,132,187,5,10,720,591,129,13
5749,2022-08-28 13:00:00,126,266,8,17,670,523,147,14
5750,2022-08-28 14:00:00,101,167,12,10,595,483,112,5
5751,2022-08-28 15:00:00,74,191,6,17,796,664,132,14
5752,2022-08-28 16:00:00,114,213,9,12,680,531,149,8
5753,2022-08-28 17:00:00,143,189,11,10,625,471,154,13
5754,2022-08-28 18:00:00,111,122,5,12,651,539,112,5
5755,2022-08-28 19:00:00,59,228,11,15,545,449,96,12
5756,2022-08-28 20:00:00,144,171,9,14,695,600,95,14
5757,2022-08-28 21:00:00,109,225,12,13,508,429,79,14
5758,2022-08-28 22:00:00,126,223,12,14,551,485,66,7
5759,2022-08-28 23:00:00,110,106,11,11,623,465,158,7
5760,2022-08-29 00:00:00,145,174,9,14,548,470,78,11
5761,2022-08-29 01:00:00,82,128,11,13,777,688,89,9
5762,2022-08-29 02:00:00,62,136,10,11,587,477,110,9
5763,2022-08-29 03:00:00,139,166,14,17,719,633,86,13
5764,2022-08-29 04:00:00,57,180,13,16,581,452,129,9
5765,2022-08-29 05:00:00,62,210,8,12,696,524,172,13
5766,2022-08-29 06:00:00,123,204,13,13,581,411,170,11
5767,2022-08-29 07:00:00,107,198,8,15,536,414,122,6
5768,2022-08-29 08:00:00,51,131,9,14,571,457,114,8
5769,2022-08-29 09:00:00,98,103,12,15,627,470,157,12
5770,2022-08-29 10:00:00,105,158,9,17,554,458,96,14
5771,2022-08-29 11:00:00,134,281,14,13,730,581,149,5
5772,2022-08-29 12:00:00,109,114,6,15,667,550,117,13
5773,2022-08-29 13:00:00,84,237,9,11,619,538,81,12
5774,2022-08-29 14:00:00,79,258,7,15,596,447,149,10
5775,2022-08-29 15:00:00,69,183,8,15,746,523,223,14
5776,2022-08-29 16:00:00,86,248,9,14,542,420,122,7
5777,2022-08-29 17:00:00,136,221,9,10,707,563,144,8
5778,2022-08-29 18:00:00,89,115,13,13,576,466,110,9
5779,2022-08-29 19:00:00,126,120,14,17,706,499,207,14
5780,2022-08-29 20:00:00,99,180,8,14,638,459,179,5
5781,2022-08-29 21:00:00,73,216,7,16,722,524,198,13
5782,2022-08-29 22:00:00,91,299,6,11,566,494,72,10
5783,2022-08-29 23:00:00,104,153,13,15,701,604,97,12
5784,2022-08-30 00:00:00,108,141,13,18,580,455,125,8
5785,2022-08-30 01:00:00,129,228,13,15,535,411,124,5
5786,2022-08-30 02:00:00,103,283,7,11,590,465,125,11
5787,2022-08-30 03:00:00,100,144,7,16,543,482,61,8
5788,2022-08-30 04:00:00,132,213,13,11,510,403,107,11
5789,2022-08-30 05:00:00,85,226,12,11,794,609,185,9
5790,2022-08-30 06:00:00,128,173,14,10,723,507,216,7
5791,2022-08-30 07:00:00,74,279,11,18,599,520,79,11
5792,2022-08-30 08:00:00,129,290,11,16,529,405,124,5
5793,2022-08-30 09:00:00,145,188,12,13,776,548,228,5
5794,2022-08-30 10:00:00,94,186,8,12,757,618,139,7
5795,2022-08-30 11:00:00,51,188,7,19,503,412,91,10
5796,2022-08-30 12:00:00,131,227,12,19,553,444,109,11
5797,2022-08-30 13:00:00,145,293,5,13,727,586,141,11
5798,2022-08-30 14:00:00,64,243,11,14,630,533,97,11
5799,2022-08-30 15:00:00,123,264,8,10,515,390,125,7
5800,2022-08-30 16:00:00,75,228,14,16,717,558,159,5
5801,2022-08-30 17:00:00,95,117,5,17,539,460,79,9
5802,2022-08-30 18:00:00,101,192,6,10,679,504,175,9
5803,2022-08-30 19:00:00,85,151,6,19,725,553,172,14
5804,2022-08-30 20:00:00,104,299,12,13,776,679,97,9
5805,2022-08-30 21:00:00,138,192,8,18,699,492,207,7
5806,2022-08-30 22:00:00,115,130,5,13,696,622,74,11
5807,2022-08-30 23:00:00,64,242,14,13,589,457,132,5
5808,2022-08-31 00:00:00,113,278,7,13,734,584,150,14
5809,2022-08-31 01:00:00,147,250,5,12,560,469,91,9
5810,2022-08-31 02:00:00,136,126,13,11,773,637,136,6
5811,2022-08-31 03:00:00,54,271,10,11,524,408,116,8
5812,2022-08-31 04:00:00,55,154,6,14,573,416,157,14
5813,2022-08-31 05:00:00,137,194,10,17,730,535,195,13
5814,2022-08-31 06:00:00,142,232,7,18,728,562,166,12
5815,2022-08-31 07:00:00,110,102,12,18,740,566,174,13
5816,2022-08-31 08:00:00,116,144,9,15,584,510,74,7
5817,2022-08-31 09:00:00,64,197,14,13,606,436,170,7
5818,2022-08-31 10:00:00,143,273,8,19,716,636,80,12
5819,2022-08-31 11:00:00,131,283,11,10,660,492,168,6
5820,2022-08-31 12:00:00,85,205,6,12,686,539,147,13
5821,2022-08-31 13:00:00,130,268,14,12,616,454,162,7
5822,2022-08-31 14:00:00,59,155,8,13,617,433,184,11
5823,2022-08-31 15:00:00,89,243,9,18,580,510,70,12
5824,2022-08-31 16:00:00,57,179,14,16,612,477,135,6
5825,2022-08-31 17:00:00,91,297,9,12,537,397,140,5
5826,2022-08-31 18:00:00,111,204,6,14,787,672,115,12
5827,2022-08-31 19:00:00,70,142,11,12,547,471,76,14
5828,2022-08-31 20:00:00,81,248,12,10,676,480,196,5
5829,2022-08-31 21:00:00,111,111,13,16,784,597,187,8
5830,2022-08-31 22:00:00,75,178,9,13,694,574,120,13
5831,2022-08-31 23:00:00,77,241,5,10,562,406,156,13
5832,2022-09-01 00:00:00,55,218,11,17,695,613,82,8
5833,2022-09-01 01:00:00,74,227,11,17,725,646,79,12
5834,2022-09-01 02:00:00,54,133,14,18,756,568,188,12
5835,2022-09-01 03:00:00,55,127,12,17,569,448,121,10
5836,2022-09-01 04:00:00,86,119,12,16,798,623,175,7
5837,2022-09-01 05:00:00,74,285,14,11,551,455,96,8
5838,2022-09-01 06:00:00,115,137,11,14,604,459,145,11
5839,2022-09-01 07:00:00,95,115,5,11,526,429,97,11
5840,2022-09-01 08:00:00,104,221,10,17,597,511,86,7
5841,2022-09-01 09:00:00,125,259,6,16,667,593,74,10
5842,2022-09-01 10:00:00,110,220,14,16,628,495,133,13
5843,2022-09-01 11:00:00,149,108,8,17,711,598,113,12
5844,2022-09-01 12:00:00,113,226,14,12,581,461,120,10
5845,2022-09-01 13:00:00,111,149,6,13,774,599,175,12
5846,2022-09-01 14:00:00,75,202,7,11,614,488,126,10
5847,2022-09-01 15:00:00,52,183,5,14,578,490,88,10
5848,2022-09-01 16:00:00,109,191,6,15,655,490,165,14
5849,2022-09-01 17:00:00,82,212,6,19,571,442,129,11
5850,2022-09-01 18:00:00,123,295,7,10,608,443,165,5
5851,2022-09-01 19:00:00,95,139,12,11,774,598,176,5
5852,2022-09-01 20:00:00,70,266,7,19,638,560,78,8
5853,2022-09-01 21:00:00,135,272,7,12,779,571,208,9
5854,2022-09-01 22:00:00,91,225,11,10,680,492,188,5
5855,2022-09-01 23:00:00,59,126,6,10,587,526,61,14
5856,2022-09-02 00:00:00,114,253,10,11,589,519,70,8
5857,2022-09-02 01:00:00,133,235,10,18,609,529,80,5
5858,2022-09-02 02:00:00,119,299,14,11,797,649,148,6
5859,2022-09-02 03:00:00,140,100,13,18,586,421,165,7
5860,2022-09-02 04:00:00,64,232,7,19,768,636,132,5
5861,2022-09-02 05:00:00,118,220,9,16,688,526,162,14
5862,2022-09-02 06:00:00,70,135,6,12,530,424,106,11
5863,2022-09-02 07:00:00,104,164,14,13,587,505,82,11
5864,2022-09-02 08:00:00,147,232,9,11,691,571,120,6
5865,2022-09-02 09:00:00,108,210,8,12,547,452,95,12
5866,2022-09-02 10:00:00,141,250,12,16,651,502,149,12
5867,2022-09-02 11:00:00,68,248,6,12,634,467,167,5
5868,2022-09-02 12:00:00,96,237,14,14,644,476,168,12
5869,2022-09-02 13:00:00,55,249,6,16,587,426,161,9
5870,2022-09-02 14:00:00,94,243,8,11,707,624,83,14
5871,2022-09-02 15:00:00,89,185,5,13,504,386,118,14
5872,2022-09-02 16:00:00,110,171,8,10,653,561,92,12
5873,2022-09-02 17:00:00,101,152,13,14,573,408,165,7
5874,2022-09-02 18:00:00,92,198,6,17,619,454,165,13
5875,2022-09-02 19:00:00,140,152,9,18,606,528,78,8
5876,2022-09-02 20:00:00,89,204,13,10,718,505,213,5
5877,2022-09-02 21:00:00,63,279,11,18,690,491,199,8
5878,2022-09-02 22:00:00,59,244,8,12,695,501,194,14
5879,2022-09-02 23:00:00,143,267,6,12,505,400,105,7
5880,2022-09-03 00:00:00,79,179,8,14,712,537,175,5
5881,2022-09-03 01:00:00,128,165,6,16,533,417,116,9
5882,2022-09-03 02:00:00,120,244,12,11,716,505,211,14
5883,2022-09-03 03:00:00,89,176,7,19,696,536,160,5
5884,2022-09-03 04:00:00,92,194,8,14,782,703,79,14
5885,2022-09-03 05:00:00,79,215,9,12,632,502,130,9
5886,2022-09-03 06:00:00,58,141,9,12,500,366,134,10
5887,2022-09-03 07:00:00,123,262,8,12,731,556,175,5
5888,2022-09-03 08:00:00,109,248,5,10,550,428,122,8
5889,2022-09-03 09:00:00,146,212,8,13,765,590,175,12
5890,2022-09-03 10:00:00,96,101,9,15,792,667,125,11
5891,2022-09-03 11:00:00,76,248,10,15,526,384,142,5
5892,2022-09-03 12:00:00,72,285,7,19,575,444,131,11
5893,2022-09-03 13:00:00,124,166,11,19,674,595,79,14
5894,2022-09-03 14:00:00,93,296,11,19,578,489,89,12
5895,2022-09-03 15:00:00,112,132,12,19,777,584,193,10
5896,2022-09-03 16:00:00,71,215,11,13,627,535,92,7
5897,2022-09-03 17:00:00,85,262,9,14,558,488,70,13
5898,2022-09-03 18:00:00,73,199,8,17,683,599,84,10
5899,2022-09-03 19:00:00,103,228,5,17,750,644,106,9
5900,2022-09-03 20:00:00,79,258,7,13,646,500,146,5
5901,2022-09-03 21:00:00,59,166,7,13,697,529,168,9
5902,2022-09-03 22:00:00,75,203,10,10,577,461,116,12
5903,2022-09-03 23:00:00,122,247,6,15,647,511,136,13
5904,2022-09-04 00:00:00,114,274,5,13,707,580,127,14
5905,2022-09-04 01:00:00,90,125,6,14,729,618,111,12
5906,2022-09-04 02:00:00,116,191,5,10,656,516,140,8
5907,2022-09-04 03:00:00,133,286,8,13,643,467,176,12
5908,2022-09-04 04:00:00,137,101,10,11,719,564,155,12
5909,2022-09-04 05:00:00,98,285,11,17,636,488,148,5
5910,2022-09-04 06:00:00,92,219,6,18,783,579,204,10
5911,2022-09-04 07:00:00,50,260,12,19,704,514,190,14
5912,2022-09-04 08:00:00,83,112,7,14,764,582,182,11
5913,2022-09-04 09:00:00,60,147,12,13,639,455,184,11
5914,2022-09-04 10:00:00,79,147,12,10,601,438,163,13
5915,2022-09-04 11:00:00,84,248,10,16,798,632,166,10
5916,2022-09-04 12:00:00,146,249,5,12,778,663,115,10
5917,2022-09-04 13:00:00,97,295,11,13,681,592,89,7
5918,2022-09-04 14:00:00,109,238,14,13,551,477,74,7
5919,2022-09-04 15:00:00,129,278,5,10,533,474,59,14
5920,2022-09-04 16:00:00,120,270,14,18,667,550,117,5
5921,2022-09-04 17:00:00,62,117,8,14,740,578,162,9
5922,2022-09-04 18:00:00,123,215,7,12,622,474,148,11
5923,2022-09-04 19:00:00,126,133,5,17,571,456,115,5
5924,2022-09-04 20:00:00,130,219,8,13,529,371,158,6
5925,2022-09-04 21:00:00,64,190,12,19,653,482,171,14
5926,2022-09-04 22:00:00,53,299,12,18,671,470,201,6
5927,2022-09-04 23:00:00,86,147,14,18,631,462,169,9
5928,2022-09-05 00:00:00,111,167,10,15,767,616,151,14
5929,2022-09-05 01:00:00,81,294,7,17,672,533,139,7
5930,2022-09-05 02:00:00,75,161,11,19,558,400,158,5
5931,2022-09-05 03:00:00,89,156,5,18,719,541,178,12
5932,2022-09-05 04:00:00,58,147,7,19,572,430,142,12
5933,2022-09-05 05:00:00,80,249,10,19,560,429,131,13
5934,2022-09-05 06:00:00,54,215,10,16,700,594,106,12
5935,2022-09-05 07:00:00,123,194,10,12,544,434,110,7
5936,2022-09-05 08:00:00,55,258,8,16,611,527,84,8
5937,2022-09-05 09:00:00,120,232,13,15,637,503,134,14
5938,2022-09-05 10:00:00,77,204,11,15,786,643,143,13
5939,2022-09-05 11:00:00,69,199,13,15,643,516,127,14
5940,2022-09-05 12:00:00,140,248,13,17,766,538,228,5
5941,2022-09-05 13:00:00,124,298,12,17,719,536,183,9
5942,2022-09-05 14:00:00,107,158,5,16,651,517,134,13
5943,2022-09-05 15:00:00,102,233,5,15,649,482,167,8
5944,2022-09-05 16:00:00,119,289,12,15,602,451,151,10
5945,2022-09-05 17:00:00,88,156,7,14,586,476,110,11
5946,2022-09-05 18:00:00,54,266,13,10,526,379,147,12
5947,2022-09-05 19:00:00,103,255,7,16,755,571,184,9
5948,2022-09-05 20:00:00,139,298,11,12,733,589,144,5
5949,2022-09-05 21:00:00,136,164,13,13,710,538,172,7
5950,2022-09-05 22:00:00,143,146,12,12,723,614,109,10
5951,2022-09-05 23:00:00,124,243,10,14,531,384,147,10
5952,2022-09-06 00:00:00,57,283,7,17,640,552,88,8
5953,2022-09-06 01:00:00,110,201,5,16,616,525,91,12
5954,2022-09-06 02:00:00,119,240,13,10,558,402,156,14
5955,2022-09-06 03:00:00,80,269,6,19,691,553,138,5
5956,2022-09-06 04:00:00,107,148,5,10,578,424,154,5
5957,2022-09-06 05:00:00,128,110,9,18,618,522,96,7
5958,2022-09-06 06:00:00,98,297,6,11,653,583,70,14
5959,2022-09-06 07:00:00,142,135,14,17,566,453,113,12
5960,2022-09-06 08:00:00,139,174,6,16,788,582,206,14
5961,2022-09-06 09:00:00,60,295,12,16,554,392,162,5
5962,2022-09-06 10:00:00,102,282,14,19,690,573,117,11
5963,2022-09-06 11:00:00,76,105,8,11,665,484,181,10
5964,2022-09-06 12:00:00,130,186,6,16,646,548,98,9
5965,2022-09-06 13:00:00,79,143,12,12,506,404,102,14
5966,2022-09-06 14:00:00,98,298,8,18,541,401,140,11
5967,2022-09-06 15:00:00,77,184,7,18,626,563,63,8
5968,2022-09-06 16:00:00,62,173,8,10,502,382,120,13
5969,2022-09-06 17:00:00,72,175,9,19,698,571,127,12
5970,2022-09-06 18:00:00,62,126,13,18,501,380,121,10
5971,2022-09-06 19:00:00,71,142,7,10,787,661,126,8
5972,2022-09-06 20:00:00,64,141,12,16,660,494,166,9
5973,2022-09-06 21:00:00,136,109,12,16,689,560,129,9
5974,2022-09-06 22:00:00,123,233,10,17,639,525,114,14
5975,2022-09-06 23:00:00,65,228,13,16,714,583,131,7
5976,2022-09-07 00:00:00,123,265,13,10,655,493,162,10
5977,2022-09-07 01:00:00,81,101,7,18,700,516,184,8
5978,2022-09-07 02:00:00,70,189,7,12,562,480,82,11
5979,2022-09-07 03:00:00,81,111,14,11,577,428,149,12
5980,2022-09-07 04:00:00,124,183,13,13,529,428,101,12
5981,2022-09-07 05:00:00,119,289,5,10,674,577,97,7
5982,2022-09-07 06:00:00,98,218,9,18,735,598,137,14
5983,2022-09-07 07:00:00,132,291,10,15,705,530,175,8
5984,2022-09-07 08:00:00,55,249,13,16,732,566,166,11
5985,2022-09-07 09:00:00,148,202,11,11,599,461,138,14
5986,2022-09-07 10:00:00,86,116,6,11,546,395,151,13
5987,2022-09-07 11:00:00,89,228,13,11,625,491,134,9
5988,2022-09-07 12:00:00,86,120,14,16,771,650,121,14
5989,2022-09-07 13:00:00,77,191,10,16,607,515,92,10
5990,2022-09-07 14:00:00,120,170,10,10,695,559,136,9
5991,2022-09-07 15:00:00,134,276,12,12,732,624,108,7
5992,2022-09-07 16:00:00,133,264,7,10,786,644,142,11
5993,2022-09-07 17:00:00,113,217,11,17,506,434,72,6
5994,2022-09-07 18:00:00,118,114,10,14,713,501,212,10
5995,2022-09-07 19:00:00,93,242,7,17,745,627,118,8
5996,2022-09-07 20:00:00,69,107,5,18,563,490,73,14
5997,2022-09-07 21:00:00,90,158,14,16,622,551,71,11
5998,2022-09-07 22:00:00,118,120,10,19,760,610,150,12
5999,2022-09-07 23:00:00,89,148,5,17,772,645,127,6
6000,2022-09-08 00:00:00,57,197,7,15,795,592,203,10
6001,2022-09-08 01:00:00,117,172,10,19,630,444,186,6
6002,2022-09-08 02:00:00,97,192,13,16,563,443,120,9
6003,2022-09-08 03:00:00,88,158,11,16,749,567,182,7
6004,2022-09-08 04:00:00,118,157,9,11,686,612,74,7
6005,2022-09-08 05:00:00,93,233,7,18,733,614,119,10
6006,2022-09-08 06:00:00,106,257,5,11,791,627,164,5
6007,2022-09-08 07:00:00,62,134,9,15,546,416,130,8
6008,2022-09-08 08:00:00,112,155,12,15,522,393,129,14
6009,2022-09-08 09:00:00,120,105,5,19,668,527,141,8
6010,2022-09-08 10:00:00,124,172,8,16,561,411,150,12
6011,2022-09-08 11:00:00,59,101,7,16,535,408,127,7
6012,2022-09-08 12:00:00,77,123,6,11,610,476,134,12
6013,2022-09-08 13:00:00,138,214,10,10,542,408,134,12
6014,2022-09-08 14:00:00,75,296,12,13,752,628,124,9
6015,2022-09-08 15:00:00,144,195,10,15,598,486,112,11
6016,2022-09-08 16:00:00,78,211,8,16,553,421,132,10
6017,2022-09-08 17:00:00,148,116,5,18,699,569,130,6
6018,2022-09-08 18:00:00,79,226,12,12,567,510,57,13
6019,2022-09-08 19:00:00,99,279,9,11,732,547,185,6
6020,2022-09-08 20:00:00,61,238,12,13,685,564,121,6
6021,2022-09-08 21:00:00,118,214,7,11,687,579,108,11
6022,2022-09-08 22:00:00,112,265,8,10,709,508,201,8
6023,2022-09-08 23:00:00,127,226,7,16,677,540,137,6
6024,2022-09-09 00:00:00,125,240,14,15,698,495,203,5
6025,2022-09-09 01:00:00,94,165,6,15,570,485,85,5
6026,2022-09-09 02:00:00,105,230,13,11,619,550,69,8
6027,2022-09-09 03:00:00,62,172,14,12,568,407,161,14
6028,2022-09-09 04:00:00,111,294,11,14,731,613,118,9
6029,2022-09-09 05:00:00,136,183,7,14,713,577,136,6
6030,2022-09-09 06:00:00,72,149,12,11,666,481,185,14
6031,2022-09-09 07:00:00,143,271,11,19,725,539,186,7
6032,2022-09-09 08:00:00,57,146,7,13,589,442,147,6
6033,2022-09-09 09:00:00,61,163,10,13,596,517,79,5
6034,2022-09-09 10:00:00,145,280,10,17,512,459,53,11
6035,2022-09-09 11:00:00,81,166,9,15,651,537,114,6
6036,2022-09-09 12:00:00,104,215,11,13,631,558,73,8
6037,2022-09-09 13:00:00,58,118,8,10,759,632,127,14
6038,2022-09-09 14:00:00,98,188,11,16,563,406,157,7
6039,2022-09-09 15:00:00,90,219,9,12,643,535,108,14
6040,2022-09-09 16:00:00,141,268,9,17,692,533,159,10
6041,2022-09-09 17:00:00,70,103,8,13,732,643,89,9
6042,2022-09-09 18:00:00,125,221,11,14,677,528,149,6
6043,2022-09-09 19:00:00,135,159,9,10,662,564,98,13
6044,2022-09-09 20:00:00,89,272,14,10,668,480,188,5
6045,2022-09-09 21:00:00,109,181,5,11,708,588,120,13
6046,2022-09-09 22:00:00,71,284,9,10,532,465,67,12
6047,2022-09-09 23:00:00,91,239,12,11,695,588,107,8
6048,2022-09-10 00:00:00,90,121,6,10,568,424,144,11
6049,2022-09-10 01:00:00,110,217,8,15,648,464,184,10
6050,2022-09-10 02:00:00,134,167,7,13,565,500,65,6
6051,2022-09-10 03:00:00,105,145,13,13,571,408,163,7
6052,2022-09-10 04:00:00,99,271,9,16,561,479,82,12
6053,2022-09-10 05:00:00,148,248,9,10,532,477,55,9
6054,2022-09-10 06:00:00,125,167,14,12,680,500,180,14
6055,2022-09-10 07:00:00,87,229,9,10,769,553,216,6
6056,2022-09-10 08:00:00,147,190,13,12,714,570,144,13
6057,2022-09-10 09:00:00,50,182,11,16,630,545,85,7
6058,2022-09-10 10:00:00,84,228,9,12,638,458,180,14
6059,2022-09-10 11:00:00,145,224,13,16,567,487,80,8
6060,2022-09-10 12:00:00,89,131,5,18,600,509,91,7
6061,2022-09-10 13:00:00,80,114,13,17,708,514,194,5
6062,2022-09-10 14:00:00,86,157,5,17,783,670,113,5
6063,2022-09-10 15:00:00,85,268,10,17,663,584,79,8
6064,2022-09-10 16:00:00,118,144,8,10,694,491,203,10
6065,2022-09-10 17:00:00,67,291,14,19,777,602,175,14
6066,2022-09-10 18:00:00,59,117,9,16,524,422,102,7
6067,2022-09-10 19:00:00,89,163,8,12,683,577,106,14
6068,2022-09-10 20:00:00,80,270,6,12,686,491,195,8
6069,2022-09-10 21:00:00,108,273,11,10,762,559,203,6
6070,2022-09-10 22:00:00,80,257,12,11,533,450,83,10
6071,2022-09-10 23:00:00,65,144,14,17,598,534,64,11
6072,2022-09-11 00:00:00,131,275,14,19,588,505,83,7
6073,2022-09-11 01:00:00,139,124,12,19,599,521,78,7
6074,2022-09-11 02:00:00,65,238,9,18,626,500,126,14
6075,2022-09-11 03:00:00,55,218,9,11,700,612,88,11
6076,2022-09-11 04:00:00,133,209,7,10,663,492,171,11
6077,2022-09-11 05:00:00,97,143,6,12,567,474,93,8
6078,2022-09-11 06:00:00,59,115,12,15,791,609,182,14
6079,2022-09-11 07:00:00,147,118,5,16,784,680,104,9
6080,2022-09-11 08:00:00,55,177,12,19,747,568,179,5
6081,2022-09-11 09:00:00,92,171,14,11,575,498,77,9
6082,2022-09-11 10:00:00,57,165,14,11,655,526,129,13
6083,2022-09-11 11:00:00,83,187,8,15,510,446,64,11
6084,2022-09-11 12:00:00,54,262,8,16,798,606,192,12
6085,2022-09-11 13:00:00,60,174,14,16,681,546,135,9
6086,2022-09-11 14:00:00,65,286,8,13,616,512,104,7
6087,2022-09-11 15:00:00,102,238,9,19,669,519,150,7
6088,2022-09-11 16:00:00,133,174,5,15,789,588,201,5
6089,2022-09-11 17:00:00,84,174,13,15,662,526,136,10
6090,2022-09-11 18:00:00,95,156,13,15,657,504,153,14
6091,2022-09-11 19:00:00,92,181,12,19,539,432,107,12
6092,2022-09-11 20:00:00,114,221,8,15,697,622,75,11
6093,2022-09-11 21:00:00,50,287,14,10,557,464,93,10
6094,2022-09-11 22:00:00,67,108,6,19,622,439,183,6
6095,2022-09-11 23:00:00,83,224,10,16,555,396,159,6
6096,2022-09-12 00:00:00,70,212,14,17,711,588,123,14
6097,2022-09-12 01:00:00,135,175,14,14,525,463,62,9
6098,2022-09-12 02:00:00,78,133,10,14,793,593,200,8
6099,2022-09-12 03:00:00,121,162,9,12,500,446,54,8
6100,2022-09-12 04:00:00,61,150,8,16,586,473,113,6
6101,2022-09-12 05:00:00,146,243,5,14,623,463,160,9
6102,2022-09-12 06:00:00,114,175,9,12,633,461,172,12
6103,2022-09-12 07:00:00,95,281,7,13,621,503,118,8
6104,2022-09-12 08:00:00,89,150,5,17,653,556,97,8
6105,2022-09-12 09:00:00,146,177,10,19,592,421,171,10
6106,2022-09-12 10:00:00,146,163,12,18,666,563,103,13
6107,2022-09-12 11:00:00,146,213,13,14,615,513,102,14
6108,2022-09-12 12:00:00,59,123,9,14,791,561,230,5
6109,2022-09-12 13:00:00,89,293,12,18,663,542,121,13
6110,2022-09-12 14:00:00,90,281,12,17,587,482,105,10
6111,2022-09-12 15:00:00,110,146,14,17,561,442,119,13
6112,2022-09-12 16:00:00,58,194,8,11,629,531,98,13
6113,2022-09-12 17:00:00,97,267,13,19,771,640,131,14
6114,2022-09-12 18:00:00,59,104,6,18,737,618,119,8
6115,2022-09-12 19:00:00,91,186,8,14,657,524,133,12
6116,2022-09-12 20:00:00,132,262,14,11,501,377,124,6
6117,2022-09-12 21:00:00,92,160,11,14,694,605,89,5
6118,2022-09-12 22:00:00,70,204,7,10,686,521,165,6
6119,2022-09-12 23:00:00,55,261,12,19,625,460,165,10
6120,2022-09-13 00:00:00,65,129,10,18,769,625,144,7
6121,2022-09-13 01:00:00,76,139,14,14,611,486,125,9
6122,2022-09-13 02:00:00,131,251,5,19,736,587,149,9
6123,2022-09-13 03:00:00,53,164,9,10,632,499,133,8
6124,2022-09-13 04:00:00,94,205,11,18,571,474,97,14
6125,2022-09-13 05:00:00,137,198,13,19,693,522,171,9
6126,2022-09-13 06:00:00,120,158,12,16,557,452,105,6
6127,2022-09-13 07:00:00,76,154,10,16,715,591,124,8
6128,2022-09-13 08:00:00,61,152,11,12,759,665,94,8
6129,2022-09-13 09:00:00,71,137,11,11,574,487,87,14
6130,2022-09-13 10:00:00,56,243,14,14,566,509,57,12
6131,2022-09-13 11:00:00,120,267,5,16,769,672,97,6
6132,2022-09-13 12:00:00,149,138,7,18,748,655,93,11
6133,2022-09-13 13:00:00,107,147,7,14,575,462,113,13
6134,2022-09-13 14:00:00,69,191,8,12,788,603,185,10
6135,2022-09-13 15:00:00,51,227,9,15,570,482,88,8
6136,2022-09-13 16:00:00,131,188,14,16,577,425,152,7
6137,2022-09-13 17:00:00,56,112,8,16,725,615,110,13
6138,2022-09-13 18:00:00,84,155,12,17,775,582,193,10
6139,2022-09-13 19:00:00,116,135,9,11,790,650,140,10
6140,2022-09-13 20:00:00,95,262,5,17,639,485,154,9
6141,2022-09-13 21:00:00,144,101,7,19,739,532,207,6
6142,2022-09-13 22:00:00,83,105,14,17,505,364,141,13
6143,2022-09-13 23:00:00,76,127,5,11,697,509,188,5
6144,2022-09-14 00:00:00,110,195,14,16,648,577,71,12
6145,2022-09-14 01:00:00,109,220,6,16,774,650,124,9
6146,2022-09-14 02:00:00,110,296,6,18,600,433,167,13
6147,2022-09-14 03:00:00,96,139,8,13,544,475,69,9
6148,2022-09-14 04:00:00,53,201,13,10,548,487,61,14
6149,2022-09-14 05:00:00,83,109,13,13,742,630,112,14
6150,2022-09-14 06:00:00,135,205,12,17,792,712,80,13
6151,2022-09-14 07:00:00,104,197,14,17,619,439,180,11
6152,2022-09-14 08:00:00,74,182,10,10,657,489,168,13
6153,2022-09-14 09:00:00,52,225,11,12,766,605,161,5
6154,2022-09-14 10:00:00,57,268,12,16,694,576,118,10
6155,2022-09-14 11:00:00,99,141,5,14,576,423,153,5
6156,2022-09-14 12:00:00,66,127,5,13,723,593,130,14
6157,2022-09-14 13:00:00,140,133,14,17,684,522,162,8
6158,2022-09-14 14:00:00,147,219,13,15,537,391,146,7
6159,2022-09-14 15:00:00,112,224,9,12,622,446,176,11
6160,2022-09-14 16:00:00,66,126,6,11,501,373,128,13
6161,2022-09-14 17:00:00,101,155,10,17,639,546,93,9
6162,2022-09-14 18:00:00,71,259,11,14,527,455,72,6
6163,2022-09-14 19:00:00,112,214,13,13,618,457,161,5
6164,2022-09-14 20:00:00,104,163,5,13,694,590,104,10
6165,2022-09-14 21:00:00,94,200,8,17,569,476,93,13
6166,2022-09-14 22:00:00,137,191,5,15,558,453,105,11
6167,2022-09-14 23:00:00,135,166,5,17,723,567,156,7
6168,2022-09-15 00:00:00,65,298,5,15,611,459,152,8
6169,2022-09-15 01:00:00,59,131,8,10,561,420,141,11
6170,2022-09-15 02:00:00,145,263,7,13,549,414,135,14
6171,2022-09-15 03:00:00,117,202,6,16,750,537,213,11
6172,2022-09-15 04:00:00,69,157,13,18,510,431,79,10
6173,2022-09-15 05:00:00,107,289,9,17,543,442,101,12
6174,2022-09-15 06:00:00,123,280,6,11,761,557,204,11
6175,2022-09-15 07:00:00,111,230,8,11,617,552,65,14
6176,2022-09-15 08:00:00,104,205,6,19,702,604,98,13
6177,2022-09-15 09:00:00,118,135,12,11,564,501,63,9
6178,2022-09-15 10:00:00,132,179,8,16,648,504,144,11
6179,2022-09-15 11:00:00,55,286,11,16,523,391,132,12
6180,2022-09-15 12:00:00,95,280,12,10,638,558,80,5
6181,2022-09-15 13:00:00,82,134,13,14,506,405,101,9
6182,2022-09-15 14:00:00,54,118,7,11,504,354,150,14
6183,2022-09-15 15:00:00,116,189,6,16,537,472,65,14
6184,2022-09-15 16:00:00,131,247,6,18,518,432,86,7
6185,2022-09-15 17:00:00,75,267,9,16,542,448,94,12
6186,2022-09-15 18:00:00,127,237,10,13,744,641,103,14
6187,2022-09-15 19:00:00,98,286,11,19,634,449,185,10
6188,2022-09-15 20:00:00,142,164,10,13,612,503,109,12
6189,2022-09-15 21:00:00,89,272,10,11,617,525,92,7
6190,2022-09-15 22:00:00,139,117,10,19,684,531,153,10
6191,2022-09-15 23:00:00,126,237,5,10,744,604,140,5
6192,2022-09-16 00:00:00,121,236,13,12,795,562,233,5
6193,2022-09-16 01:00:00,76,121,5,14,712,559,153,10
6194,2022-09-16 02:00:00,125,139,11,11,688,527,161,12
6195,2022-09-16 03:00:00,83,259,7,11,669,472,197,6
6196,2022-09-16 04:00:00,54,235,10,10,725,533,192,7
6197,2022-09-16 05:00:00,112,226,11,12,617,529,88,13
6198,2022-09-16 06:00:00,76,223,10,17,672,489,183,8
6199,2022-09-16 07:00:00,53,141,10,15,540,424,116,9
6200,2022-09-16 08:00:00,143,284,7,17,760,601,159,11
6201,2022-09-16 09:00:00,149,156,14,13,704,565,139,12
6202,2022-09-16 10:00:00,87,162,14,10,677,580,97,13
6203,2022-09-16 11:00:00,120,199,12,16,781,582,199,13
6204,2022-09-16 12:00:00,82,265,7,11,759,644,115,14
6205,2022-09-16 13:00:00,90,266,9,14,552,447,105,5
6206,2022-09-16 14:00:00,56,249,13,18,611,446,165,10
6207,2022-09-16 15:00:00,80,106,14,14,631,478,153,14
6208,2022-09-16 16:00:00,122,295,13,19,775,603,172,11
6209,2022-09-16 17:00:00,133,274,11,14,551,489,62,5
6210,2022-09-16 18:00:00,51,230,12,18,781,605,176,7
6211,2022-09-16 19:00:00,138,235,14,11,707,572,135,14
6212,2022-09-16 20:00:00,85,188,9,11,558,405,153,14
6213,2022-09-16 21:00:00,87,189,10,10,759,534,225,13
6214,2022-09-16 22:00:00,129,116,8,17,506,418,88,9
6215,2022-09-16 23:00:00,138,193,13,10,734,587,147,10
6216,2022-09-17 00:00:00,120,122,9,18,748,658,90,6
6217,2022-09-17 01:00:00,118,106,12,15,600,516,84,8
6218,2022-09-17 02:00:00,124,200,7,11,638,554,84,8
6219,2022-09-17 03:00:00,72,244,7,10,672,576,96,7
6220,2022-09-17 04:00:00,94,181,5,16,511,453,58,9
6221,2022-09-17 05:00:00,103,126,8,17,561,483,78,12
6222,2022-09-17 06:00:00,145,155,14,18,550,464,86,7
6223,2022-09-17 07:00:00,103,258,5,16,614,449,165,7
6224,2022-09-17 08:00:00,137,237,9,16,756,554,202,12
6225,2022-09-17 09:00:00,107,122,13,15,571,466,105,7
6226,2022-09-17 10:00:00,114,189,6,17,653,498,155,6
6227,2022-09-17 11:00:00,120,285,13,10,570,485,85,14
6228,2022-09-17 12:00:00,69,261,11,17,749,647,102,6
6229,2022-09-17 13:00:00,81,177,9,14,693,490,203,5
6230,2022-09-17 14:00:00,124,142,8,14,660,545,115,7
6231,2022-09-17 15:00:00,105,257,5,15,620,532,88,6
6232,2022-09-17 16:00:00,78,133,9,12,560,468,92,5
6233,2022-09-17 17:00:00,148,123,5,15,630,552,78,11
6234,2022-09-17 18:00:00,115,289,11,11,753,529,224,9
6235,2022-09-17 19:00:00,137,293,11,18,702,508,194,8
6236,2022-09-17 20:00:00,137,297,14,18,771,549,222,6
6237,2022-09-17 21:00:00,101,223,9,18,716,591,125,13
6238,2022-09-17 22:00:00,131,130,14,10,546,430,116,12
6239,2022-09-17 23:00:00,101,256,12,11,685,591,94,12
6240,2022-09-18 00:00:00,96,124,10,15,799,600,199,8
6241,2022-09-18 01:00:00,118,157,9,14,664,583,81,9
6242,2022-09-18 02:00:00,71,235,5,14,796,692,104,12
6243,2022-09-18 03:00:00,80,100,7,13,765,606,159,13
6244,2022-09-18 04:00:00,67,136,5,15,698,536,162,12
6245,2022-09-18 05:00:00,78,180,14,19,562,481,81,11
6246,2022-09-18 06:00:00,140,181,10,14,529,432,97,11
6247,2022-09-18 07:00:00,141,243,5,11,538,390,148,7
6248,2022-09-18 08:00:00,100,100,12,13,666,527,139,13
6249,2022-09-18 09:00:00,94,138,13,17,742,600,142,9
6250,2022-09-18 10:00:00,114,272,14,18,712,627,85,13
6251,2022-09-18 11:00:00,147,265,8,10,572,478,94,11
6252,2022-09-18 12:00:00,60,166,12,15,553,392,161,11
6253,2022-09-18 13:00:00,51,227,9,13,507,430,77,5
6254,2022-09-18 14:00:00,134,126,5,14,527,449,78,10
6255,2022-09-18 15:00:00,71,195,8,16,587,479,108,8
6256,2022-09-18 16:00:00,76,116,10,13,516,405,111,6
6257,2022-09-18 17:00:00,119,193,6,18,552,428,124,6
6258,2022-09-18 18:00:00,85,147,9,19,542,467,75,5
6259,2022-09-18 19:00:00,83,282,7,19,599,495,104,10
6260,2022-09-18 20:00:00,149,211,5,18,703,589,114,10
6261,2022-09-18 21:00:00,77,259,5,19,633,467,166,9
6262,2022-09-18 22:00:00,53,248,11,12,581,499,82,9
6263,2022-09-18 23:00:00,147,277,5,17,715,609,106,10
6264,2022-09-19 00:00:00,134,251,13,16,690,543,147,6
6265,2022-09-19 01:00:00,64,113,12,15,618,502,116,8
6266,2022-09-19 02:00:00,108,182,11,14,650,574,76,12
6267,2022-09-19 03:00:00,106,268,13,13,650,517,133,9
6268,2022-09-19 04:00:00,147,176,12,19,549,423,126,10
6269,2022-09-19 05:00:00,112,212,9,16,603,461,142,11
6270,2022-09-19 06:00:00,95,246,6,18,649,486,163,6
6271,2022-09-19 07:00:00,127,243,10,18,586,448,138,7
6272,2022-09-19 08:00:00,78,223,5,15,634,454,180,6
6273,2022-09-19 09:00:00,121,265,12,17,788,572,216,10
6274,2022-09-19 10:00:00,123,222,6,13,728,573,155,5
6275,2022-09-19 11:00:00,76,165,12,12,531,412,119,12
6276,2022-09-19 12:00:00,89,125,10,15,614,463,151,14
6277,2022-09-19 13:00:00,57,103,5,16,567,466,101,10
6278,2022-09-19 14:00:00,79,174,12,12,789,700,89,8
6279,2022-09-19 15:00:00,59,236,13,13,652,529,123,14
6280,2022-09-19 16:00:00,113,233,10,10,714,615,99,13
6281,2022-09-19 17:00:00,123,221,13,19,633,534,99,11
6282,2022-09-19 18:00:00,107,187,8,18,688,581,107,14
6283,2022-09-19 19:00:00,98,231,7,10,625,472,153,13
6284,2022-09-19 20:00:00,98,268,13,15,549,425,124,10
6285,2022-09-19 21:00:00,83,247,14,17,743,531,212,6
6286,2022-09-19 22:00:00,97,150,13,15,779,686,93,11
6287,2022-09-19 23:00:00,73,114,8,13,605,441,164,7
6288,2022-09-20 00:00:00,84,154,10,10,793,695,98,6
6289,2022-09-20 01:00:00,110,124,13,17,548,409,139,8
6290,2022-09-20 02:00:00,86,214,9,12,567,507,60,8
6291,2022-09-20 03:00:00,148,185,11,14,539,423,116,14
6292,2022-09-20 04:00:00,95,154,11,15,753,607,146,11
6293,2022-09-20 05:00:00,122,291,7,16,631,549,82,11
6294,2022-09-20 06:00:00,122,142,12,16,795,691,104,7
6295,2022-09-20 07:00:00,98,244,13,16,606,474,132,12
6296,2022-09-20 08:00:00,72,210,6,17,703,551,152,9
6297,2022-09-20 09:00:00,121,108,11,14,583,502,81,13
6298,2022-09-20 10:00:00,138,148,12,14,622,558,64,5
6299,2022-09-20 11:00:00,80,216,10,13,790,705,85,11
6300,2022-09-20 12:00:00,138,276,5,16,633,511,122,14
6301,2022-09-20 13:00:00,132,293,11,16,734,613,121,6
6302,2022-09-20 14:00:00,89,116,7,15,511,382,129,5
6303,2022-09-20 15:00:00,96,236,14,12,635,477,158,9
6304,2022-09-20 16:00:00,118,167,12,15,623,553,70,6
6305,2022-09-20 17:00:00,107,127,14,16,597,502,95,12
6306,2022-09-20 18:00:00,131,121,6,16,687,492,195,7
6307,2022-09-20 19:00:00,50,284,11,11,654,585,69,9
6308,2022-09-20 20:00:00,70,111,10,17,534,480,54,12
6309,2022-09-20 21:00:00,56,269,9,18,519,381,138,8
6310,2022-09-20 22:00:00,110,272,8,19,788,575,213,5
6311,2022-09-20 23:00:00,131,181,9,12,597,466,131,14
6312,2022-09-21 00:00:00,140,111,8,11,511,432,79,12
6313,2022-09-21 01:00:00,145,151,5,19,787,619,168,13
6314,2022-09-21 02:00:00,67,296,6,12,678,601,77,11
6315,2022-09-21 03:00:00,59,232,14,12,568,435,133,8
6316,2022-09-21 04:00:00,51,192,11,17,556,473,83,12
6317,2022-09-21 05:00:00,55,167,14,15,734,593,141,10
6318,2022-09-21 06:00:00,70,143,5,10,573,491,82,8
6319,2022-09-21 07:00:00,121,204,5,17,771,621,150,11
6320,2022-09-21 08:00:00,78,221,6,19,501,442,59,9
6321,2022-09-21 09:00:00,56,243,5,17,684,505,179,14
6322,2022-09-21 10:00:00,96,183,13,10,748,663,85,14
6323,2022-09-21 11:00:00,108,121,5,11,784,569,215,12
6324,2022-09-21 12:00:00,62,277,11,17,789,613,176,8
6325,2022-09-21 13:00:00,106,233,10,19,799,595,204,5
6326,2022-09-21 14:00:00,60,103,10,10,713,531,182,6
6327,2022-09-21 15:00:00,71,259,14,10,572,504,68,5
6328,2022-09-21 16:00:00,76,103,10,15,655,578,77,14
6329,2022-09-21 17:00:00,74,185,13,10,717,517,200,8
6330,2022-09-21 18:00:00,146,113,14,11,665,554,111,14
6331,2022-09-21 19:00:00,95,159,10,14,617,467,150,7
6332,2022-09-21 20:00:00,126,106,13,19,614,514,100,11
6333,2022-09-21 21:00:00,50,248,8,12,644,578,66,14
6334,2022-09-21 22:00:00,111,298,9,17,792,572,220,6
6335,2022-09-21 23:00:00,64,214,12,14,732,547,185,13
6336,2022-09-22 00:00:00,98,280,7,19,635,482,153,14
6337,2022-09-22 01:00:00,145,244,10,11,645,574,71,10
6338,2022-09-22 02:00:00,64,298,7,13,707,578,129,13
6339,2022-09-22 03:00:00,60,160,6,19,546,423,123,8
6340,2022-09-22 04:00:00,61,207,13,16,579,405,174,14
6341,2022-09-22 05:00:00,74,112,9,16,544,425,119,10
6342,2022-09-22 06:00:00,66,267,12,16,656,527,129,9
6343,2022-09-22 07:00:00,54,275,5,17,733,573,160,11
6344,2022-09-22 08:00:00,135,222,5,14,708,525,183,6
6345,2022-09-22 09:00:00,144,180,5,17,677,557,120,10
6346,2022-09-22 10:00:00,52,163,7,18,782,613,169,12
6347,2022-09-22 11:00:00,60,149,6,12,740,530,210,12
6348,2022-09-22 12:00:00,94,101,10,10,769,672,97,9
6349,2022-09-22 13:00:00,111,127,8,12,564,406,158,10
6350,2022-09-22 14:00:00,71,116,5,12,555,478,77,7
6351,2022-09-22 15:00:00,59,245,12,11,747,618,129,10
6352,2022-09-22 16:00:00,146,120,6,14,562,486,76,10
6353,2022-09-22 17:00:00,84,137,7,19,534,391,143,7
6354,2022-09-22 18:00:00,95,190,12,17,532,433,99,6
6355,2022-09-22 19:00:00,52,204,13,12,591,507,84,6
6356,2022-09-22 20:00:00,77,289,13,14,692,551,141,8
6357,2022-09-22 21:00:00,125,107,9,16,527,446,81,10
6358,2022-09-22 22:00:00,111,294,11,17,766,664,102,12
6359,2022-09-22 23:00:00,146,125,6,15,566,405,161,9
6360,2022-09-23 00:00:00,86,226,7,15,503,356,147,8
6361,2022-09-23 01:00:00,101,267,10,14,641,507,134,13
6362,2022-09-23 02:00:00,109,252,14,19,748,587,161,6
6363,2022-09-23 03:00:00,129,186,14,14,728,566,162,5
6364,2022-09-23 04:00:00,65,253,8,19,726,647,79,5
6365,2022-09-23 05:00:00,61,211,7,17,506,379,127,6
6366,2022-09-23 06:00:00,57,103,10,11,586,443,143,11
6367,2022-09-23 07:00:00,124,276,12,10,575,501,74,6
6368,2022-09-23 08:00:00,125,190,14,18,618,524,94,11
6369,2022-09-23 09:00:00,51,140,9,17,651,555,96,6
6370,2022-09-23 10:00:00,74,273,5,11,715,591,124,6
6371,2022-09-23 11:00:00,98,199,12,15,776,650,126,6
6372,2022-09-23 12:00:00,90,295,8,10,573,408,165,10
6373,2022-09-23 13:00:00,77,163,7,12,693,587,106,5
6374,2022-09-23 14:00:00,104,210,12,11,559,447,112,11
6375,2022-09-23 15:00:00,52,254,7,15,590,523,67,7
6376,2022-09-23 16:00:00,99,185,9,10,588,478,110,5
6377,2022-09-23 17:00:00,79,275,8,18,526,462,64,12
6378,2022-09-23 18:00:00,65,227,8,11,774,603,171,10
6379,2022-09-23 19:00:00,59,262,5,14,542,434,108,6
6380,2022-09-23 20:00:00,100,192,7,17,509,386,123,14
6381,2022-09-23 21:00:00,74,267,8,13,586,497,89,10
6382,2022-09-23 22:00:00,138,202,11,11,609,456,153,6
6383,2022-09-23 23:00:00,88,194,11,18,679,485,194,8
6384,2022-09-24 00:00:00,51,132,6,16,781,621,160,14
6385,2022-09-24 01:00:00,82,100,14,15,724,643,81,11
6386,2022-09-24 02:00:00,105,152,10,10,567,508,59,14
6387,2022-09-24 03:00:00,96,234,8,16,762,615,147,12
6388,2022-09-24 04:00:00,144,217,8,10,767,617,150,5
6389,2022-09-24 05:00:00,97,248,10,11,646,532,114,14
6390,2022-09-24 06:00:00,87,242,10,16,537,461,76,12
6391,2022-09-24 07:00:00,81,280,10,19,578,504,74,5
6392,2022-09-24 08:00:00,98,199,9,10,597,494,103,8
6393,2022-09-24 09:00:00,117,199,11,17,610,545,65,10
6394,2022-09-24 10:00:00,59,281,7,19,666,469,197,11
6395,2022-09-24 11:00:00,87,128,11,13,644,474,170,14
6396,2022-09-24 12:00:00,124,213,13,12,655,497,158,6
6397,2022-09-24 13:00:00,81,259,9,12,612,534,78,13
6398,2022-09-24 14:00:00,61,115,7,19,797,597,200,10
6399,2022-09-24 15:00:00,66,141,13,18,766,684,82,11
6400,2022-09-24 16:00:00,79,198,9,14,610,538,72,13
6401,2022-09-24 17:00:00,114,145,8,15,542,392,150,9
6402,2022-09-24 18:00:00,138,264,6,14,591,454,137,11
6403,2022-09-24 19:00:00,98,171,7,19,688,588,100,11
6404,2022-09-24 20:00:00,97,274,8,17,731,596,135,14
6405,2022-09-24 21:00:00,74,189,14,11,791,600,191,13
6406,2022-09-24 22:00:00,117,149,6,13,636,571,65,5
6407,2022-09-24 23:00:00,50,294,11,15,571,429,142,14
6408,2022-09-25 00:00:00,74,217,8,10,593,425,168,12
6409,2022-09-25 01:00:00,146,293,14,15,691,495,196,5
6410,2022-09-25 02:00:00,131,270,5,18,546,404,142,10
6411,2022-09-25 03:00:00,66,150,11,15,620,499,121,12
6412,2022-09-25 04:00:00,88,294,8,13,784,613,171,10
6413,2022-09-25 05:00:00,62,161,14,13,695,602,93,9
6414,2022-09-25 06:00:00,139,276,8,12,727,615,112,12
6415,2022-09-25 07:00:00,94,256,5,11,532,379,153,14
6416,2022-09-25 08:00:00,65,112,12,15,705,494,211,13
6417,2022-09-25 09:00:00,59,221,7,18,784,705,79,14
6418,2022-09-25 10:00:00,85,210,6,19,779,677,102,14
6419,2022-09-25 11:00:00,102,157,9,15,559,459,100,12
6420,2022-09-25 12:00:00,146,292,10,13,714,528,186,11
6421,2022-09-25 13:00:00,114,140,10,13,635,456,179,12
6422,2022-09-25 14:00:00,96,130,12,19,635,456,179,9
6423,2022-09-25 15:00:00,133,237,6,19,708,536,172,9
6424,2022-09-25 16:00:00,76,230,5,17,683,604,79,6
6425,2022-09-25 17:00:00,132,235,10,12,760,560,200,11
6426,2022-09-25 18:00:00,55,107,12,12,742,575,167,11
6427,2022-09-25 19:00:00,117,196,13,18,701,497,204,5
6428,2022-09-25 20:00:00,145,224,10,16,733,611,122,11
6429,2022-09-25 21:00:00,83,176,14,16,643,574,69,8
6430,2022-09-25 22:00:00,119,258,10,19,608,526,82,7
6431,2022-09-25 23:00:00,107,176,9,19,577,508,69,6
6432,2022-09-26 00:00:00,101,107,12,14,658,469,189,13
6433,2022-09-26 01:00:00,100,219,8,11,555,407,148,9
6434,2022-09-26 02:00:00,136,122,12,14,641,457,184,12
6435,2022-09-26 03:00:00,58,258,10,10,764,635,129,11
6436,2022-09-26 04:00:00,71,198,10,18,732,573,159,5
6437,2022-09-26 05:00:00,69,119,8,10,797,577,220,8
6438,2022-09-26 06:00:00,118,193,14,19,513,367,146,7
6439,2022-09-26 07:00:00,77,142,6,19,643,463,180,11
6440,2022-09-26 08:00:00,125,134,11,19,563,448,115,14
6441,2022-09-26 09:00:00,53,237,8,14,704,599,105,9
6442,2022-09-26 10:00:00,67,124,12,15,736,563,173,13
6443,2022-09-26 11:00:00,142,247,8,14,637,544,93,5
6444,2022-09-26 12:00:00,60,130,6,14,708,614,94,10
6445,2022-09-26 13:00:00,110,154,8,19,746,544,202,13
6446,2022-09-26 14:00:00,58,234,11,11,774,682,92,14
6447,2022-09-26 15:00:00,61,186,5,18,674,565,109,10
6448,2022-09-26 16:00:00,78,121,7,18,541,480,61,11
6449,2022-09-26 17:00:00,149,180,9,13,509,418,91,12
6450,2022-09-26 18:00:00,98,161,12,13,686,518,168,7
6451,2022-09-26 19:00:00,76,110,6,12,522,390,132,14
6452,2022-09-26 20:00:00,72,156,11,14,552,408,144,7
6453,2022-09-26 21:00:00,87,286,9,15,591,475,116,9
6454,2022-09-26 22:00:00,68,279,13,17,643,498,145,7
6455,2022-09-26 23:00:00,64,237,6,18,777,627,150,13
6456,2022-09-27 00:00:00,117,187,9,14,569,453,116,7
6457,2022-09-27 01:00:00,147,165,9,15,761,654,107,8
6458,2022-09-27 02:00:00,134,163,8,13,713,534,179,9
6459,2022-09-27 03:00:00,108,212,8,19,558,474,84,11
6460,2022-09-27 04:00:00,144,256,13,12,793,567,226,6
6461,2022-09-27 05:00:00,143,253,6,13,650,498,152,11
6462,2022-09-27 06:00:00,106,234,11,18,734,590,144,8
6463,2022-09-27 07:00:00,50,186,6,12,687,482,205,7
6464,2022-09-27 08:00:00,137,113,8,10,678,499,179,5
6465,2022-09-27 09:00:00,67,189,13,11,725,530,195,8
6466,2022-09-27 10:00:00,91,181,10,14,587,516,71,12
6467,2022-09-27 11:00:00,80,187,7,16,724,631,93,12
6468,2022-09-27 12:00:00,111,184,9,16,737,570,167,6
6469,2022-09-27 13:00:00,52,287,7,17,666,478,188,9
6470,2022-09-27 14:00:00,51,251,8,15,557,487,70,10
6471,2022-09-27 15:00:00,149,187,11,13,580,406,174,13
6472,2022-09-27 16:00:00,122,256,14,13,589,422,167,11
6473,2022-09-27 17:00:00,58,180,12,12,506,367,139,8
6474,2022-09-27 18:00:00,73,157,6,12,746,662,84,7
6475,2022-09-27 19:00:00,85,117,11,10,505,383,122,11
6476,2022-09-27 20:00:00,123,140,11,18,515,380,135,13
6477,2022-09-27 21:00:00,87,125,7,13,723,511,212,9
6478,2022-09-27 22:00:00,106,265,11,13,558,465,93,13
6479,2022-09-27 23:00:00,123,276,7,11,636,557,79,13
6480,2022-09-28 00:00:00,115,170,8,18,651,523,128,6
6481,2022-09-28 01:00:00,146,286,10,13,549,448,101,13
6482,2022-09-28 02:00:00,133,213,5,17,673,585,88,11
6483,2022-09-28 03:00:00,92,141,5,18,788,646,142,10
6484,2022-09-28 04:00:00,105,238,6,12,644,536,108,13
6485,2022-09-28 05:00:00,75,158,6,17,577,441,136,10
6486,2022-09-28 06:00:00,57,239,13,14,558,479,79,14
6487,2022-09-28 07:00:00,125,143,5,11,509,392,117,11
6488,2022-09-28 08:00:00,88,265,5,12,518,455,63,7
6489,2022-09-28 09:00:00,110,219,13,15,616,479,137,7
6490,2022-09-28 10:00:00,76,214,9,11,696,566,130,13
6491,2022-09-28 11:00:00,114,291,6,17,537,448,89,6
6492,2022-09-28 12:00:00,128,130,9,19,593,505,88,11
6493,2022-09-28 13:00:00,71,191,5,18,668,571,97,9
6494,2022-09-28 14:00:00,137,122,12,14,510,452,58,6
6495,2022-09-28 15:00:00,147,168,7,10,661,563,98,10
6496,2022-09-28 16:00:00,87,197,13,14,755,654,101,8
6497,2022-09-28 17:00:00,92,244,11,10,602,515,87,9
6498,2022-09-28 18:00:00,63,177,8,10,758,580,178,11
6499,2022-09-28 19:00:00,93,177,8,12,597,469,128,7
6500,2022-09-28 20:00:00,128,135,5,10,599,477,122,8
6501,2022-09-28 21:00:00,60,155,14,19,622,535,87,5
6502,2022-09-28 22:00:00,128,174,9,17,640,529,111,14
6503,2022-09-28 23:00:00,108,251,12,12,716,572,144,14
6504,2022-09-29 00:00:00,70,299,8,19,796,684,112,8
6505,2022-09-29 01:00:00,123,184,6,14,581,451,130,13
6506,2022-09-29 02:00:00,73,263,10,18,758,669,89,9
6507,2022-09-29 03:00:00,96,121,6,14,508,357,151,14
6508,2022-09-29 04:00:00,83,126,10,19,503,405,98,9
6509,2022-09-29 05:00:00,88,116,12,18,545,470,75,12
6510,2022-09-29 06:00:00,89,213,7,12,700,504,196,14
6511,2022-09-29 07:00:00,124,106,7,10,574,405,169,8
6512,2022-09-29 08:00:00,104,244,13,11,531,385,146,10
6513,2022-09-29 09:00:00,148,297,6,15,724,631,93,10
6514,2022-09-29 10:00:00,68,174,14,11,786,588,198,12
6515,2022-09-29 11:00:00,56,242,5,11,573,404,169,6
6516,2022-09-29 12:00:00,145,292,14,19,606,438,168,8
6517,2022-09-29 13:00:00,100,100,11,11,634,499,135,10
6518,2022-09-29 14:00:00,120,186,6,10,674,499,175,12
6519,2022-09-29 15:00:00,60,298,11,18,567,457,110,10
6520,2022-09-29 16:00:00,83,136,13,12,691,516,175,8
6521,2022-09-29 17:00:00,98,220,5,10,648,461,187,10
6522,2022-09-29 18:00:00,127,105,7,14,696,520,176,5
6523,2022-09-29 19:00:00,74,272,6,13,508,448,60,11
6524,2022-09-29 20:00:00,58,263,6,18,538,439,99,10
6525,2022-09-29 21:00:00,146,283,13,17,619,479,140,7
6526,2022-09-29 22:00:00,121,255,5,11,576,469,107,13
6527,2022-09-29 23:00:00,71,175,12,11,796,599,197,13
6528,2022-09-30 00:00:00,118,285,10,11,715,600,115,9
6529,2022-09-30 01:00:00,107,114,13,18,694,486,208,13
6530,2022-09-30 02:00:00,64,235,7,17,521,387,134,6
6531,2022-09-30 03:00:00,53,275,11,13,661,519,142,11
6532,2022-09-30 04:00:00,146,258,13,16,612,546,66,12
6533,2022-09-30 05:00:00,128,198,11,10,700,555,145,14
6534,2022-09-30 06:00:00,54,279,11,15,587,519,68,9
6535,2022-09-30 07:00:00,118,175,5,19,771,571,200,9
6536,2022-09-30 08:00:00,128,288,8,13,516,432,84,13
6537,2022-09-30 09:00:00,89,210,14,18,524,418,106,11
6538,2022-09-30 10:00:00,66,180,10,13,590,515,75,11
6539,2022-09-30 11:00:00,101,205,9,11,714,582,132,8
6540,2022-09-30 12:00:00,105,163,11,11,529,404,125,10
6541,2022-09-30 13:00:00,111,166,5,11,717,571,146,8
6542,2022-09-30 14:00:00,71,217,7,11,712,602,110,10
6543,2022-09-30 15:00:00,105,274,8,10,640,556,84,6
6544,2022-09-30 16:00:00,148,256,5,16,639,542,97,5
6545,2022-09-30 17:00:00,67,200,11,19,582,511,71,14
6546,2022-09-30 18:00:00,99,288,5,15,615,530,85,6
6547,2022-09-30 19:00:00,67,175,13,18,797,564,233,13
6548,2022-09-30 20:00:00,125,175,14,10,560,460,100,9
6549,2022-09-30 21:00:00,125,200,9,16,693,534,159,14
6550,2022-09-30 22:00:00,144,203,10,19,721,641,80,14
6551,2022-09-30 23:00:00,132,171,8,16,534,402,132,6
6552,2022-10-01 00:00:00,79,250,5,15,528,434,94,14
6553,2022-10-01 01:00:00,92,124,7,12,526,381,145,14
6554,2022-10-01 02:00:00,120,291,10,11,516,458,58,9
6555,2022-10-01 03:00:00,82,274,7,15,637,452,185,13
6556,2022-10-01 04:00:00,106,102,9,19,652,561,91,13
6557,2022-10-01 05:00:00,104,103,8,17,762,571,191,9
6558,2022-10-01 06:00:00,93,203,12,19,511,437,74,11
6559,2022-10-01 07:00:00,87,204,6,10,759,605,154,9
6560,2022-10-01 08:00:00,121,273,5,11,593,424,169,12
6561,2022-10-01 09:00:00,125,176,5,11,565,468,97,5
6562,2022-10-01 10:00:00,87,220,8,12,591,431,160,10
6563,2022-10-01 11:00:00,143,200,10,14,712,607,105,6
6564,2022-10-01 12:00:00,84,133,10,13,725,512,213,5
6565,2022-10-01 13:00:00,67,191,5,14,514,386,128,14
6566,2022-10-01 14:00:00,95,194,11,11,704,540,164,9
6567,2022-10-01 15:00:00,75,175,11,17,708,532,176,8
6568,2022-10-01 16:00:00,110,268,9,10,728,568,160,6
6569,2022-10-01 17:00:00,75,181,6,13,574,479,95,7
6570,2022-10-01 18:00:00,50,212,7,16,624,498,126,5
6571,2022-10-01 19:00:00,88,292,7,18,654,573,81,11
6572,2022-10-01 20:00:00,137,236,14,17,796,691,105,8
6573,2022-10-01 21:00:00,69,197,14,14,633,508,125,10
6574,2022-10-01 22:00:00,118,280,11,15,770,548,222,6
6575,2022-10-01 23:00:00,83,152,11,14,615,460,155,10
6576,2022-10-02 00:00:00,94,155,6,15,694,615,79,9
6577,2022-10-02 01:00:00,55,199,10,17,720,611,109,13
6578,2022-10-02 02:00:00,94,271,8,14,502,427,75,11
6579,2022-10-02 03:00:00,85,194,8,10,741,569,172,8
6580,2022-10-02 04:00:00,131,295,7,14,761,656,105,6
6581,2022-10-02 05:00:00,134,274,13,15,731,601,130,7
6582,2022-10-02 06:00:00,130,159,8,18,584,419,165,9
6583,2022-10-02 07:00:00,65,198,11,13,571,510,61,14
6584,2022-10-02 08:00:00,65,110,13,13,532,456,76,7
6585,2022-10-02 09:00:00,54,148,8,11,697,502,195,9
6586,2022-10-02 10:00:00,64,144,10,11,707,497,210,14
6587,2022-10-02 11:00:00,85,180,5,11,648,549,99,9
6588,2022-10-02 12:00:00,77,191,13,16,506,373,133,12
6589,2022-10-02 13:00:00,108,121,5,10,710,497,213,8
6590,2022-10-02 14:00:00,132,169,8,18,573,412,161,6
6591,2022-10-02 15:00:00,96,241,9,18,524,404,120,12
6592,2022-10-02 16:00:00,104,135,7,13,650,498,152,9
6593,2022-10-02 17:00:00,69,299,12,18,731,569,162,7
6594,2022-10-02 18:00:00,74,259,14,17,524,402,122,13
6595,2022-10-02 19:00:00,106,283,10,18,772,676,96,12
6596,2022-10-02 20:00:00,53,164,9,17,511,449,62,8
6597,2022-10-02 21:00:00,106,179,13,19,782,566,216,7
6598,2022-10-02 22:00:00,127,286,9,11,515,426,89,9
6599,2022-10-02 23:00:00,60,224,14,18,670,524,146,10
6600,2022-10-03 00:00:00,118,118,7,18,643,566,77,6
6601,2022-10-03 01:00:00,62,214,6,13,581,413,168,13
6602,2022-10-03 02:00:00,57,248,11,12,749,667,82,11
6603,2022-10-03 03:00:00,100,223,13,14,601,515,86,7
6604,2022-10-03 04:00:00,112,150,14,13,543,478,65,13
6605,2022-10-03 05:00:00,128,168,8,14,698,552,146,10
6606,2022-10-03 06:00:00,144,105,12,19,630,509,121,6
6607,2022-10-03 07:00:00,111,161,5,13,565,505,60,10
6608,2022-10-03 08:00:00,91,161,11,14,567,496,71,6
6609,2022-10-03 09:00:00,132,249,13,13,616,512,104,7
6610,2022-10-03 10:00:00,110,201,11,16,513,460,53,13
6611,2022-10-03 11:00:00,80,262,8,16,753,629,124,6
6612,2022-10-03 12:00:00,103,290,10,15,577,462,115,14
6613,2022-10-03 13:00:00,118,106,9,18,786,641,145,5
6614,2022-10-03 14:00:00,131,114,7,12,601,461,140,11
6615,2022-10-03 15:00:00,132,281,9,15,615,492,123,11
6616,2022-10-03 16:00:00,103,251,10,18,755,590,165,8
6617,2022-10-03 17:00:00,53,210,6,19,517,383,134,14
6618,2022-10-03 18:00:00,73,276,6,14,587,421,166,5
6619,2022-10-03 19:00:00,140,127,12,10,614,482,132,7
6620,2022-10-03 20:00:00,67,151,6,15,741,589,152,7
6621,2022-10-03 21:00:00,67,129,12,11,522,407,115,6
6622,2022-10-03 22:00:00,110,286,14,19,789,640,149,7
6623,2022-10-03 23:00:00,80,119,11,13,753,529,224,13
6624,2022-10-04 00:00:00,100,245,11,11,529,467,62,5
6625,2022-10-04 01:00:00,64,238,11,12,567,439,128,10
6626,2022-10-04 02:00:00,97,195,8,13,568,493,75,12
6627,2022-10-04 03:00:00,78,125,10,14,564,450,114,13
6628,2022-10-04 04:00:00,86,229,5,11,696,609,87,8
6629,2022-10-04 05:00:00,115,142,14,17,595,493,102,9
6630,2022-10-04 06:00:00,127,267,10,17,721,582,139,9
6631,2022-10-04 07:00:00,52,120,8,16,641,512,129,11
6632,2022-10-04 08:00:00,116,216,12,13,597,451,146,7
6633,2022-10-04 09:00:00,144,194,7,11,771,627,144,8
6634,2022-10-04 10:00:00,135,290,11,18,730,540,190,11
6635,2022-10-04 11:00:00,137,246,8,12,560,415,145,13
6636,2022-10-04 12:00:00,108,139,13,19,795,692,103,10
6637,2022-10-04 13:00:00,130,252,12,11,670,587,83,8
6638,2022-10-04 14:00:00,90,221,5,16,678,507,171,11
6639,2022-10-04 15:00:00,102,100,13,19,699,613,86,14
6640,2022-10-04 16:00:00,138,215,14,11,655,513,142,10
6641,2022-10-04 17:00:00,129,201,13,10,776,653,123,6
6642,2022-10-04 18:00:00,142,163,12,12,689,603,86,9
6643,2022-10-04 19:00:00,65,226,14,14,560,474,86,6
6644,2022-10-04 20:00:00,139,191,8,12,760,566,194,10
6645,2022-10-04 21:00:00,113,165,11,19,757,634,123,12
6646,2022-10-04 22:00:00,50,138,7,17,673,591,82,10
6647,2022-10-04 23:00:00,67,226,6,14,583,497,86,11
6648,2022-10-05 00:00:00,82,203,12,18,681,505,176,12
6649,2022-10-05 01:00:00,86,171,14,10,739,534,205,13
6650,2022-10-05 02:00:00,136,285,5,16,572,450,122,12
6651,2022-10-05 03:00:00,86,256,13,17,676,596,80,13
6652,2022-10-05 04:00:00,62,186,14,11,705,534,171,6
6653,2022-10-05 05:00:00,98,280,11,16,799,639,160,6
6654,2022-10-05 06:00:00,88,230,14,15,513,381,132,11
6655,2022-10-05 07:00:00,86,184,10,10,577,425,152,8
6656,2022-10-05 08:00:00,54,172,6,11,678,520,158,8
6657,2022-10-05 09:00:00,56,219,10,17,735,589,146,5
6658,2022-10-05 10:00:00,132,200,7,14,775,544,231,8
6659,2022-10-05 11:00:00,85,192,7,17,717,602,115,12
6660,2022-10-05 12:00:00,72,180,11,18,732,605,127,8
6661,2022-10-05 13:00:00,80,209,9,11,535,434,101,5
6662,2022-10-05 14:00:00,110,279,6,19,690,527,163,9
6663,2022-10-05 15:00:00,100,103,6,11,542,441,101,12
6664,2022-10-05 16:00:00,92,107,14,16,756,590,166,10
6665,2022-10-05 17:00:00,109,250,12,10,541,409,132,8
6666,2022-10-05 18:00:00,84,234,12,12,775,620,155,13
6667,2022-10-05 19:00:00,132,140,5,19,597,461,136,12
6668,2022-10-05 20:00:00,132,218,14,10,762,565,197,12
6669,2022-10-05 21:00:00,64,103,10,13,570,418,152,7
6670,2022-10-05 22:00:00,129,139,5,17,548,390,158,5
6671,2022-10-05 23:00:00,63,208,14,13,645,473,172,8
6672,2022-10-06 00:00:00,69,159,6,10,756,554,202,13
6673,2022-10-06 01:00:00,89,264,7,15,714,522,192,7
6674,2022-10-06 02:00:00,91,273,6,12,538,454,84,12
6675,2022-10-06 03:00:00,128,158,6,19,786,649,137,13
6676,2022-10-06 04:00:00,142,136,9,12,735,576,159,5
6677,2022-10-06 05:00:00,128,288,8,12,749,535,214,10
6678,2022-10-06 06:00:00,131,110,11,16,637,522,115,5
6679,2022-10-06 07:00:00,92,222,14,17,691,533,158,7
6680,2022-10-06 08:00:00,90,273,5,13,760,628,132,5
6681,2022-10-06 09:00:00,118,262,12,10,587,491,96,6
6682,2022-10-06 10:00:00,53,269,8,12,519,429,90,9
6683,2022-10-06 11:00:00,62,297,11,11,758,635,123,14
6684,2022-10-06 12:00:00,66,287,9,19,739,532,207,12
6685,2022-10-06 13:00:00,81,168,11,15,505,386,119,6
6686,2022-10-06 14:00:00,145,232,9,19,741,612,129,12
6687,2022-10-06 15:00:00,141,138,13,15,771,610,161,10
6688,2022-10-06 16:00:00,75,113,12,19,651,513,138,6
6689,2022-10-06 17:00:00,79,146,10,14,559,402,157,10
6690,2022-10-06 18:00:00,129,158,11,10,572,476,96,13
6691,2022-10-06 19:00:00,83,135,11,14,581,488,93,10
6692,2022-10-06 20:00:00,118,225,14,14,587,504,83,6
6693,2022-10-06 21:00:00,85,161,5,15,730,642,88,12
6694,2022-10-06 22:00:00,80,200,12,18,552,420,132,6
6695,2022-10-06 23:00:00,85,287,10,15,575,445,130,11
6696,2022-10-07 00:00:00,129,259,7,10,508,388,120,9
6697,2022-10-07 01:00:00,60,193,7,16,626,532,94,8
6698,2022-10-07 02:00:00,149,196,13,19,720,610,110,13
6699,2022-10-07 03:00:00,117,269,13,11,760,596,164,6
6700,2022-10-07 04:00:00,56,281,14,10,628,503,125,14
6701,2022-10-07 05:00:00,124,136,11,15,616,486,130,13
6702,2022-10-07 06:00:00,126,212,13,13,782,559,223,14
6703,2022-10-07 07:00:00,125,280,6,19,579,495,84,8
6704,2022-10-07 08:00:00,88,272,8,10,520,411,109,9
6705,2022-10-07 09:00:00,110,272,6,11,625,528,97,10
6706,2022-10-07 10:00:00,72,295,8,15,514,365,149,6
6707,2022-10-07 11:00:00,69,180,6,19,559,428,131,11
6708,2022-10-07 12:00:00,113,101,13,15,787,611,176,5
6709,2022-10-07 13:00:00,131,296,9,19,513,362,151,10
6710,2022-10-07 14:00:00,132,265,11,16,739,576,163,10
6711,2022-10-07 15:00:00,103,113,11,18,644,570,74,10
6712,2022-10-07 16:00:00,102,258,12,10,563,398,165,6
6713,2022-10-07 17:00:00,74,153,8,12,778,557,221,13
6714,2022-10-07 18:00:00,77,184,12,14,678,519,159,6
6715,2022-10-07 19:00:00,93,235,8,13,795,685,110,8
6716,2022-10-07 20:00:00,132,276,14,16,783,656,127,7
6717,2022-10-07 21:00:00,134,153,13,12,627,558,69,10
6718,2022-10-07 22:00:00,133,253,12,10,573,401,172,7
6719,2022-10-07 23:00:00,61,167,9,16,761,675,86,5
6720,2022-10-08 00:00:00,105,237,13,10,686,500,186,9
6721,2022-10-08 01:00:00,96,233,9,17,637,446,191,9
6722,2022-10-08 02:00:00,76,116,5,16,557,490,67,13
6723,2022-10-08 03:00:00,120,286,5,12,535,441,94,8
6724,2022-10-08 04:00:00,139,283,7,12,588,468,120,6
6725,2022-10-08 05:00:00,105,160,11,16,635,518,117,13
6726,2022-10-08 06:00:00,63,149,13,14,584,471,113,14
6727,2022-10-08 07:00:00,127,197,9,15,730,649,81,12
6728,2022-10-08 08:00:00,126,154,11,12,635,564,71,12
6729,2022-10-08 09:00:00,77,108,6,10,516,404,112,7
6730,2022-10-08 10:00:00,144,157,5,15,731,524,207,5
6731,2022-10-08 11:00:00,67,298,5,18,600,437,163,13
6732,2022-10-08 12:00:00,121,125,12,19,795,557,238,7
6733,2022-10-08 13:00:00,134,195,6,10,598,428,170,14
6734,2022-10-08 14:00:00,60,209,11,19,522,459,63,7
6735,2022-10-08 15:00:00,122,274,10,18,757,549,208,12
6736,2022-10-08 16:00:00,88,270,8,15,785,589,196,6
6737,2022-10-08 17:00:00,92,292,14,14,657,586,71,13
6738,2022-10-08 18:00:00,59,187,8,14,622,469,153,6
6739,2022-10-08 19:00:00,143,145,5,12,652,525,127,5
6740,2022-10-08 20:00:00,86,268,10,10,556,490,66,12
6741,2022-10-08 21:00:00,148,202,11,13,773,614,159,9
6742,2022-10-08 22:00:00,84,186,11,12,625,478,147,13
6743,2022-10-08 23:00:00,133,182,6,12,559,479,80,9
6744,2022-10-09 00:00:00,84,292,14,10,751,620,131,9
6745,2022-10-09 01:00:00,90,225,6,19,682,611,71,7
6746,2022-10-09 02:00:00,95,273,12,12,734,611,123,14
6747,2022-10-09 03:00:00,104,118,14,13,608,465,143,7
6748,2022-10-09 04:00:00,117,173,5,16,760,545,215,14
6749,2022-10-09 05:00:00,51,204,12,10,713,626,87,8
6750,2022-10-09 06:00:00,55,252,5,19,740,655,85,8
6751,2022-10-09 07:00:00,64,267,11,19,768,656,112,11
6752,2022-10-09 08:00:00,110,193,8,11,603,515,88,10
6753,2022-10-09 09:00:00,118,275,13,10,638,462,176,12
6754,2022-10-09 10:00:00,82,266,5,12,532,422,110,10
6755,2022-10-09 11:00:00,140,186,8,16,706,612,94,5
6756,2022-10-09 12:00:00,77,114,10,14,537,409,128,6
6757,2022-10-09 13:00:00,83,125,5,17,531,391,140,8
6758,2022-10-09 14:00:00,67,213,10,12,602,442,160,13
6759,2022-10-09 15:00:00,102,116,9,10,509,409,100,5
6760,2022-10-09 16:00:00,83,151,12,11,716,557,159,11
6761,2022-10-09 17:00:00,139,279,11,10,534,471,63,10
6762,2022-10-09 18:00:00,94,133,10,16,678,569,109,14
6763,2022-10-09 19:00:00,92,281,10,11,613,543,70,8
6764,2022-10-09 20:00:00,117,171,5,12,690,545,145,14
6765,2022-10-09 21:00:00,95,108,14,19,625,515,110,7
6766,2022-10-09 22:00:00,109,164,9,16,681,521,160,6
6767,2022-10-09 23:00:00,133,212,10,10,589,471,118,12
6768,2022-10-10 00:00:00,88,136,9,17,681,493,188,11
6769,2022-10-10 01:00:00,64,276,9,12,731,550,181,10
6770,2022-10-10 02:00:00,85,121,10,15,563,452,111,12
6771,2022-10-10 03:00:00,134,218,5,14,722,627,95,9
6772,2022-10-10 04:00:00,139,264,5,14,610,480,130,8
6773,2022-10-10 05:00:00,51,175,13,18,570,401,169,6
6774,2022-10-10 06:00:00,50,152,7,18,534,436,98,13
6775,2022-10-10 07:00:00,54,174,14,13,571,415,156,11
6776,2022-10-10 08:00:00,115,175,7,14,624,488,136,5
6777,2022-10-10 09:00:00,120,143,5,16,639,518,121,6
6778,2022-10-10 10:00:00,79,204,7,19,539,390,149,11
6779,2022-10-10 11:00:00,118,131,10,19,619,522,97,9
6780,2022-10-10 12:00:00,76,136,11,16,665,467,198,10
6781,2022-10-10 13:00:00,51,206,5,15,698,597,101,8
6782,2022-10-10 14:00:00,112,272,11,15,641,468,173,6
6783,2022-10-10 15:00:00,99,206,12,15,580,498,82,7
6784,2022-10-10 16:00:00,97,149,12,16,606,507,99,11
6785,2022-10-10 17:00:00,80,216,8,14,621,472,149,13
6786,2022-10-10 18:00:00,112,134,12,19,586,441,145,12
6787,2022-10-10 19:00:00,107,190,12,15,775,669,106,9
6788,2022-10-10 20:00:00,106,265,6,11,714,573,141,8
6789,2022-10-10 21:00:00,101,229,12,18,523,390,133,13
6790,2022-10-10 22:00:00,50,234,13,10,618,460,158,8
6791,2022-10-10 23:00:00,139,103,9,16,556,442,114,12
6792,2022-10-11 00:00:00,83,170,11,11,797,590,207,13
6793,2022-10-11 01:00:00,146,281,7,12,524,375,149,11
6794,2022-10-11 02:00:00,136,245,8,17,524,373,151,6
6795,2022-10-11 03:00:00,146,197,13,19,708,592,116,5
6796,2022-10-11 04:00:00,130,201,7,16,760,604,156,8
6797,2022-10-11 05:00:00,118,149,8,15,710,514,196,13
6798,2022-10-11 06:00:00,70,195,5,14,532,434,98,11
6799,2022-10-11 07:00:00,119,234,5,16,630,504,126,11
6800,2022-10-11 08:00:00,77,201,13,12,545,459,86,11
6801,2022-10-11 09:00:00,103,277,9,10,636,539,97,12
6802,2022-10-11 10:00:00,54,290,11,17,695,528,167,6
6803,2022-10-11 11:00:00,80,205,8,11,576,429,147,12
6804,2022-10-11 12:00:00,53,120,6,16,500,449,51,7
6805,2022-10-11 13:00:00,53,121,7,18,796,666,130,12
6806,2022-10-11 14:00:00,88,252,9,10,759,535,224,6
6807,2022-10-11 15:00:00,137,118,9,13,518,451,67,6
6808,2022-10-11 16:00:00,71,285,13,11,709,543,166,13
6809,2022-10-11 17:00:00,137,159,6,19,528,443,85,8
6810,2022-10-11 18:00:00,110,169,13,14,791,664,127,7
6811,2022-10-11 19:00:00,51,235,11,12,765,610,155,7
6812,2022-10-11 20:00:00,110,210,10,13,657,520,137,12
6813,2022-10-11 21:00:00,95,247,13,17,562,476,86,11
6814,2022-10-11 22:00:00,110,113,14,18,601,463,138,5
6815,2022-10-11 23:00:00,76,204,14,14,690,548,142,11
6816,2022-10-12 00:00:00,75,183,13,11,648,510,138,7
6817,2022-10-12 01:00:00,51,134,10,17,555,498,57,10
6818,2022-10-12 02:00:00,135,180,12,11,669,536,133,5
6819,2022-10-12 03:00:00,92,149,8,10,748,635,113,8
6820,2022-10-12 04:00:00,121,284,6,13,711,554,157,11
6821,2022-10-12 05:00:00,92,107,11,15,663,559,104,7
6822,2022-10-12 06:00:00,87,135,11,18,696,573,123,8
6823,2022-10-12 07:00:00,101,151,8,11,689,529,160,6
6824,2022-10-12 08:00:00,57,268,12,13,772,655,117,14
6825,2022-10-12 09:00:00,52,118,11,12,510,391,119,10
6826,2022-10-12 10:00:00,75,244,8,19,663,590,73,8
6827,2022-10-12 11:00:00,96,289,13,19,640,547,93,14
6828,2022-10-12 12:00:00,91,198,14,15,545,435,110,6
6829,2022-10-12 13:00:00,109,135,8,11,517,431,86,14
6830,2022-10-12 14:00:00,66,283,11,12,661,524,137,8
6831,2022-10-12 15:00:00,79,293,9,16,603,451,152,6
6832,2022-10-12 16:00:00,127,109,11,12,753,617,136,12
6833,2022-10-12 17:00:00,77,289,6,11,694,578,116,13
6834,2022-10-12 18:00:00,93,152,13,10,737,623,114,10
6835,2022-10-12 19:00:00,67,176,5,16,564,427,137,11
6836,2022-10-12 20:00:00,132,249,7,15,771,658,113,11
6837,2022-10-12 21:00:00,78,162,11,12,664,475,189,11
6838,2022-10-12 22:00:00,84,123,8,15,638,483,155,5
6839,2022-10-12 23:00:00,148,194,13,11,592,415,177,9
6840,2022-10-13 00:00:00,126,115,12,19,763,637,126,12
6841,2022-10-13 01:00:00,65,252,13,11,504,377,127,6
6842,2022-10-13 02:00:00,98,179,5,11,599,519,80,9
6843,2022-10-13 03:00:00,139,133,9,18,641,537,104,8
6844,2022-10-13 04:00:00,96,215,14,17,719,605,114,10
6845,2022-10-13 05:00:00,96,208,13,18,731,624,107,11
6846,2022-10-13 06:00:00,76,115,9,19,542,436,106,6
6847,2022-10-13 07:00:00,117,162,11,11,575,416,159,8
6848,2022-10-13 08:00:00,53,286,6,19,535,459,76,5
6849,2022-10-13 09:00:00,66,228,8,19,541,437,104,14
6850,2022-10-13 10:00:00,94,282,6,13,573,424,149,12
6851,2022-10-13 11:00:00,143,268,12,16,711,557,154,9
6852,2022-10-13 12:00:00,71,252,11,13,695,487,208,11
6853,2022-10-13 13:00:00,110,264,5,17,513,436,77,12
6854,2022-10-13 14:00:00,141,118,14,10,779,556,223,12
6855,2022-10-13 15:00:00,86,132,13,18,697,530,167,6
6856,2022-10-13 16:00:00,119,266,13,16,760,676,84,7
6857,2022-10-13 17:00:00,86,276,14,13,635,452,183,7
6858,2022-10-13 18:00:00,51,172,11,13,554,419,135,9
6859,2022-10-13 19:00:00,76,114,5,14,603,449,154,14
6860,2022-10-13 20:00:00,88,245,5,12,562,429,133,13
6861,2022-10-13 21:00:00,129,235,6,16,596,436,160,9
6862,2022-10-13 22:00:00,56,274,8,10,720,623,97,10
6863,2022-10-13 23:00:00,59,150,14,17,756,597,159,13
6864,2022-10-14 00:00:00,117,191,12,15,639,450,189,10
6865,2022-10-14 01:00:00,114,282,7,16,782,571,211,10
6866,2022-10-14 02:00:00,148,269,10,10,627,514,113,6
6867,2022-10-14 03:00:00,82,290,8,10,680,553,127,10
6868,2022-10-14 04:00:00,93,273,5,12,753,659,94,8
6869,2022-10-14 05:00:00,85,267,6,12,699,517,182,12
6870,2022-10-14 06:00:00,91,186,13,17,720,549,171,13
6871,2022-10-14 07:00:00,70,236,10,18,781,605,176,10
6872,2022-10-14 08:00:00,114,172,5,14,623,492,131,8
6873,2022-10-14 09:00:00,81,231,14,19,703,565,138,14
6874,2022-10-14 10:00:00,120,198,9,14,696,515,181,5
6875,2022-10-14 11:00:00,138,288,9,13,548,434,114,5
6876,2022-10-14 12:00:00,105,208,11,16,522,466,56,12
6877,2022-10-14 13:00:00,110,158,8,19,733,538,195,12
6878,2022-10-14 14:00:00,123,280,5,18,784,642,142,9
6879,2022-10-14 15:00:00,86,121,10,18,690,538,152,11
6880,2022-10-14 16:00:00,64,272,7,11,657,471,186,10
6881,2022-10-14 17:00:00,102,124,10,14,716,540,176,8
6882,2022-10-14 18:00:00,117,213,14,13,636,491,145,12
6883,2022-10-14 19:00:00,62,110,13,13,501,424,77,9
6884,2022-10-14 20:00:00,105,197,13,17,617,509,108,8
6885,2022-10-14 21:00:00,138,290,11,12,558,396,162,8
6886,2022-10-14 22:00:00,118,202,6,13,745,525,220,8
6887,2022-10-14 23:00:00,58,189,14,16,715,568,147,14
6888,2022-10-15 00:00:00,57,255,6,19,730,633,97,9
6889,2022-10-15 01:00:00,79,165,12,16,721,557,164,10
6890,2022-10-15 02:00:00,90,283,8,15,677,519,158,7
6891,2022-10-15 03:00:00,130,203,12,14,595,528,67,14
6892,2022-10-15 04:00:00,52,120,14,19,663,500,163,12
6893,2022-10-15 05:00:00,149,236,6,17,542,453,89,8
6894,2022-10-15 06:00:00,90,263,11,15,640,536,104,14
6895,2022-10-15 07:00:00,68,144,5,11,590,524,66,14
6896,2022-10-15 08:00:00,126,101,8,10,602,482,120,14
6897,2022-10-15 09:00:00,141,178,6,16,567,471,96,9
6898,2022-10-15 10:00:00,123,287,14,18,584,470,114,13
6899,2022-10-15 11:00:00,102,118,12,10,733,658,75,13
6900,2022-10-15 12:00:00,62,187,5,16,576,514,62,8
6901,2022-10-15 13:00:00,63,137,12,15,717,631,86,9
6902,2022-10-15 14:00:00,145,133,5,15,647,504,143,10
6903,2022-10-15 15:00:00,51,102,10,18,613,433,180,12
6904,2022-10-15 16:00:00,144,284,11,17,643,535,108,5
6905,2022-10-15 17:00:00,73,162,13,13,661,475,186,10
6906,2022-10-15 18:00:00,128,101,12,12,703,603,100,12
6907,2022-10-15 19:00:00,135,126,14,10,599,484,115,12
6908,2022-10-15 20:00:00,117,299,12,13,660,521,139,10
6909,2022-10-15 21:00:00,95,201,14,12,605,500,105,12
6910,2022-10-15 22:00:00,115,280,11,19,783,622,161,11
6911,2022-10-15 23:00:00,119,117,11,12,680,524,156,9
6912,2022-10-16 00:00:00,83,182,6,12,666,466,200,11
6913,2022-10-16 01:00:00,114,251,12,19,782,588,194,8
6914,2022-10-16 02:00:00,128,160,5,17,762,614,148,6
6915,2022-10-16 03:00:00,72,126,13,16,585,436,149,8
6916,2022-10-16 04:00:00,105,133,11,19,572,441,131,6
6917,2022-10-16 05:00:00,53,137,7,15,627,508,119,6
6918,2022-10-16 06:00:00,62,218,14,12,764,560,204,14
6919,2022-10-16 07:00:00,127,230,7,14,590,512,78,6
6920,2022-10-16 08:00:00,138,247,12,12,560,462,98,13
6921,2022-10-16 09:00:00,95,298,6,19,586,512,74,7
6922,2022-10-16 10:00:00,78,224,12,13,573,439,134,7
6923,2022-10-16 11:00:00,149,268,7,18,620,511,109,5
6924,2022-10-16 12:00:00,117,207,5,14,674,545,129,11
6925,2022-10-16 13:00:00,136,134,12,10,687,606,81,9
6926,2022-10-16 14:00:00,60,121,8,17,705,620,85,9
6927,2022-10-16 15:00:00,145,102,7,16,510,440,70,6
6928,2022-10-16 16:00:00,55,283,7,12,763,641,122,13
6929,2022-10-16 17:00:00,147,116,14,18,780,569,211,10
6930,2022-10-16 18:00:00,51,162,6,16,620,496,124,8
6931,2022-10-16 19:00:00,102,265,8,16,722,564,158,10
6932,2022-10-16 20:00:00,53,214,14,10,618,482,136,11
6933,2022-10-16 21:00:00,110,103,7,14,676,499,177,14
6934,2022-10-16 22:00:00,52,280,14,15,661,518,143,10
6935,2022-10-16 23:00:00,143,187,11,17,664,512,152,12
6936,2022-10-17 00:00:00,101,164,13,14,598,507,91,8
6937,2022-10-17 01:00:00,111,226,10,12,731,566,165,5
6938,2022-10-17 02:00:00,118,140,14,17,603,482,121,8
6939,2022-10-17 03:00:00,69,185,12,19,505,439,66,6
6940,2022-10-17 04:00:00,61,237,7,19,582,512,70,8
6941,2022-10-17 05:00:00,92,212,11,18,792,577,215,10
6942,2022-10-17 06:00:00,80,206,5,17,615,475,140,13
6943,2022-10-17 07:00:00,117,244,11,19,695,570,125,7
6944,2022-10-17 08:00:00,75,189,5,10,544,438,106,13
6945,2022-10-17 09:00:00,68,298,5,16,621,557,64,8
6946,2022-10-17 10:00:00,86,138,13,11,609,494,115,6
6947,2022-10-17 11:00:00,137,177,8,14,529,445,84,8
6948,2022-10-17 12:00:00,64,166,11,13,599,432,167,14
6949,2022-10-17 13:00:00,127,178,9,15,737,641,96,13
6950,2022-10-17 14:00:00,105,142,14,10,581,467,114,8
6951,2022-10-17 15:00:00,136,100,12,17,541,428,113,5
6952,2022-10-17 16:00:00,137,156,14,12,640,460,180,5
6953,2022-10-17 17:00:00,62,124,8,11,568,493,75,6
6954,2022-10-17 18:00:00,96,162,6,11,690,551,139,12
6955,2022-10-17 19:00:00,76,233,14,16,522,367,155,7
6956,2022-10-17 20:00:00,125,188,11,14,668,571,97,8
6957,2022-10-17 21:00:00,62,296,7,13,656,476,180,9
6958,2022-10-17 22:00:00,77,245,9,10,608,431,177,11
6959,2022-10-17 23:00:00,119,202,8,17,628,473,155,9
6960,2022-10-18 00:00:00,116,154,5,12,502,431,71,5
6961,2022-10-18 01:00:00,139,236,12,11,746,528,218,9
6962,2022-10-18 02:00:00,83,239,7,19,633,489,144,11
6963,2022-10-18 03:00:00,118,124,8,19,780,643,137,10
6964,2022-10-18 04:00:00,53,250,7,13,673,582,91,11
6965,2022-10-18 05:00:00,66,110,8,18,514,445,69,11
6966,2022-10-18 06:00:00,65,287,5,18,512,432,80,9
6967,2022-10-18 07:00:00,100,141,14,10,635,501,134,10
6968,2022-10-18 08:00:00,111,135,6,12,625,505,120,10
6969,2022-10-18 09:00:00,130,134,9,13,526,383,143,14
6970,2022-10-18 10:00:00,53,184,11,18,531,425,106,9
6971,2022-10-18 11:00:00,79,283,14,18,529,387,142,6
6972,2022-10-18 12:00:00,135,167,9,19,536,427,109,5
6973,2022-10-18 13:00:00,146,289,7,12,738,652,86,6
6974,2022-10-18 14:00:00,76,269,14,16,610,540,70,9
6975,2022-10-18 15:00:00,88,244,13,10,625,474,151,14
6976,2022-10-18 16:00:00,51,123,8,19,740,550,190,5
6977,2022-10-18 17:00:00,53,124,8,18,699,601,98,10
6978,2022-10-18 18:00:00,104,226,10,16,635,487,148,14
6979,2022-10-18 19:00:00,107,278,13,17,583,425,158,7
6980,2022-10-18 20:00:00,106,147,8,14,687,543,144,14
6981,2022-10-18 21:00:00,109,115,14,19,718,619,99,13
6982,2022-10-18 22:00:00,88,134,8,15,693,504,189,9
6983,2022-10-18 23:00:00,75,123,5,18,627,514,113,13
6984,2022-10-19 00:00:00,84,171,10,17,514,378,136,5
6985,2022-10-19 01:00:00,79,100,5,19,573,482,91,6
6986,2022-10-19 02:00:00,144,177,12,18,642,509,133,12
6987,2022-10-19 03:00:00,84,275,11,19,731,650,81,10
6988,2022-10-19 04:00:00,85,167,10,17,782,573,209,14
6989,2022-10-19 05:00:00,50,232,8,19,634,542,92,13
6990,2022-10-19 06:00:00,112,201,14,12,616,508,108,7
6991,2022-10-19 07:00:00,102,122,8,11,756,564,192,10
6992,2022-10-19 08:00:00,85,237,10,15,612,457,155,12
6993,2022-10-19 09:00:00,128,287,5,12,526,454,72,11
6994,2022-10-19 10:00:00,52,222,14,14,502,430,72,9
6995,2022-10-19 11:00:00,53,240,7,13,697,559,138,9
6996,2022-10-19 12:00:00,60,204,9,11,728,543,185,11
6997,2022-10-19 13:00:00,130,277,9,12,723,544,179,8
6998,2022-10-19 14:00:00,91,218,12,17,619,464,155,5
6999,2022-10-19 15:00:00,141,139,6,12,761,579,182,8
7000,2022-10-19 16:00:00,61,270,7,13,726,643,83,8
7001,2022-10-19 17:00:00,128,115,5,10,525,370,155,8
7002,2022-10-19 18:00:00,113,197,7,19,614,457,157,13
7003,2022-10-19 19:00:00,51,130,5,15,633,542,91,10
7004,2022-10-19 20:00:00,122,183,14,10,506,380,126,5
7005,2022-10-19 21:00:00,85,146,7,13,509,396,113,13
7006,2022-10-19 22:00:00,60,100,13,18,637,559,78,12
7007,2022-10-19 23:00:00,123,143,14,13,645,560,85,8
7008,2022-10-20 00:00:00,111,242,7,14,703,514,189,10
7009,2022-10-20 01:00:00,137,112,10,17,528,418,110,6
7010,2022-10-20 02:00:00,117,247,10,18,571,428,143,7
7011,2022-10-20 03:00:00,126,231,7,12,636,465,171,8
7012,2022-10-20 04:00:00,70,214,12,12,664,550,114,9
7013,2022-10-20 05:00:00,140,256,13,12,504,385,119,7
7014,2022-10-20 06:00:00,78,189,6,16,788,694,94,10
7015,2022-10-20 07:00:00,113,143,11,14,525,369,156,5
7016,2022-10-20 08:00:00,132,255,14,13,527,393,134,5
7017,2022-10-20 09:00:00,85,171,7,19,789,599,190,11
7018,2022-10-20 10:00:00,140,195,12,16,606,529,77,12
7019,2022-10-20 11:00:00,123,174,5,13,535,378,157,7
7020,2022-10-20 12:00:00,123,147,8,15,505,452,53,13
7021,2022-10-20 13:00:00,101,258,7,16,621,441,180,7
7022,2022-10-20 14:00:00,79,270,6,16,572,465,107,12
7023,2022-10-20 15:00:00,92,262,12,14,773,564,209,6
7024,2022-10-20 16:00:00,97,120,7,16,787,588,199,13
7025,2022-10-20 17:00:00,58,237,14,16,766,647,119,14
7026,2022-10-20 18:00:00,98,166,14,17,701,617,84,12
7027,2022-10-20 19:00:00,76,276,6,19,635,451,184,9
7028,2022-10-20 20:00:00,86,173,13,13,547,435,112,6
7029,2022-10-20 21:00:00,53,228,6,15,706,535,171,9
7030,2022-10-20 22:00:00,75,137,11,18,524,448,76,9
7031,2022-10-20 23:00:00,70,139,6,11,560,457,103,6
7032,2022-10-21 00:00:00,145,224,6,11,611,541,70,6
7033,2022-10-21 01:00:00,50,180,14,13,608,460,148,6
7034,2022-10-21 02:00:00,54,240,13,10,761,575,186,7
7035,2022-10-21 03:00:00,84,242,11,15,712,593,119,7
7036,2022-10-21 04:00:00,76,148,9,19,501,424,77,10
7037,2022-10-21 05:00:00,129,214,10,15,745,608,137,14
7038,2022-10-21 06:00:00,146,140,9,15,512,417,95,8
7039,2022-10-21 07:00:00,100,140,12,15,768,641,127,7
7040,2022-10-21 08:00:00,67,112,10,13,791,596,195,10
7041,2022-10-21 09:00:00,120,267,7,16,516,442,74,14
7042,2022-10-21 10:00:00,72,292,14,12,666,511,155,12
7043,2022-10-21 11:00:00,108,227,10,12,797,572,225,13
7044,2022-10-21 12:00:00,104,194,11,18,615,522,93,7
7045,2022-10-21 13:00:00,109,128,13,13,780,551,229,11
7046,2022-10-21 14:00:00,149,159,12,19,601,445,156,6
7047,2022-10-21 15:00:00,146,232,7,16,650,544,106,12
7048,2022-10-21 16:00:00,50,254,12,15,622,473,149,6
7049,2022-10-21 17:00:00,72,283,6,15,709,543,166,11
7050,2022-10-21 18:00:00,63,217,13,17,668,519,149,14
7051,2022-10-21 19:00:00,66,287,14,12,630,493,137,8
7052,2022-10-21 20:00:00,122,280,13,11,781,685,96,8
7053,2022-10-21 21:00:00,111,230,11,15,748,548,200,13
7054,2022-10-21 22:00:00,59,143,6,16,762,670,92,10
7055,2022-10-21 23:00:00,61,175,9,14,663,559,104,14
7056,2022-10-22 00:00:00,129,147,10,16,693,500,193,8
7057,2022-10-22 01:00:00,117,160,8,18,618,510,108,12
7058,2022-10-22 02:00:00,124,255,13,18,745,653,92,12
7059,2022-10-22 03:00:00,54,262,10,16,580,493,87,8
7060,2022-10-22 04:00:00,91,262,9,11,638,447,191,8
7061,2022-10-22 05:00:00,98,270,8,18,516,397,119,13
7062,2022-10-22 06:00:00,143,153,6,17,627,531,96,8
7063,2022-10-22 07:00:00,147,135,6,14,544,475,69,9
7064,2022-10-22 08:00:00,68,292,6,18,716,608,108,13
7065,2022-10-22 09:00:00,115,130,7,13,773,574,199,6
7066,2022-10-22 10:00:00,86,114,13,18,792,645,147,9
7067,2022-10-22 11:00:00,107,283,13,11,765,536,229,13
7068,2022-10-22 12:00:00,100,277,14,19,753,580,173,7
7069,2022-10-22 13:00:00,87,238,11,18,795,585,210,8
7070,2022-10-22 14:00:00,108,292,14,18,560,441,119,6
7071,2022-10-22 15:00:00,110,142,9,13,611,535,76,10
7072,2022-10-22 16:00:00,81,157,10,12,516,408,108,13
7073,2022-10-22 17:00:00,146,254,9,11,708,596,112,5
7074,2022-10-22 18:00:00,68,106,11,19,770,578,192,6
7075,2022-10-22 19:00:00,132,279,11,15,672,502,170,7
7076,2022-10-22 20:00:00,142,258,13,19,732,624,108,13
7077,2022-10-22 21:00:00,144,164,7,14,687,552,135,13
7078,2022-10-22 22:00:00,126,297,13,17,782,660,122,6
7079,2022-10-22 23:00:00,139,196,8,10,551,488,63,6
7080,2022-10-23 00:00:00,73,247,14,12,776,623,153,12
7081,2022-10-23 01:00:00,76,110,7,13,506,381,125,6
7082,2022-10-23 02:00:00,74,160,6,11,548,458,90,11
7083,2022-10-23 03:00:00,91,215,12,17,541,485,56,9
7084,2022-10-23 04:00:00,131,271,11,13,714,543,171,12
7085,2022-10-23 05:00:00,68,217,8,19,632,508,124,11
7086,2022-10-23 06:00:00,58,187,7,19,590,476,114,12
7087,2022-10-23 07:00:00,103,135,10,14,609,491,118,7
7088,2022-10-23 08:00:00,82,256,12,17,504,396,108,12
7089,2022-10-23 09:00:00,98,119,8,16,696,551,145,8
7090,2022-10-23 10:00:00,74,139,8,16,557,436,121,6
7091,2022-10-23 11:00:00,50,221,5,11,731,527,204,14
7092,2022-10-23 12:00:00,113,296,14,15,672,555,117,14
7093,2022-10-23 13:00:00,93,127,6,11,727,536,191,11
7094,2022-10-23 14:00:00,149,115,12,19,743,602,141,10
7095,2022-10-23 15:00:00,52,258,11,14,659,550,109,9
7096,2022-10-23 16:00:00,60,255,11,14,659,510,149,12
7097,2022-10-23 17:00:00,91,160,7,17,666,578,88,8
7098,2022-10-23 18:00:00,84,124,14,11,568,431,137,13
7099,2022-10-23 19:00:00,64,277,13,10,750,655,95,7
7100,2022-10-23 20:00:00,81,141,13,19,782,565,217,12
7101,2022-10-23 21:00:00,149,194,5,12,662,540,122,8
7102,2022-10-23 22:00:00,117,156,7,12,513,415,98,11
7103,2022-10-23 23:00:00,89,175,10,13,720,554,166,8
7104,2022-10-24 00:00:00,138,242,10,10,696,505,191,9
7105,2022-10-24 01:00:00,79,149,13,13,530,377,153,7
7106,2022-10-24 02:00:00,85,193,9,11,640,531,109,7
7107,2022-10-24 03:00:00,113,296,5,13,549,489,60,6
7108,2022-10-24 04:00:00,94,125,5,18,722,517,205,8
7109,2022-10-24 05:00:00,149,201,11,17,596,470,126,6
7110,2022-10-24 06:00:00,91,100,12,17,581,502,79,13
7111,2022-10-24 07:00:00,124,190,10,12,695,573,122,6
7112,2022-10-24 08:00:00,57,287,9,17,527,379,148,10
7113,2022-10-24 09:00:00,134,214,10,12,773,596,177,12
7114,2022-10-24 10:00:00,105,244,7,10,616,470,146,7
7115,2022-10-24 11:00:00,143,232,14,18,519,466,53,7
7116,2022-10-24 12:00:00,65,167,9,10,772,613,159,10
7117,2022-10-24 13:00:00,74,231,9,12,535,376,159,14
7118,2022-10-24 14:00:00,80,176,6,15,582,489,93,12
7119,2022-10-24 15:00:00,124,257,11,15,632,561,71,9
7120,2022-10-24 16:00:00,139,186,11,18,737,535,202,5
7121,2022-10-24 17:00:00,131,101,11,10,798,689,109,11
7122,2022-10-24 18:00:00,75,287,8,13,753,574,179,10
7123,2022-10-24 19:00:00,139,206,7,19,540,407,133,5
7124,2022-10-24 20:00:00,148,120,9,15,543,429,114,13
7125,2022-10-24 21:00:00,102,175,14,18,658,538,120,9
7126,2022-10-24 22:00:00,92,137,10,18,530,394,136,5
7127,2022-10-24 23:00:00,138,134,13,11,559,495,64,14
7128,2022-10-25 00:00:00,85,248,14,13,620,490,130,7
7129,2022-10-25 01:00:00,60,168,10,12,723,619,104,11
7130,2022-10-25 02:00:00,140,153,14,18,629,510,119,6
7131,2022-10-25 03:00:00,125,152,13,11,674,506,168,10
7132,2022-10-25 04:00:00,64,121,6,19,590,492,98,9
7133,2022-10-25 05:00:00,109,238,7,14,772,582,190,12
7134,2022-10-25 06:00:00,113,243,10,16,700,609,91,11
7135,2022-10-25 07:00:00,58,247,5,10,522,432,90,5
7136,2022-10-25 08:00:00,127,243,6,13,611,497,114,11
7137,2022-10-25 09:00:00,113,177,5,16,630,479,151,9
7138,2022-10-25 10:00:00,131,177,8,14,531,454,77,7
7139,2022-10-25 11:00:00,55,225,10,14,639,451,188,11
7140,2022-10-25 12:00:00,53,209,10,10,757,648,109,7
7141,2022-10-25 13:00:00,105,238,11,12,570,416,154,6
7142,2022-10-25 14:00:00,129,240,12,16,697,573,124,12
7143,2022-10-25 15:00:00,78,226,5,12,784,563,221,14
7144,2022-10-25 16:00:00,132,263,8,15,669,533,136,8
7145,2022-10-25 17:00:00,134,131,8,10,523,392,131,5
7146,2022-10-25 18:00:00,140,229,7,12,770,667,103,10
7147,2022-10-25 19:00:00,96,221,8,13,795,569,226,11
7148,2022-10-25 20:00:00,141,284,6,17,693,528,165,7
7149,2022-10-25 21:00:00,109,124,6,16,712,618,94,9
7150,2022-10-25 22:00:00,106,158,6,19,558,441,117,8
7151,2022-10-25 23:00:00,122,273,8,17,596,440,156,13
7152,2022-10-26 00:00:00,58,242,10,19,711,600,111,11
7153,2022-10-26 01:00:00,71,207,10,15,597,509,88,7
7154,2022-10-26 02:00:00,135,136,12,18,743,569,174,12
7155,2022-10-26 03:00:00,65,191,11,14,747,580,167,8
7156,2022-10-26 04:00:00,109,270,7,18,506,396,110,5
7157,2022-10-26 05:00:00,143,162,9,18,718,638,80,7
7158,2022-10-26 06:00:00,99,257,7,17,740,628,112,6
7159,2022-10-26 07:00:00,60,191,9,13,550,481,69,10
7160,2022-10-26 08:00:00,94,269,11,15,790,608,182,13
7161,2022-10-26 09:00:00,102,151,9,16,551,467,84,6
7162,2022-10-26 10:00:00,97,165,10,13,745,648,97,11
7163,2022-10-26 11:00:00,104,125,11,10,543,482,61,12
7164,2022-10-26 12:00:00,132,268,5,17,565,440,125,10
7165,2022-10-26 13:00:00,79,252,6,17,629,487,142,8
7166,2022-10-26 14:00:00,148,289,7,18,517,425,92,12
7167,2022-10-26 15:00:00,56,226,11,19,550,398,152,7
7168,2022-10-26 16:00:00,121,261,9,18,782,571,211,5
7169,2022-10-26 17:00:00,81,170,12,16,758,542,216,6
7170,2022-10-26 18:00:00,142,123,11,10,722,643,79,5
7171,2022-10-26 19:00:00,107,226,6,14,662,576,86,8
7172,2022-10-26 20:00:00,104,140,11,17,775,653,122,8
7173,2022-10-26 21:00:00,114,120,11,14,694,602,92,8
7174,2022-10-26 22:00:00,127,175,5,15,651,545,106,13
7175,2022-10-26 23:00:00,68,119,12,18,604,476,128,5
7176,2022-10-27 00:00:00,128,287,5,10,679,504,175,6
7177,2022-10-27 01:00:00,117,284,11,12,513,435,78,12
7178,2022-10-27 02:00:00,126,228,13,18,721,578,143,8
7179,2022-10-27 03:00:00,79,119,6,16,704,604,100,6
7180,2022-10-27 04:00:00,77,296,5,11,779,669,110,9
7181,2022-10-27 05:00:00,66,155,7,19,729,536,193,5
7182,2022-10-27 06:00:00,145,223,12,14,526,433,93,11
7183,2022-10-27 07:00:00,101,224,11,16,671,493,178,8
7184,2022-10-27 08:00:00,53,138,11,17,561,490,71,7
7185,2022-10-27 09:00:00,67,149,5,10,675,485,190,12
7186,2022-10-27 10:00:00,127,114,12,17,652,510,142,13
7187,2022-10-27 11:00:00,136,241,13,19,588,424,164,13
7188,2022-10-27 12:00:00,96,225,13,18,721,558,163,9
7189,2022-10-27 13:00:00,140,276,14,11,500,412,88,13
7190,2022-10-27 14:00:00,66,289,7,18,520,440,80,9
7191,2022-10-27 15:00:00,79,164,8,11,585,490,95,8
7192,2022-10-27 16:00:00,111,181,8,14,780,574,206,13
7193,2022-10-27 17:00:00,59,106,10,15,569,455,114,6
7194,2022-10-27 18:00:00,144,210,7,12,754,648,106,13
7195,2022-10-27 19:00:00,83,109,5,12,715,607,108,9
7196,2022-10-27 20:00:00,123,214,9,11,541,485,56,5
7197,2022-10-27 21:00:00,127,100,8,19,589,467,122,14
7198,2022-10-27 22:00:00,62,148,5,15,500,374,126,11
7199,2022-10-27 23:00:00,118,246,8,17,703,520,183,9
7200,2022-10-28 00:00:00,67,128,14,19,513,394,119,9
7201,2022-10-28 01:00:00,126,211,12,13,617,488,129,7
7202,2022-10-28 02:00:00,90,172,12,12,535,436,99,14
7203,2022-10-28 03:00:00,81,275,9,17,632,461,171,5
7204,2022-10-28 04:00:00,148,181,10,14,707,519,188,14
7205,2022-10-28 05:00:00,120,178,11,14,566,402,164,7
7206,2022-10-28 06:00:00,138,104,8,17,534,389,145,13
7207,2022-10-28 07:00:00,137,232,6,19,582,487,95,12
7208,2022-10-28 08:00:00,58,171,14,12,555,400,155,11
7209,2022-10-28 09:00:00,112,285,5,12,605,468,137,8
7210,2022-10-28 10:00:00,86,133,7,19,688,525,163,12
7211,2022-10-28 11:00:00,142,283,12,15,719,638,81,7
7212,2022-10-28 12:00:00,53,299,14,19,565,466,99,8
7213,2022-10-28 13:00:00,76,117,14,13,685,550,135,11
7214,2022-10-28 14:00:00,136,232,14,12,519,417,102,10
7215,2022-10-28 15:00:00,113,283,9,16,714,597,117,7
7216,2022-10-28 16:00:00,61,233,13,13,734,516,218,7
7217,2022-10-28 17:00:00,73,195,11,15,514,398,116,9
7218,2022-10-28 18:00:00,132,160,8,17,556,448,108,7
7219,2022-10-28 19:00:00,111,103,12,15,687,557,130,6
7220,2022-10-28 20:00:00,124,122,5,14,644,525,119,8
7221,2022-10-28 21:00:00,89,216,13,18,793,582,211,7
7222,2022-10-28 22:00:00,132,148,6,10,645,528,117,6
7223,2022-10-28 23:00:00,104,288,12,15,762,549,213,7
7224,2022-10-29 00:00:00,128,161,10,14,741,550,191,6
7225,2022-10-29 01:00:00,96,261,9,17,736,519,217,8
7226,2022-10-29 02:00:00,95,122,13,15,622,553,69,5
7227,2022-10-29 03:00:00,51,279,11,13,786,657,129,14
7228,2022-10-29 04:00:00,101,166,10,14,724,616,108,13
7229,2022-10-29 05:00:00,145,120,13,16,739,611,128,5
7230,2022-10-29 06:00:00,75,248,8,14,522,412,110,7
7231,2022-10-29 07:00:00,131,199,11,11,783,684,99,12
7232,2022-10-29 08:00:00,57,209,8,12,755,630,125,13
7233,2022-10-29 09:00:00,125,145,12,15,540,415,125,12
7234,2022-10-29 10:00:00,141,163,10,13,621,458,163,9
7235,2022-10-29 11:00:00,129,131,14,19,696,611,85,10
7236,2022-10-29 12:00:00,69,142,10,17,589,467,122,12
7237,2022-10-29 13:00:00,96,180,13,17,654,511,143,12
7238,2022-10-29 14:00:00,97,109,8,16,529,467,62,9
7239,2022-10-29 15:00:00,133,144,14,16,665,524,141,12
7240,2022-10-29 16:00:00,91,139,9,12,656,471,185,11
7241,2022-10-29 17:00:00,142,269,7,13,605,460,145,9
7242,2022-10-29 18:00:00,115,227,9,18,524,427,97,9
7243,2022-10-29 19:00:00,128,158,13,14,596,432,164,13
7244,2022-10-29 20:00:00,51,232,7,16,688,550,138,5
7245,2022-10-29 21:00:00,128,202,8,11,744,651,93,8
7246,2022-10-29 22:00:00,62,215,7,13,781,592,189,11
7247,2022-10-29 23:00:00,132,271,9,15,581,414,167,12
7248,2022-10-30 00:00:00,56,164,11,13,676,578,98,10
7249,2022-10-30 01:00:00,95,165,10,12,609,448,161,5
7250,2022-10-30 02:00:00,93,151,7,15,766,580,186,13
7251,2022-10-30 03:00:00,100,169,10,11,503,402,101,8
7252,2022-10-30 04:00:00,135,253,13,11,689,499,190,7
7253,2022-10-30 05:00:00,123,241,13,18,740,629,111,12
7254,2022-10-30 06:00:00,136,147,14,16,659,497,162,11
7255,2022-10-30 07:00:00,61,156,5,13,686,525,161,13
7256,2022-10-30 08:00:00,144,132,13,10,654,567,87,7
7257,2022-10-30 09:00:00,108,265,6,16,630,514,116,13
7258,2022-10-30 10:00:00,50,107,7,13,539,432,107,10
7259,2022-10-30 11:00:00,66,239,13,16,649,475,174,11
7260,2022-10-30 12:00:00,61,248,12,13,665,520,145,13
7261,2022-10-30 13:00:00,128,220,13,13,610,511,99,5
7262,2022-10-30 14:00:00,71,214,14,12,577,431,146,12
7263,2022-10-30 15:00:00,94,216,10,10,712,612,100,11
7264,2022-10-30 16:00:00,97,276,10,12,628,495,133,11
7265,2022-10-30 17:00:00,121,181,9,11,714,558,156,11
7266,2022-10-30 18:00:00,125,237,13,17,793,614,179,11
7267,2022-10-30 19:00:00,99,245,10,13,794,668,126,6
7268,2022-10-30 20:00:00,147,114,11,19,733,621,112,6
7269,2022-10-30 21:00:00,102,117,9,14,721,572,149,6
7270,2022-10-30 22:00:00,126,174,14,10,766,571,195,14
7271,2022-10-30 23:00:00,66,102,8,18,516,419,97,8
7272,2022-10-31 00:00:00,69,133,6,10,593,491,102,8
7273,2022-10-31 01:00:00,78,147,10,19,598,506,92,8
7274,2022-10-31 02:00:00,75,202,6,12,538,459,79,14
7275,2022-10-31 03:00:00,97,260,5,10,555,416,139,14
7276,2022-10-31 04:00:00,120,135,11,10,553,454,99,8
7277,2022-10-31 05:00:00,56,184,6,14,591,464,127,6
7278,2022-10-31 06:00:00,114,286,8,12,770,652,118,14
7279,2022-10-31 07:00:00,94,241,7,19,690,553,137,9
7280,2022-10-31 08:00:00,124,280,5,18,545,436,109,7
7281,2022-10-31 09:00:00,113,167,11,19,606,485,121,9
7282,2022-10-31 10:00:00,67,234,9,17,606,442,164,12
7283,2022-10-31 11:00:00,124,247,12,17,767,551,216,5
7284,2022-10-31 12:00:00,110,133,10,13,788,606,182,9
7285,2022-10-31 13:00:00,74,204,5,17,683,531,152,14
7286,2022-10-31 14:00:00,77,253,9,11,731,631,100,11
7287,2022-10-31 15:00:00,78,120,10,19,582,417,165,11
7288,2022-10-31 16:00:00,96,144,8,15,710,539,171,5
7289,2022-10-31 17:00:00,131,161,13,19,784,617,167,6
7290,2022-10-31 18:00:00,69,174,12,15,742,609,133,7
7291,2022-10-31 19:00:00,63,236,10,14,573,508,65,11
7292,2022-10-31 20:00:00,127,263,5,12,719,635,84,9
7293,2022-10-31 21:00:00,118,206,7,14,716,603,113,11
7294,2022-10-31 22:00:00,82,117,12,17,735,539,196,11
7295,2022-10-31 23:00:00,145,263,12,12,597,510,87,8
7296,2022-11-01 00:00:00,106,220,12,15,508,384,124,14
7297,2022-11-01 01:00:00,72,293,10,12,720,604,116,7
7298,2022-11-01 02:00:00,137,138,9,17,611,477,134,6
7299,2022-11-01 03:00:00,126,122,8,18,655,468,187,10
7300,2022-11-01 04:00:00,93,184,13,18,626,485,141,12
7301,2022-11-01 05:00:00,55,208,11,10,542,427,115,8
7302,2022-11-01 06:00:00,116,222,12,18,783,597,186,13
7303,2022-11-01 07:00:00,148,149,5,17,739,550,189,12
7304,2022-11-01 08:00:00,124,104,5,19,610,534,76,13
7305,2022-11-01 09:00:00,136,169,9,13,563,492,71,5
7306,2022-11-01 10:00:00,50,264,7,11,506,372,134,7
7307,2022-11-01 11:00:00,111,293,9,19,635,461,174,11
7308,2022-11-01 12:00:00,54,298,5,17,723,640,83,11
7309,2022-11-01 13:00:00,99,119,11,12,743,626,117,7
7310,2022-11-01 14:00:00,56,286,14,17,554,419,135,11
7311,2022-11-01 15:00:00,67,123,11,18,733,558,175,6
7312,2022-11-01 16:00:00,113,220,10,15,740,550,190,12
7313,2022-11-01 17:00:00,117,249,8,15,776,559,217,5
7314,2022-11-01 18:00:00,98,281,13,13,704,549,155,10
7315,2022-11-01 19:00:00,98,148,6,15,637,488,149,5
7316,2022-11-01 20:00:00,123,123,7,17,670,582,88,9
7317,2022-11-01 21:00:00,93,251,13,19,552,420,132,14
7318,2022-11-01 22:00:00,125,147,7,11,715,555,160,7
7319,2022-11-01 23:00:00,130,152,13,18,647,511,136,7
7320,2022-11-02 00:00:00,129,130,9,10,766,628,138,13
7321,2022-11-02 01:00:00,116,240,6,15,781,684,97,12
7322,2022-11-02 02:00:00,96,167,8,12,648,473,175,5
7323,2022-11-02 03:00:00,95,210,9,14,764,678,86,14
7324,2022-11-02 04:00:00,66,255,13,17,551,397,154,8
7325,2022-11-02 05:00:00,74,188,11,10,620,449,171,7
7326,2022-11-02 06:00:00,148,118,13,19,563,440,123,8
7327,2022-11-02 07:00:00,101,128,5,18,632,539,93,13
7328,2022-11-02 08:00:00,122,231,7,16,667,567,100,10
7329,2022-11-02 09:00:00,76,292,12,18,768,593,175,10
7330,2022-11-02 10:00:00,143,206,10,18,745,574,171,10
7331,2022-11-02 11:00:00,78,206,7,18,772,671,101,7
7332,2022-11-02 12:00:00,86,213,7,10,694,491,203,5
7333,2022-11-02 13:00:00,100,286,13,17,748,638,110,13
7334,2022-11-02 14:00:00,138,173,13,11,546,387,159,6
7335,2022-11-02 15:00:00,71,256,12,12,726,643,83,7
7336,2022-11-02 16:00:00,128,153,6,14,582,476,106,12
7337,2022-11-02 17:00:00,52,133,13,14,616,443,173,7
7338,2022-11-02 18:00:00,89,184,11,19,554,478,76,13
7339,2022-11-02 19:00:00,59,290,8,17,508,441,67,8
7340,2022-11-02 20:00:00,119,124,8,10,739,644,95,6
7341,2022-11-02 21:00:00,50,265,8,14,573,485,88,11
7342,2022-11-02 22:00:00,83,118,5,11,799,604,195,7
7343,2022-11-02 23:00:00,83,178,8,12,716,513,203,5
7344,2022-11-03 00:00:00,81,190,6,17,697,512,185,10
7345,2022-11-03 01:00:00,53,114,14,10,749,553,196,11
7346,2022-11-03 02:00:00,114,102,8,13,738,560,178,12
7347,2022-11-03 03:00:00,140,222,13,16,599,430,169,14
7348,2022-11-03 04:00:00,109,158,11,10,676,566,110,9
7349,2022-11-03 05:00:00,130,256,12,10,649,491,158,13
7350,2022-11-03 06:00:00,70,286,10,11,667,491,176,14
7351,2022-11-03 07:00:00,99,193,8,13,787,698,89,13
7352,2022-11-03 08:00:00,56,118,11,18,533,433,100,13
7353,2022-11-03 09:00:00,142,236,5,13,697,565,132,14
7354,2022-11-03 10:00:00,62,223,6,14,763,628,135,12
7355,2022-11-03 11:00:00,142,261,12,11,561,462,99,6
7356,2022-11-03 12:00:00,63,259,14,11,757,675,82,8
7357,2022-11-03 13:00:00,141,128,12,18,637,538,99,6
7358,2022-11-03 14:00:00,129,233,8,10,610,520,90,10
7359,2022-11-03 15:00:00,140,185,6,13,573,498,75,9
7360,2022-11-03 16:00:00,100,251,6,12,589,445,144,9
7361,2022-11-03 17:00:00,134,205,8,11,788,705,83,9
7362,2022-11-03 18:00:00,105,119,11,15,612,436,176,12
7363,2022-11-03 19:00:00,118,235,13,13,523,442,81,10
7364,2022-11-03 20:00:00,57,290,9,17,616,452,164,13
7365,2022-11-03 21:00:00,132,290,14,17,583,507,76,5
7366,2022-11-03 22:00:00,69,190,6,19,732,575,157,12
7367,2022-11-03 23:00:00,107,171,10,10,660,579,81,13
7368,2022-11-04 00:00:00,113,201,8,15,526,459,67,7
7369,2022-11-04 01:00:00,68,239,7,19,745,625,120,6
7370,2022-11-04 02:00:00,57,273,12,18,660,590,70,8
7371,2022-11-04 03:00:00,104,200,8,13,568,458,110,9
7372,2022-11-04 04:00:00,118,213,9,18,583,460,123,11
7373,2022-11-04 05:00:00,55,261,6,19,760,614,146,5
7374,2022-11-04 06:00:00,89,155,12,18,556,485,71,7
7375,2022-11-04 07:00:00,71,282,10,15,669,601,68,11
7376,2022-11-04 08:00:00,61,228,14,18,788,652,136,10
7377,2022-11-04 09:00:00,101,159,12,15,560,426,134,9
7378,2022-11-04 10:00:00,107,290,11,13,674,606,68,13
7379,2022-11-04 11:00:00,51,160,5,18,657,587,70,14
7380,2022-11-04 12:00:00,102,286,5,19,764,551,213,11
7381,2022-11-04 13:00:00,78,133,14,19,628,504,124,7
7382,2022-11-04 14:00:00,89,145,14,12,676,540,136,12
7383,2022-11-04 15:00:00,107,223,13,13,707,580,127,13
7384,2022-11-04 16:00:00,147,246,14,11,503,434,69,11
7385,2022-11-04 17:00:00,52,210,13,19,545,409,136,13
7386,2022-11-04 18:00:00,112,182,10,17,687,586,101,5
7387,2022-11-04 19:00:00,148,178,7,19,798,710,88,8
7388,2022-11-04 20:00:00,90,152,5,16,681,601,80,8
7389,2022-11-04 21:00:00,127,152,9,11,613,509,104,6
7390,2022-11-04 22:00:00,143,293,14,18,590,472,118,6
7391,2022-11-04 23:00:00,131,200,8,16,647,472,175,8
7392,2022-11-05 00:00:00,93,210,7,18,695,498,197,6
7393,2022-11-05 01:00:00,53,177,10,10,578,429,149,14
7394,2022-11-05 02:00:00,69,221,7,19,675,589,86,8
7395,2022-11-05 03:00:00,114,157,8,17,638,548,90,7
7396,2022-11-05 04:00:00,91,124,11,12,587,508,79,6
7397,2022-11-05 05:00:00,147,269,7,12,666,470,196,14
7398,2022-11-05 06:00:00,139,239,13,16,561,427,134,6
7399,2022-11-05 07:00:00,72,171,7,15,658,493,165,6
7400,2022-11-05 08:00:00,149,209,6,12,581,425,156,6
7401,2022-11-05 09:00:00,76,101,7,14,790,648,142,13
7402,2022-11-05 10:00:00,88,115,9,14,725,607,118,12
7403,2022-11-05 11:00:00,127,212,6,17,639,476,163,11
7404,2022-11-05 12:00:00,80,144,13,18,634,464,170,13
7405,2022-11-05 13:00:00,132,215,8,18,771,639,132,9
7406,2022-11-05 14:00:00,59,104,9,12,704,590,114,7
7407,2022-11-05 15:00:00,146,182,5,15,691,519,172,7
7408,2022-11-05 16:00:00,115,223,9,10,625,443,182,12
7409,2022-11-05 17:00:00,77,242,6,19,665,544,121,8
7410,2022-11-05 18:00:00,121,282,10,13,638,455,183,8
7411,2022-11-05 19:00:00,68,273,11,15,660,556,104,14
7412,2022-11-05 20:00:00,52,149,6,17,539,465,74,7
7413,2022-11-05 21:00:00,141,297,10,16,603,528,75,13
7414,2022-11-05 22:00:00,104,195,11,19,645,498,147,7
7415,2022-11-05 23:00:00,79,269,7,14,749,604,145,6
7416,2022-11-06 00:00:00,99,171,5,10,525,456,69,6
7417,2022-11-06 01:00:00,102,101,14,13,548,456,92,9
7418,2022-11-06 02:00:00,86,224,11,14,521,468,53,12
7419,2022-11-06 03:00:00,127,159,6,18,630,498,132,10
7420,2022-11-06 04:00:00,87,230,5,16,721,637,84,5
7421,2022-11-06 05:00:00,60,229,11,18,542,382,160,7
7422,2022-11-06 06:00:00,118,109,9,18,505,410,95,7
7423,2022-11-06 07:00:00,130,109,8,10,652,522,130,8
7424,2022-11-06 08:00:00,135,150,14,13,776,631,145,11
7425,2022-11-06 09:00:00,124,104,10,12,556,391,165,9
7426,2022-11-06 10:00:00,69,135,6,14,754,552,202,6
7427,2022-11-06 11:00:00,69,296,13,15,569,458,111,9
7428,2022-11-06 12:00:00,55,164,14,14,620,480,140,7
7429,2022-11-06 13:00:00,125,178,9,16,526,437,89,7
7430,2022-11-06 14:00:00,62,198,5,16,798,587,211,5
7431,2022-11-06 15:00:00,137,162,9,19,531,459,72,13
7432,2022-11-06 16:00:00,147,170,14,15,626,550,76,9
7433,2022-11-06 17:00:00,55,114,14,15,787,672,115,6
7434,2022-11-06 18:00:00,139,248,5,18,659,587,72,6
7435,2022-11-06 19:00:00,93,226,14,13,503,434,69,13
7436,2022-11-06 20:00:00,134,220,12,15,751,596,155,7
7437,2022-11-06 21:00:00,111,203,11,15,733,516,217,9
7438,2022-11-06 22:00:00,140,243,6,18,697,607,90,14
7439,2022-11-06 23:00:00,126,155,11,12,724,622,102,13
7440,2022-11-07 00:00:00,95,237,13,13,526,455,71,12
7441,2022-11-07 01:00:00,149,293,7,17,712,520,192,5
7442,2022-11-07 02:00:00,135,285,10,18,585,427,158,12
7443,2022-11-07 03:00:00,74,240,8,12,787,638,149,5
7444,2022-11-07 04:00:00,80,124,12,14,567,438,129,9
7445,2022-11-07 05:00:00,130,259,6,13,632,449,183,13
7446,2022-11-07 06:00:00,64,205,12,11,502,442,60,10
7447,2022-11-07 07:00:00,61,168,14,14,558,465,93,13
7448,2022-11-07 08:00:00,126,267,14,10,545,401,144,5
7449,2022-11-07 09:00:00,110,263,13,10,659,554,105,12
7450,2022-11-07 10:00:00,120,291,14,19,750,527,223,6
7451,2022-11-07 11:00:00,120,207,6,12,696,579,117,12
7452,2022-11-07 12:00:00,102,222,11,14,579,454,125,13
7453,2022-11-07 13:00:00,52,119,13,15,785,698,87,7
7454,2022-11-07 14:00:00,121,199,13,11,613,524,89,5
7455,2022-11-07 15:00:00,74,186,12,10,551,488,63,7
7456,2022-11-07 16:00:00,103,282,11,13,724,618,106,5
7457,2022-11-07 17:00:00,103,127,7,14,589,507,82,9
7458,2022-11-07 18:00:00,133,185,11,19,588,487,101,10
7459,2022-11-07 19:00:00,58,218,12,10,674,547,127,14
7460,2022-11-07 20:00:00,79,209,8,18,542,392,150,9
7461,2022-11-07 21:00:00,74,200,13,17,663,569,94,13
7462,2022-11-07 22:00:00,134,170,11,18,578,506,72,8
7463,2022-11-07 23:00:00,147,125,11,19,533,415,118,12
7464,2022-11-08 00:00:00,126,255,6,19,679,569,110,10
7465,2022-11-08 01:00:00,80,203,5,10,758,576,182,10
7466,2022-11-08 02:00:00,137,212,10,14,648,516,132,5
7467,2022-11-08 03:00:00,97,195,6,12,687,512,175,14
7468,2022-11-08 04:00:00,135,278,11,19,588,447,141,10
7469,2022-11-08 05:00:00,76,281,5,19,756,553,203,14
7470,2022-11-08 06:00:00,62,231,8,19,711,635,76,10
7471,2022-11-08 07:00:00,100,106,12,12,724,540,184,11
7472,2022-11-08 08:00:00,146,185,11,17,566,492,74,14
7473,2022-11-08 09:00:00,86,215,12,13,776,548,228,10
7474,2022-11-08 10:00:00,62,187,7,17,621,510,111,13
7475,2022-11-08 11:00:00,60,120,8,13,519,442,77,12
7476,2022-11-08 12:00:00,56,256,13,18,612,527,85,5
7477,2022-11-08 13:00:00,54,263,11,16,612,526,86,12
7478,2022-11-08 14:00:00,78,170,5,13,636,452,184,5
7479,2022-11-08 15:00:00,61,259,11,18,658,545,113,5
7480,2022-11-08 16:00:00,87,277,5,14,661,557,104,11
7481,2022-11-08 17:00:00,61,185,9,15,561,395,166,5
7482,2022-11-08 18:00:00,142,219,14,14,660,528,132,8
7483,2022-11-08 19:00:00,138,210,7,11,709,496,213,6
7484,2022-11-08 20:00:00,82,207,7,11,659,466,193,7
7485,2022-11-08 21:00:00,62,159,7,11,697,495,202,13
7486,2022-11-08 22:00:00,111,221,14,15,537,454,83,9
7487,2022-11-08 23:00:00,85,200,10,19,650,583,67,8
7488,2022-11-09 00:00:00,147,190,8,12,720,554,166,12
7489,2022-11-09 01:00:00,61,111,12,18,684,514,170,14
7490,2022-11-09 02:00:00,84,189,13,16,735,576,159,10
7491,2022-11-09 03:00:00,76,177,7,19,532,420,112,11
7492,2022-11-09 04:00:00,101,293,10,13,647,578,69,10
7493,2022-11-09 05:00:00,111,220,6,15,740,638,102,14
7494,2022-11-09 06:00:00,64,134,11,16,779,679,100,8
7495,2022-11-09 07:00:00,80,122,7,18,627,480,147,6
7496,2022-11-09 08:00:00,54,128,8,18,553,399,154,13
7497,2022-11-09 09:00:00,132,292,14,15,539,471,68,9
7498,2022-11-09 10:00:00,53,161,12,19,584,473,111,8
7499,2022-11-09 11:00:00,105,297,13,14,574,452,122,5
7500,2022-11-09 12:00:00,55,273,8,18,696,619,77,14
7501,2022-11-09 13:00:00,100,198,14,14,583,517,66,7
7502,2022-11-09 14:00:00,146,291,8,12,768,576,192,5
7503,2022-11-09 15:00:00,78,154,13,14,731,586,145,10
7504,2022-11-09 16:00:00,89,151,10,14,500,431,69,11
7505,2022-11-09 17:00:00,108,159,6,16,649,567,82,6
7506,2022-11-09 18:00:00,126,284,11,11,741,627,114,13
7507,2022-11-09 19:00:00,81,240,13,14,612,521,91,13
7508,2022-11-09 20:00:00,147,118,9,15,658,520,138,13
7509,2022-11-09 21:00:00,73,246,11,13,644,547,97,8
7510,2022-11-09 22:00:00,67,145,5,14,668,584,84,7
7511,2022-11-09 23:00:00,70,227,9,11,690,518,172,8
7512,2022-11-10 00:00:00,115,129,12,13,718,584,134,13
7513,2022-11-10 01:00:00,63,173,7,18,570,405,165,5
7514,2022-11-10 02:00:00,149,281,8,19,664,586,78,8
7515,2022-11-10 03:00:00,93,172,10,14,511,445,66,12
7516,2022-11-10 04:00:00,106,155,7,14,687,529,158,7
7517,2022-11-10 05:00:00,89,248,10,14,784,560,224,12
7518,2022-11-10 06:00:00,139,111,5,18,601,444,157,8
7519,2022-11-10 07:00:00,141,100,5,16,607,484,123,14
7520,2022-11-10 08:00:00,62,229,8,10,505,363,142,13
7521,2022-11-10 09:00:00,91,205,9,16,733,631,102,6
7522,2022-11-10 10:00:00,84,144,6,10,789,578,211,11
7523,2022-11-10 11:00:00,95,171,6,19,543,390,153,8
7524,2022-11-10 12:00:00,52,172,8,12,716,578,138,5
7525,2022-11-10 13:00:00,99,159,5,11,503,379,124,10
7526,2022-11-10 14:00:00,121,163,6,17,715,566,149,14
7527,2022-11-10 15:00:00,141,156,9,16,570,477,93,5
7528,2022-11-10 16:00:00,51,193,10,17,736,608,128,13
7529,2022-11-10 17:00:00,52,285,7,17,526,390,136,9
7530,2022-11-10 18:00:00,96,161,13,14,766,604,162,11
7531,2022-11-10 19:00:00,58,207,11,16,753,548,205,11
7532,2022-11-10 20:00:00,76,228,5,18,534,448,86,12
7533,2022-11-10 21:00:00,50,176,9,19,510,390,120,12
7534,2022-11-10 22:00:00,55,249,7,18,732,634,98,14
7535,2022-11-10 23:00:00,133,123,6,10,659,551,108,5
7536,2022-11-11 00:00:00,119,117,5,10,629,511,118,8
7537,2022-11-11 01:00:00,101,195,7,18,705,592,113,10
7538,2022-11-11 02:00:00,149,267,11,11,735,611,124,13
7539,2022-11-11 03:00:00,149,188,8,13,649,536,113,14
7540,2022-11-11 04:00:00,90,272,10,19,728,510,218,5
7541,2022-11-11 05:00:00,56,226,10,18,744,619,125,5
7542,2022-11-11 06:00:00,137,171,6,19,763,650,113,5
7543,2022-11-11 07:00:00,71,218,7,16,757,676,81,10
7544,2022-11-11 08:00:00,147,175,12,12,757,588,169,7
7545,2022-11-11 09:00:00,123,137,10,13,615,438,177,10
7546,2022-11-11 10:00:00,138,275,10,10,674,499,175,5
7547,2022-11-11 11:00:00,59,286,11,13,668,566,102,12
7548,2022-11-11 12:00:00,78,113,6,13,725,588,137,11
7549,2022-11-11 13:00:00,88,102,11,11,591,435,156,13
7550,2022-11-11 14:00:00,122,153,8,18,761,617,144,8
7551,2022-11-11 15:00:00,68,130,14,13,644,482,162,11
7552,2022-11-11 16:00:00,92,120,12,12,621,485,136,13
7553,2022-11-11 17:00:00,119,270,5,18,537,441,96,10
7554,2022-11-11 18:00:00,117,178,14,13,515,447,68,5
7555,2022-11-11 19:00:00,125,256,11,14,592,476,116,10
7556,2022-11-11 20:00:00,95,217,11,12,706,606,100,11
7557,2022-11-11 21:00:00,109,205,10,10,522,421,101,11
7558,2022-11-11 22:00:00,113,237,9,13,596,527,69,8
7559,2022-11-11 23:00:00,67,146,14,11,652,465,187,10
7560,2022-11-12 00:00:00,94,251,11,13,620,448,172,13
7561,2022-11-12 01:00:00,57,209,7,17,650,475,175,8
7562,2022-11-12 02:00:00,79,247,5,14,716,546,170,13
7563,2022-11-12 03:00:00,84,297,10,13,575,467,108,10
7564,2022-11-12 04:00:00,107,236,14,19,650,494,156,7
7565,2022-11-12 05:00:00,67,267,7,15,516,400,116,14
7566,2022-11-12 06:00:00,77,131,8,14,642,548,94,11
7567,2022-11-12 07:00:00,95,226,5,14,723,608,115,9
7568,2022-11-12 08:00:00,53,180,8,18,568,420,148,6
7569,2022-11-12 09:00:00,125,137,7,11,620,434,186,6
7570,2022-11-12 10:00:00,114,167,6,18,661,481,180,9
7571,2022-11-12 11:00:00,139,262,8,15,605,499,106,6
7572,2022-11-12 12:00:00,136,270,5,19,637,488,149,7
7573,2022-11-12 13:00:00,95,279,7,16,781,555,226,13
7574,2022-11-12 14:00:00,104,120,8,12,746,625,121,8
7575,2022-11-12 15:00:00,78,102,11,19,780,620,160,10
7576,2022-11-12 16:00:00,123,214,8,14,695,545,150,10
7577,2022-11-12 17:00:00,144,131,5,17,772,607,165,7
7578,2022-11-12 18:00:00,108,226,6,11,549,456,93,7
7579,2022-11-12 19:00:00,66,245,14,11,708,634,74,14
7580,2022-11-12 20:00:00,115,141,7,18,741,560,181,14
7581,2022-11-12 21:00:00,148,207,14,11,683,571,112,6
7582,2022-11-12 22:00:00,96,191,12,11,582,429,153,10
7583,2022-11-12 23:00:00,60,205,14,14,596,473,123,5
7584,2022-11-13 00:00:00,90,192,11,15,684,559,125,9
7585,2022-11-13 01:00:00,64,133,12,17,616,449,167,10
7586,2022-11-13 02:00:00,131,262,10,17,791,694,97,7
7587,2022-11-13 03:00:00,93,240,8,12,683,590,93,5
7588,2022-11-13 04:00:00,92,120,7,14,601,497,104,8
7589,2022-11-13 05:00:00,109,150,5,11,602,449,153,13
7590,2022-11-13 06:00:00,97,215,12,12,741,589,152,6
7591,2022-11-13 07:00:00,123,173,6,11,769,583,186,7
7592,2022-11-13 08:00:00,50,188,10,15,654,561,93,9
7593,2022-11-13 09:00:00,51,211,13,14,521,425,96,11
7594,2022-11-13 10:00:00,68,110,11,10,527,387,140,5
7595,2022-11-13 11:00:00,121,180,5,18,746,535,211,9
7596,2022-11-13 12:00:00,113,127,10,15,520,459,61,8
7597,2022-11-13 13:00:00,141,262,13,19,668,480,188,14
7598,2022-11-13 14:00:00,60,127,10,12,677,598,79,5
7599,2022-11-13 15:00:00,97,205,9,13,547,451,96,8
7600,2022-11-13 16:00:00,73,143,13,11,577,428,149,8
7601,2022-11-13 17:00:00,94,219,6,14,587,424,163,8
7602,2022-11-13 18:00:00,106,263,7,18,523,382,141,8
7603,2022-11-13 19:00:00,66,201,8,13,550,492,58,14
7604,2022-11-13 20:00:00,60,130,7,13,569,506,63,13
7605,2022-11-13 21:00:00,80,187,11,17,540,383,157,6
7606,2022-11-13 22:00:00,111,260,11,10,544,484,60,6
7607,2022-11-13 23:00:00,91,181,11,16,661,491,170,9
7608,2022-11-14 00:00:00,57,218,13,15,785,660,125,14
7609,2022-11-14 01:00:00,145,112,13,17,578,423,155,5
7610,2022-11-14 02:00:00,95,216,9,18,607,444,163,14
7611,2022-11-14 03:00:00,115,160,6,15,748,568,180,10
7612,2022-11-14 04:00:00,97,273,6,18,615,530,85,11
7613,2022-11-14 05:00:00,103,276,5,17,712,544,168,12
7614,2022-11-14 06:00:00,141,162,12,14,586,415,171,12
7615,2022-11-14 07:00:00,90,288,14,15,619,536,83,9
7616,2022-11-14 08:00:00,130,273,6,10,706,594,112,8
7617,2022-11-14 09:00:00,85,214,8,12,585,440,145,5
7618,2022-11-14 10:00:00,82,115,6,17,577,455,122,5
7619,2022-11-14 11:00:00,128,282,12,18,786,601,185,7
7620,2022-11-14 12:00:00,99,240,5,16,649,493,156,8
7621,2022-11-14 13:00:00,65,142,6,13,622,531,91,7
7622,2022-11-14 14:00:00,66,185,5,13,614,546,68,8
7623,2022-11-14 15:00:00,110,255,12,14,645,478,167,5
7624,2022-11-14 16:00:00,114,106,10,16,505,403,102,12
7625,2022-11-14 17:00:00,57,213,10,17,724,615,109,7
7626,2022-11-14 18:00:00,122,217,11,10,677,517,160,13
7627,2022-11-14 19:00:00,103,192,6,14,589,492,97,9
7628,2022-11-14 20:00:00,134,265,8,15,680,608,72,5
7629,2022-11-14 21:00:00,69,135,13,12,735,632,103,11
7630,2022-11-14 22:00:00,78,146,12,13,752,557,195,12
7631,2022-11-14 23:00:00,68,168,9,18,607,431,176,11
7632,2022-11-15 00:00:00,132,279,6,12,797,620,177,14
7633,2022-11-15 01:00:00,52,149,5,10,769,590,179,8
7634,2022-11-15 02:00:00,120,192,14,10,668,549,119,9
7635,2022-11-15 03:00:00,147,168,13,10,521,381,140,11
7636,2022-11-15 04:00:00,131,214,8,16,557,400,157,11
7637,2022-11-15 05:00:00,141,101,7,16,591,526,65,10
7638,2022-11-15 06:00:00,149,137,9,15,575,493,82,11
7639,2022-11-15 07:00:00,55,232,6,13,746,643,103,12
7640,2022-11-15 08:00:00,94,297,11,15,655,522,133,5
7641,2022-11-15 09:00:00,141,247,9,15,684,537,147,5
7642,2022-11-15 10:00:00,69,267,7,15,722,618,104,8
7643,2022-11-15 11:00:00,139,254,7,15,688,551,137,13
7644,2022-11-15 12:00:00,76,206,13,11,548,384,164,13
7645,2022-11-15 13:00:00,50,266,5,15,537,403,134,14
7646,2022-11-15 14:00:00,114,277,6,19,715,549,166,8
7647,2022-11-15 15:00:00,135,198,6,11,529,418,111,7
7648,2022-11-15 16:00:00,53,220,13,17,529,374,155,7
7649,2022-11-15 17:00:00,88,210,13,11,658,590,68,14
7650,2022-11-15 18:00:00,73,202,14,15,747,646,101,13
7651,2022-11-15 19:00:00,149,188,5,10,711,637,74,8
7652,2022-11-15 20:00:00,103,232,8,12,727,532,195,7
7653,2022-11-15 21:00:00,51,126,6,10,730,582,148,8
7654,2022-11-15 22:00:00,67,176,12,18,697,527,170,14
7655,2022-11-15 23:00:00,129,291,13,15,706,507,199,10
7656,2022-11-16 00:00:00,54,278,11,10,692,594,98,11
7657,2022-11-16 01:00:00,55,102,6,10,667,599,68,12
7658,2022-11-16 02:00:00,58,206,7,11,660,527,133,6
7659,2022-11-16 03:00:00,79,128,12,14,524,398,126,9
7660,2022-11-16 04:00:00,93,208,14,17,785,685,100,8
7661,2022-11-16 05:00:00,70,272,8,18,638,483,155,6
7662,2022-11-16 06:00:00,69,287,5,15,646,524,122,6
7663,2022-11-16 07:00:00,128,101,5,18,751,530,221,14
7664,2022-11-16 08:00:00,55,269,9,15,691,553,138,8
7665,2022-11-16 09:00:00,127,149,13,12,692,534,158,6
7666,2022-11-16 10:00:00,78,155,8,15,798,565,233,8
7667,2022-11-16 11:00:00,126,224,7,16,579,451,128,9
7668,2022-11-16 12:00:00,125,212,6,14,743,584,159,10
7669,2022-11-16 13:00:00,86,215,11,11,614,471,143,6
7670,2022-11-16 14:00:00,122,167,5,16,517,424,93,7
7671,2022-11-16 15:00:00,86,276,13,13,771,547,224,13
7672,2022-11-16 16:00:00,65,149,5,15,751,600,151,13
7673,2022-11-16 17:00:00,92,143,11,14,622,478,144,7
7674,2022-11-16 18:00:00,130,232,7,11,557,466,91,10
7675,2022-11-16 19:00:00,120,191,6,15,575,460,115,6
7676,2022-11-16 20:00:00,122,115,6,18,733,620,113,11
7677,2022-11-16 21:00:00,61,175,7,16,518,366,152,13
7678,2022-11-16 22:00:00,69,163,13,18,639,564,75,12
7679,2022-11-16 23:00:00,141,270,10,16,615,511,104,11
7680,2022-11-17 00:00:00,108,270,12,17,623,478,145,8
7681,2022-11-17 01:00:00,76,123,12,16,685,512,173,5
7682,2022-11-17 02:00:00,82,215,12,17,622,457,165,9
7683,2022-11-17 03:00:00,143,271,10,12,776,556,220,8
7684,2022-11-17 04:00:00,148,275,14,16,569,474,95,12
7685,2022-11-17 05:00:00,116,133,9,17,781,548,233,6
7686,2022-11-17 06:00:00,107,172,14,18,772,580,192,6
7687,2022-11-17 07:00:00,104,299,6,13,679,503,176,14
7688,2022-11-17 08:00:00,145,233,8,17,735,588,147,8
7689,2022-11-17 09:00:00,93,297,11,12,756,639,117,6
7690,2022-11-17 10:00:00,114,258,5,14,507,387,120,14
7691,2022-11-17 11:00:00,82,110,8,16,531,456,75,8
7692,2022-11-17 12:00:00,137,263,10,13,752,578,174,14
7693,2022-11-17 13:00:00,87,195,12,10,736,621,115,14
7694,2022-11-17 14:00:00,85,175,13,14,687,548,139,11
7695,2022-11-17 15:00:00,93,251,11,15,596,494,102,14
7696,2022-11-17 16:00:00,120,173,8,16,516,460,56,11
7697,2022-11-17 17:00:00,143,126,11,15,500,415,85,12
7698,2022-11-17 18:00:00,97,130,5,11,681,595,86,12
7699,2022-11-17 19:00:00,128,201,11,12,797,674,123,5
7700,2022-11-17 20:00:00,108,144,10,17,542,445,97,13
7701,2022-11-17 21:00:00,63,138,11,12,575,478,97,10
7702,2022-11-17 22:00:00,133,258,14,11,555,392,163,9
7703,2022-11-17 23:00:00,100,268,5,14,547,461,86,9
7704,2022-11-18 00:00:00,104,256,12,14,533,405,128,10
7705,2022-11-18 01:00:00,72,135,10,19,747,568,179,12
7706,2022-11-18 02:00:00,57,196,12,16,514,444,70,11
7707,2022-11-18 03:00:00,56,113,5,18,586,518,68,10
7708,2022-11-18 04:00:00,141,195,8,15,718,554,164,7
7709,2022-11-18 05:00:00,142,243,9,14,561,424,137,7
7710,2022-11-18 06:00:00,104,116,11,17,557,411,146,6
7711,2022-11-18 07:00:00,145,121,6,10,773,630,143,10
7712,2022-11-18 08:00:00,122,180,13,10,617,504,113,12
7713,2022-11-18 09:00:00,136,288,13,15,660,493,167,7
7714,2022-11-18 10:00:00,98,125,11,14,530,459,71,6
7715,2022-11-18 11:00:00,114,225,5,16,650,565,85,9
7716,2022-11-18 12:00:00,65,267,11,16,703,533,170,6
7717,2022-11-18 13:00:00,54,276,5,10,622,504,118,8
7718,2022-11-18 14:00:00,68,183,12,17,766,677,89,12
7719,2022-11-18 15:00:00,107,136,11,13,787,655,132,9
7720,2022-11-18 16:00:00,63,265,6,12,754,543,211,6
7721,2022-11-18 17:00:00,65,180,8,15,534,446,88,9
7722,2022-11-18 18:00:00,137,273,14,19,608,439,169,10
7723,2022-11-18 19:00:00,148,274,9,11,776,670,106,8
7724,2022-11-18 20:00:00,87,279,11,15,660,549,111,13
7725,2022-11-18 21:00:00,55,200,7,18,758,656,102,9
7726,2022-11-18 22:00:00,145,275,5,16,761,613,148,5
7727,2022-11-18 23:00:00,115,192,12,15,593,430,163,7
7728,2022-11-19 00:00:00,132,268,11,16,623,538,85,10
7729,2022-11-19 01:00:00,135,284,12,17,778,634,144,7
7730,2022-11-19 02:00:00,53,136,10,16,670,552,118,10
7731,2022-11-19 03:00:00,147,153,12,15,712,583,129,12
7732,2022-11-19 04:00:00,129,246,5,13,521,456,65,5
7733,2022-11-19 05:00:00,76,279,7,16,548,387,161,8
7734,2022-11-19 06:00:00,72,173,7,15,657,507,150,14
7735,2022-11-19 07:00:00,68,237,5,10,640,551,89,11
7736,2022-11-19 08:00:00,127,249,10,18,692,618,74,12
7737,2022-11-19 09:00:00,87,254,6,17,602,443,159,12
7738,2022-11-19 10:00:00,148,161,11,10,607,444,163,5
7739,2022-11-19 11:00:00,149,119,13,12,657,559,98,11
7740,2022-11-19 12:00:00,123,172,13,14,689,510,179,6
7741,2022-11-19 13:00:00,121,217,11,11,582,443,139,10
7742,2022-11-19 14:00:00,115,107,8,15,580,452,128,9
7743,2022-11-19 15:00:00,62,103,6,15,681,545,136,9
7744,2022-11-19 16:00:00,60,261,10,14,560,413,147,5
7745,2022-11-19 17:00:00,136,267,8,10,549,435,114,7
7746,2022-11-19 18:00:00,132,287,13,11,523,390,133,14
7747,2022-11-19 19:00:00,128,296,11,10,663,499,164,10
7748,2022-11-19 20:00:00,72,115,5,19,755,649,106,10
7749,2022-11-19 21:00:00,106,121,11,16,696,523,173,14
7750,2022-11-19 22:00:00,109,164,9,18,631,473,158,7
7751,2022-11-19 23:00:00,137,136,13,11,702,501,201,8
7752,2022-11-20 00:00:00,74,125,12,16,690,610,80,11
7753,2022-11-20 01:00:00,122,187,8,11,517,380,137,12
7754,2022-11-20 02:00:00,143,270,14,18,523,461,62,12
7755,2022-11-20 03:00:00,56,177,13,13,740,534,206,12
7756,2022-11-20 04:00:00,117,160,12,18,620,524,96,10
7757,2022-11-20 05:00:00,68,252,10,14,624,467,157,13
7758,2022-11-20 06:00:00,128,141,11,13,721,599,122,6
7759,2022-11-20 07:00:00,135,133,9,14,596,417,179,14
7760,2022-11-20 08:00:00,55,184,6,13,603,500,103,11
7761,2022-11-20 09:00:00,140,270,13,19,700,562,138,13
7762,2022-11-20 10:00:00,132,203,12,15,793,625,168,8
7763,2022-11-20 11:00:00,105,286,5,13,562,404,158,6
7764,2022-11-20 12:00:00,78,238,5,17,577,477,100,14
7765,2022-11-20 13:00:00,82,228,9,16,582,522,60,6
7766,2022-11-20 14:00:00,116,147,14,17,786,693,93,6
7767,2022-11-20 15:00:00,112,233,14,11,703,520,183,7
7768,2022-11-20 16:00:00,52,207,11,18,568,502,66,6
7769,2022-11-20 17:00:00,81,253,11,15,656,588,68,6
7770,2022-11-20 18:00:00,136,207,5,18,691,497,194,14
7771,2022-11-20 19:00:00,131,275,10,12,597,432,165,14
7772,2022-11-20 20:00:00,126,201,9,17,675,478,197,5
7773,2022-11-20 21:00:00,110,223,8,12,718,547,171,11
7774,2022-11-20 22:00:00,99,274,13,10,657,464,193,9
7775,2022-11-20 23:00:00,112,292,5,14,519,408,111,14
7776,2022-11-21 00:00:00,80,192,12,15,555,488,67,6
7777,2022-11-21 01:00:00,85,196,9,12,716,581,135,7
7778,2022-11-21 02:00:00,83,154,10,14,622,451,171,8
7779,2022-11-21 03:00:00,51,260,6,12,751,564,187,11
7780,2022-11-21 04:00:00,80,124,8,10,720,619,101,14
7781,2022-11-21 05:00:00,52,237,14,15,524,386,138,12
7782,2022-11-21 06:00:00,123,149,12,17,550,473,77,6
7783,2022-11-21 07:00:00,50,162,9,17,723,543,180,14
7784,2022-11-21 08:00:00,85,166,13,10,535,434,101,13
7785,2022-11-21 09:00:00,113,245,6,15,769,564,205,14
7786,2022-11-21 10:00:00,51,113,12,13,747,612,135,10
7787,2022-11-21 11:00:00,87,193,14,10,552,420,132,5
7788,2022-11-21 12:00:00,101,277,6,14,530,436,94,8
7789,2022-11-21 13:00:00,130,218,13,12,635,524,111,11
7790,2022-11-21 14:00:00,144,111,12,15,502,371,131,13
7791,2022-11-21 15:00:00,92,138,12,16,688,493,195,13
7792,2022-11-21 16:00:00,117,257,12,18,597,530,67,11
7793,2022-11-21 17:00:00,92,207,14,19,667,599,68,12
7794,2022-11-21 18:00:00,134,172,13,19,722,607,115,6
7795,2022-11-21 19:00:00,124,176,13,12,657,567,90,8
7796,2022-11-21 20:00:00,69,128,7,11,675,474,201,8
7797,2022-11-21 21:00:00,136,187,5,17,640,500,140,10
7798,2022-11-21 22:00:00,149,125,10,13,643,501,142,8
7799,2022-11-21 23:00:00,108,215,9,13,750,671,79,9
7800,2022-11-22 00:00:00,50,197,14,19,545,418,127,7
7801,2022-11-22 01:00:00,101,210,10,11,780,546,234,6
7802,2022-11-22 02:00:00,130,191,5,13,779,573,206,9
7803,2022-11-22 03:00:00,147,115,13,12,774,649,125,11
7804,2022-11-22 04:00:00,121,278,6,16,516,457,59,9
7805,2022-11-22 05:00:00,66,262,9,16,567,468,99,5
7806,2022-11-22 06:00:00,134,103,11,13,523,398,125,8
7807,2022-11-22 07:00:00,95,221,11,10,552,454,98,7
7808,2022-11-22 08:00:00,60,251,13,13,672,567,105,9
7809,2022-11-22 09:00:00,108,245,10,16,690,592,98,10
7810,2022-11-22 10:00:00,91,253,8,19,627,465,162,10
7811,2022-11-22 11:00:00,118,289,8,18,751,564,187,10
7812,2022-11-22 12:00:00,106,263,10,11,709,514,195,14
7813,2022-11-22 13:00:00,70,207,9,10,689,492,197,6
7814,2022-11-22 14:00:00,53,186,13,11,526,416,110,13
7815,2022-11-22 15:00:00,136,245,9,19,790,590,200,6
7816,2022-11-22 16:00:00,92,182,9,14,663,494,169,5
7817,2022-11-22 17:00:00,91,204,12,13,605,517,88,5
7818,2022-11-22 18:00:00,124,269,12,11,703,506,197,8
7819,2022-11-22 19:00:00,141,290,13,17,612,475,137,14
7820,2022-11-22 20:00:00,66,112,10,10,746,529,217,12
7821,2022-11-22 21:00:00,73,125,6,19,716,534,182,14
7822,2022-11-22 22:00:00,77,186,6,15,748,659,89,10
7823,2022-11-22 23:00:00,133,147,13,18,791,559,232,8
7824,2022-11-23 00:00:00,124,173,13,18,704,582,122,7
7825,2022-11-23 01:00:00,56,236,11,10,708,546,162,5
7826,2022-11-23 02:00:00,115,167,7,16,637,491,146,9
7827,2022-11-23 03:00:00,108,211,5,17,686,488,198,5
7828,2022-11-23 04:00:00,134,148,9,17,575,420,155,5
7829,2022-11-23 05:00:00,121,115,6,14,511,452,59,14
7830,2022-11-23 06:00:00,89,247,8,12,566,505,61,5
7831,2022-11-23 07:00:00,84,130,7,10,752,587,165,12
7832,2022-11-23 08:00:00,72,147,5,13,523,449,74,6
7833,2022-11-23 09:00:00,68,150,9,19,762,646,116,14
7834,2022-11-23 10:00:00,71,118,5,10,619,497,122,7
7835,2022-11-23 11:00:00,146,178,9,15,771,611,160,14
7836,2022-11-23 12:00:00,100,150,9,14,536,435,101,5
7837,2022-11-23 13:00:00,138,168,8,18,787,705,82,7
7838,2022-11-23 14:00:00,120,297,10,17,760,676,84,14
7839,2022-11-23 15:00:00,107,111,5,14,786,658,128,10
7840,2022-11-23 16:00:00,133,264,11,15,744,555,189,6
7841,2022-11-23 17:00:00,56,194,5,13,690,549,141,11
7842,2022-11-23 18:00:00,74,134,10,11,759,676,83,8
7843,2022-11-23 19:00:00,107,186,12,17,529,437,92,11
7844,2022-11-23 20:00:00,141,270,13,10,656,492,164,12
7845,2022-11-23 21:00:00,64,214,9,12,671,534,137,5
7846,2022-11-23 22:00:00,138,148,10,13,744,565,179,13
7847,2022-11-23 23:00:00,131,288,12,16,569,422,147,11
7848,2022-11-24 00:00:00,55,250,13,12,724,606,118,6
7849,2022-11-24 01:00:00,131,269,8,11,557,496,61,8
7850,2022-11-24 02:00:00,55,157,13,13,712,636,76,12
7851,2022-11-24 03:00:00,94,159,11,10,689,508,181,6
7852,2022-11-24 04:00:00,88,135,10,15,585,518,67,12
7853,2022-11-24 05:00:00,142,166,9,15,691,485,206,5
7854,2022-11-24 06:00:00,118,188,9,12,561,463,98,7
7855,2022-11-24 07:00:00,145,246,13,18,748,602,146,7
7856,2022-11-24 08:00:00,113,212,12,17,796,702,94,6
7857,2022-11-24 09:00:00,131,152,12,14,560,419,141,11
7858,2022-11-24 10:00:00,98,263,5,16,750,527,223,6
7859,2022-11-24 11:00:00,82,275,8,15,665,580,85,8
7860,2022-11-24 12:00:00,123,120,9,17,555,411,144,6
7861,2022-11-24 13:00:00,130,174,8,10,763,658,105,13
7862,2022-11-24 14:00:00,106,242,7,15,791,564,227,12
7863,2022-11-24 15:00:00,133,243,6,16,587,473,114,8
7864,2022-11-24 16:00:00,55,289,12,10,696,593,103,12
7865,2022-11-24 17:00:00,50,296,8,16,672,486,186,12
7866,2022-11-24 18:00:00,128,124,7,13,723,563,160,9
7867,2022-11-24 19:00:00,120,185,13,11,734,628,106,12
7868,2022-11-24 20:00:00,77,273,11,14,550,445,105,11
7869,2022-11-24 21:00:00,148,226,13,16,696,625,71,6
7870,2022-11-24 22:00:00,127,157,14,12,633,491,142,9
7871,2022-11-24 23:00:00,132,183,12,16,580,457,123,12
7872,2022-11-25 00:00:00,140,257,14,19,688,487,201,7
7873,2022-11-25 01:00:00,64,169,5,13,777,548,229,11
7874,2022-11-25 02:00:00,113,138,7,17,645,546,99,9
7875,2022-11-25 03:00:00,55,106,7,16,700,547,153,7
7876,2022-11-25 04:00:00,100,186,9,14,597,431,166,13
7877,2022-11-25 05:00:00,58,160,12,19,622,462,160,7
7878,2022-11-25 06:00:00,121,202,12,18,744,634,110,7
7879,2022-11-25 07:00:00,85,113,13,12,787,634,153,7
7880,2022-11-25 08:00:00,98,216,10,16,719,515,204,12
7881,2022-11-25 09:00:00,132,230,7,13,668,583,85,12
7882,2022-11-25 10:00:00,113,267,12,15,639,449,190,7
7883,2022-11-25 11:00:00,91,249,7,18,672,509,163,6
7884,2022-11-25 12:00:00,95,103,13,10,606,462,144,13
7885,2022-11-25 13:00:00,88,117,7,13,749,636,113,10
7886,2022-11-25 14:00:00,68,124,7,19,591,510,81,9
7887,2022-11-25 15:00:00,124,186,9,16,603,521,82,6
7888,2022-11-25 16:00:00,51,247,12,14,615,516,99,5
7889,2022-11-25 17:00:00,115,136,11,15,638,511,127,7
7890,2022-11-25 18:00:00,94,218,6,13,574,451,123,5
7891,2022-11-25 19:00:00,79,242,5,13,720,521,199,8
7892,2022-11-25 20:00:00,60,213,10,14,759,552,207,9
7893,2022-11-25 21:00:00,106,108,9,15,627,555,72,13
7894,2022-11-25 22:00:00,131,121,5,16,566,452,114,6
7895,2022-11-25 23:00:00,53,172,12,17,717,559,158,13
7896,2022-11-26 00:00:00,86,214,7,18,604,481,123,12
7897,2022-11-26 01:00:00,105,177,12,11,652,513,139,7
7898,2022-11-26 02:00:00,142,237,12,17,577,418,159,9
7899,2022-11-26 03:00:00,127,278,13,18,689,560,129,7
7900,2022-11-26 04:00:00,56,163,12,10,728,599,129,7
7901,2022-11-26 05:00:00,96,173,5,19,730,613,117,14
7902,2022-11-26 06:00:00,79,175,9,12,578,416,162,8
7903,2022-11-26 07:00:00,84,132,8,17,668,549,119,11
7904,2022-11-26 08:00:00,105,178,9,17,702,506,196,12
7905,2022-11-26 09:00:00,95,130,10,16,726,549,177,9
7906,2022-11-26 10:00:00,143,149,6,19,669,500,169,12
7907,2022-11-26 11:00:00,125,174,6,13,553,428,125,12
7908,2022-11-26 12:00:00,62,158,9,17,641,490,151,14
7909,2022-11-26 13:00:00,78,161,6,11,583,449,134,13
7910,2022-11-26 14:00:00,107,201,10,10,602,460,142,8
7911,2022-11-26 15:00:00,76,226,6,14,606,446,160,6
7912,2022-11-26 16:00:00,107,280,10,12,510,383,127,9
7913,2022-11-26 17:00:00,118,204,14,17,602,527,75,14
7914,2022-11-26 18:00:00,83,288,14,10,667,521,146,9
7915,2022-11-26 19:00:00,113,229,5,12,711,589,122,13
7916,2022-11-26 20:00:00,86,167,8,14,742,563,179,5
7917,2022-11-26 21:00:00,103,122,7,15,653,494,159,5
7918,2022-11-26 22:00:00,86,143,9,16,681,555,126,13
7919,2022-11-26 23:00:00,62,140,11,13,533,408,125,7
7920,2022-11-27 00:00:00,89,266,7,15,570,413,157,13
7921,2022-11-27 01:00:00,65,131,8,10,787,626,161,10
7922,2022-11-27 02:00:00,104,242,14,11,651,473,178,14
7923,2022-11-27 03:00:00,72,241,12,15,509,445,64,7
7924,2022-11-27 04:00:00,72,272,13,11,523,454,69,11
7925,2022-11-27 05:00:00,141,216,6,12,598,473,125,5
7926,2022-11-27 06:00:00,103,252,10,11,658,499,159,10
7927,2022-11-27 07:00:00,90,205,6,19,510,394,116,11
7928,2022-11-27 08:00:00,119,256,5,15,720,642,78,10
7929,2022-11-27 09:00:00,127,143,14,13,532,387,145,14
7930,2022-11-27 10:00:00,124,163,8,12,595,524,71,14
7931,2022-11-27 11:00:00,80,223,12,16,604,422,182,10
7932,2022-11-27 12:00:00,50,131,12,19,582,425,157,5
7933,2022-11-27 13:00:00,146,133,14,16,704,555,149,11
7934,2022-11-27 14:00:00,59,240,7,17,754,579,175,14
7935,2022-11-27 15:00:00,140,218,7,18,611,515,96,7
7936,2022-11-27 16:00:00,94,246,7,12,545,443,102,12
7937,2022-11-27 17:00:00,64,192,10,14,768,668,100,10
7938,2022-11-27 18:00:00,71,102,10,18,755,625,130,9
7939,2022-11-27 19:00:00,130,176,10,19,562,501,61,13
7940,2022-11-27 20:00:00,120,270,5,11,668,514,154,7
7941,2022-11-27 21:00:00,114,210,14,17,577,511,66,6
7942,2022-11-27 22:00:00,76,163,6,12,641,513,128,5
7943,2022-11-27 23:00:00,110,222,14,13,505,379,126,10
7944,2022-11-28 00:00:00,101,143,9,15,758,629,129,13
7945,2022-11-28 01:00:00,85,266,14,16,515,442,73,5
7946,2022-11-28 02:00:00,141,124,10,10,750,537,213,14
7947,2022-11-28 03:00:00,70,176,7,16,774,612,162,5
7948,2022-11-28 04:00:00,133,221,11,13,680,507,173,9
7949,2022-11-28 05:00:00,69,230,6,18,665,578,87,7
7950,2022-11-28 06:00:00,117,112,13,10,718,536,182,9
7951,2022-11-28 07:00:00,65,168,5,10,624,454,170,6
7952,2022-11-28 08:00:00,120,107,9,19,686,553,133,13
7953,2022-11-28 09:00:00,137,248,12,10,761,561,200,8
7954,2022-11-28 10:00:00,55,117,11,10,566,469,97,10
7955,2022-11-28 11:00:00,148,231,11,12,788,639,149,9
7956,2022-11-28 12:00:00,116,100,8,19,664,470,194,10
7957,2022-11-28 13:00:00,112,195,7,13,603,513,90,7
7958,2022-11-28 14:00:00,125,138,8,11,654,520,134,9
7959,2022-11-28 15:00:00,58,239,6,12,626,511,115,5
7960,2022-11-28 16:00:00,59,220,6,11,799,640,159,12
7961,2022-11-28 17:00:00,95,273,12,15,596,457,139,11
7962,2022-11-28 18:00:00,77,170,8,10,590,520,70,12
7963,2022-11-28 19:00:00,144,288,6,18,547,430,117,14
7964,2022-11-28 20:00:00,76,178,9,10,781,666,115,10
7965,2022-11-28 21:00:00,86,225,9,17,679,546,133,11
7966,2022-11-28 22:00:00,111,165,7,18,636,467,169,6
7967,2022-11-28 23:00:00,111,104,9,16,709,549,160,13
7968,2022-11-29 00:00:00,120,274,14,13,629,445,184,10
7969,2022-11-29 01:00:00,75,251,8,13,766,554,212,9
7970,2022-11-29 02:00:00,99,246,9,13,545,450,95,6
7971,2022-11-29 03:00:00,87,230,8,18,524,447,77,14
7972,2022-11-29 04:00:00,75,180,14,13,574,454,120,10
7973,2022-11-29 05:00:00,119,268,7,13,711,630,81,6
7974,2022-11-29 06:00:00,65,170,12,14,532,403,129,14
7975,2022-11-29 07:00:00,111,212,13,11,573,423,150,10
7976,2022-11-29 08:00:00,137,222,6,11,764,608,156,9
7977,2022-11-29 09:00:00,75,136,5,18,765,677,88,14
7978,2022-11-29 10:00:00,91,141,10,16,792,649,143,13
7979,2022-11-29 11:00:00,126,115,6,16,633,495,138,8
7980,2022-11-29 12:00:00,62,278,8,18,634,562,72,13
7981,2022-11-29 13:00:00,117,241,9,18,770,574,196,9
7982,2022-11-29 14:00:00,71,253,13,17,749,551,198,6
7983,2022-11-29 15:00:00,102,150,8,15,570,509,61,9
7984,2022-11-29 16:00:00,82,191,13,12,783,575,208,8
7985,2022-11-29 17:00:00,81,221,9,18,634,568,66,14
7986,2022-11-29 18:00:00,134,102,7,14,691,533,158,7
7987,2022-11-29 19:00:00,120,110,14,17,655,502,153,6
7988,2022-11-29 20:00:00,110,129,13,10,708,551,157,7
7989,2022-11-29 21:00:00,135,199,11,17,794,678,116,9
7990,2022-11-29 22:00:00,126,124,14,17,571,414,157,12
7991,2022-11-29 23:00:00,146,215,9,17,774,690,84,9
7992,2022-11-30 00:00:00,120,262,14,18,672,547,125,11
7993,2022-11-30 01:00:00,51,164,8,18,698,535,163,10
7994,2022-11-30 02:00:00,106,115,8,14,655,567,88,11
7995,2022-11-30 03:00:00,68,156,14,16,518,363,155,7
7996,2022-11-30 04:00:00,130,269,5,15,528,428,100,10
7997,2022-11-30 05:00:00,89,243,14,17,646,519,127,12
7998,2022-11-30 06:00:00,87,118,9,13,565,495,70,8
7999,2022-11-30 07:00:00,113,127,14,16,501,419,82,7
8000,2022-11-30 08:00:00,61,155,7,15,581,420,161,13
8001,2022-11-30 09:00:00,130,138,12,18,713,618,95,10
8002,2022-11-30 10:00:00,101,125,12,12,663,528,135,7
8003,2022-11-30 11:00:00,94,216,9,17,797,702,95,5
8004,2022-11-30 12:00:00,120,285,13,13,761,591,170,14
8005,2022-11-30 13:00:00,60,157,10,11,525,406,119,10
8006,2022-11-30 14:00:00,117,139,10,14,674,492,182,5
8007,2022-11-30 15:00:00,147,141,13,14,662,565,97,5
8008,2022-11-30 16:00:00,142,267,11,15,646,569,77,9
8009,2022-11-30 17:00:00,53,189,11,19,733,658,75,8
8010,2022-11-30 18:00:00,69,173,5,18,550,418,132,12
8011,2022-11-30 19:00:00,68,210,10,12,772,684,88,13
8012,2022-11-30 20:00:00,58,114,5,16,711,583,128,14
8013,2022-11-30 21:00:00,53,198,5,17,657,501,156,12
8014,2022-11-30 22:00:00,105,153,9,10,522,442,80,12
8015,2022-11-30 23:00:00,121,129,6,14,580,487,93,14
8016,2022-12-01 00:00:00,112,271,14,14,652,583,69,10
8017,2022-12-01 01:00:00,106,147,7,18,615,509,106,10
8018,2022-12-01 02:00:00,52,213,8,10,575,475,100,9
8019,2022-12-01 03:00:00,91,287,5,16,515,381,134,5
8020,2022-12-01 04:00:00,66,194,9,18,712,512,200,5
8021,2022-12-01 05:00:00,65,115,12,10,510,433,77,6
8022,2022-12-01 06:00:00,80,216,8,10,691,529,162,7
8023,2022-12-01 07:00:00,57,162,11,12,748,620,128,6
8024,2022-12-01 08:00:00,94,259,11,14,570,423,147,13
8025,2022-12-01 09:00:00,82,139,6,19,736,605,131,12
8026,2022-12-01 10:00:00,110,201,8,15,753,585,168,10
8027,2022-12-01 11:00:00,148,183,10,15,558,426,132,9
8028,2022-12-01 12:00:00,113,140,7,11,640,553,87,10
8029,2022-12-01 13:00:00,88,152,13,10,784,703,81,13
8030,2022-12-01 14:00:00,67,133,7,17,607,435,172,8
8031,2022-12-01 15:00:00,136,155,14,16,518,385,133,11
8032,2022-12-01 16:00:00,102,147,13,12,638,497,141,13
8033,2022-12-01 17:00:00,101,177,13,18,578,459,119,7
8034,2022-12-01 18:00:00,115,282,11,12,654,458,196,12
8035,2022-12-01 19:00:00,125,219,6,13,737,659,78,10
8036,2022-12-01 20:00:00,82,125,6,10,556,440,116,9
8037,2022-12-01 21:00:00,84,291,6,10,756,541,215,11
8038,2022-12-01 22:00:00,119,168,13,17,645,467,178,6
8039,2022-12-01 23:00:00,117,249,13,18,538,464,74,8
8040,2022-12-02 00:00:00,114,254,14,18,695,549,146,7
8041,2022-12-02 01:00:00,114,115,6,15,620,535,85,12
8042,2022-12-02 02:00:00,70,211,11,18,646,516,130,13
8043,2022-12-02 03:00:00,63,128,8,15,726,586,140,14
8044,2022-12-02 04:00:00,145,291,13,16,709,563,146,10
8045,2022-12-02 05:00:00,120,259,6,10,540,472,68,14
8046,2022-12-02 06:00:00,96,138,5,15,718,535,183,10
8047,2022-12-02 07:00:00,64,272,6,13,682,555,127,8
8048,2022-12-02 08:00:00,118,211,11,11,791,704,87,11
8049,2022-12-02 09:00:00,68,171,11,15,514,371,143,11
8050,2022-12-02 10:00:00,71,115,11,19,763,568,195,11
8051,2022-12-02 11:00:00,147,108,11,10,661,570,91,11
8052,2022-12-02 12:00:00,131,151,7,19,508,377,131,7
8053,2022-12-02 13:00:00,87,278,10,13,533,460,73,13
8054,2022-12-02 14:00:00,98,253,12,12,781,596,185,11
8055,2022-12-02 15:00:00,84,178,14,19,662,543,119,7
8056,2022-12-02 16:00:00,133,153,9,17,775,579,196,12
8057,2022-12-02 17:00:00,105,208,14,18,630,506,124,12
8058,2022-12-02 18:00:00,122,228,9,13,531,437,94,5
8059,2022-12-02 19:00:00,65,204,12,19,506,410,96,12
8060,2022-12-02 20:00:00,115,219,8,17,598,530,68,9
8061,2022-12-02 21:00:00,123,210,13,17,521,451,70,5
8062,2022-12-02 22:00:00,107,279,11,18,648,553,95,12
8063,2022-12-02 23:00:00,136,185,10,17,727,567,160,5
8064,2022-12-03 00:00:00,56,208,11,14,632,459,173,10
8065,2022-12-03 01:00:00,100,264,5,10,682,497,185,11
8066,2022-12-03 02:00:00,50,181,7,15,792,631,161,11
8067,2022-12-03 03:00:00,76,186,11,12,768,645,123,7
8068,2022-12-03 04:00:00,138,196,12,13,664,553,111,9
8069,2022-12-03 05:00:00,117,115,5,16,617,439,178,11
8070,2022-12-03 06:00:00,74,195,11,14,510,408,102,11
8071,2022-12-03 07:00:00,54,146,7,10,712,588,124,10
8072,2022-12-03 08:00:00,115,118,14,18,579,514,65,12
8073,2022-12-03 09:00:00,89,163,5,17,649,492,157,7
8074,2022-12-03 10:00:00,117,214,14,17,636,566,70,9
8075,2022-12-03 11:00:00,142,152,7,10,604,496,108,7
8076,2022-12-03 12:00:00,123,195,14,17,670,476,194,9
8077,2022-12-03 13:00:00,142,249,13,10,534,478,56,11
8078,2022-12-03 14:00:00,86,176,14,13,693,523,170,7
8079,2022-12-03 15:00:00,117,150,13,17,753,545,208,14
8080,2022-12-03 16:00:00,76,147,11,14,703,496,207,6
8081,2022-12-03 17:00:00,64,219,11,11,727,626,101,7
8082,2022-12-03 18:00:00,115,254,7,18,693,623,70,10
8083,2022-12-03 19:00:00,145,260,13,19,510,390,120,9
8084,2022-12-03 20:00:00,144,163,12,14,794,592,202,13
8085,2022-12-03 21:00:00,54,131,9,18,558,426,132,11
8086,2022-12-03 22:00:00,83,185,8,16,563,469,94,5
8087,2022-12-03 23:00:00,104,295,9,13,688,533,155,5
8088,2022-12-04 00:00:00,146,268,6,10,732,517,215,11
8089,2022-12-04 01:00:00,63,219,5,15,556,493,63,7
8090,2022-12-04 02:00:00,51,195,6,16,592,467,125,5
8091,2022-12-04 03:00:00,62,168,6,13,631,491,140,7
8092,2022-12-04 04:00:00,56,159,13,19,624,482,142,9
8093,2022-12-04 05:00:00,138,274,9,14,675,559,116,14
8094,2022-12-04 06:00:00,89,177,11,13,702,614,88,8
8095,2022-12-04 07:00:00,134,277,9,13,673,521,152,5
8096,2022-12-04 08:00:00,62,233,14,19,505,392,113,14
8097,2022-12-04 09:00:00,76,198,7,16,522,397,125,11
8098,2022-12-04 10:00:00,54,197,11,14,555,408,147,8
8099,2022-12-04 11:00:00,57,134,5,12,772,615,157,8
8100,2022-12-04 12:00:00,91,213,14,12,760,592,168,6
8101,2022-12-04 13:00:00,145,140,10,17,791,694,97,13
8102,2022-12-04 14:00:00,76,149,11,17,649,496,153,12
8103,2022-12-04 15:00:00,64,266,9,11,698,573,125,12
8104,2022-12-04 16:00:00,129,163,12,18,659,585,74,12
8105,2022-12-04 17:00:00,124,226,7,13,542,452,90,11
8106,2022-12-04 18:00:00,72,278,10,11,755,675,80,9
8107,2022-12-04 19:00:00,146,214,13,16,708,541,167,11
8108,2022-12-04 20:00:00,133,239,14,17,502,370,132,14
8109,2022-12-04 21:00:00,57,167,6,13,795,645,150,6
8110,2022-12-04 22:00:00,146,274,10,17,692,610,82,7
8111,2022-12-04 23:00:00,59,238,8,14,596,531,65,8
8112,2022-12-05 00:00:00,137,291,9,19,629,447,182,7
8113,2022-12-05 01:00:00,113,235,12,10,721,607,114,14
8114,2022-12-05 02:00:00,93,242,10,13,700,629,71,13
8115,2022-12-05 03:00:00,88,295,10,18,520,452,68,7
8116,2022-12-05 04:00:00,56,104,10,16,730,517,213,7
8117,2022-12-05 05:00:00,64,116,13,19,660,486,174,14
8118,2022-12-05 06:00:00,68,134,8,16,635,453,182,11
8119,2022-12-05 07:00:00,140,206,5,12,757,591,166,5
8120,2022-12-05 08:00:00,57,150,10,12,539,402,137,8
8121,2022-12-05 09:00:00,92,228,10,12,637,460,177,12
8122,2022-12-05 10:00:00,57,103,11,13,790,612,178,8
8123,2022-12-05 11:00:00,52,262,10,14,656,542,114,13
8124,2022-12-05 12:00:00,66,264,5,16,649,521,128,5
8125,2022-12-05 13:00:00,101,161,14,14,560,417,143,10
8126,2022-12-05 14:00:00,78,248,13,11,666,560,106,7
8127,2022-12-05 15:00:00,56,293,14,10,551,397,154,7
8128,2022-12-05 16:00:00,64,274,6,12,699,576,123,13
8129,2022-12-05 17:00:00,110,115,12,15,745,577,168,13
8130,2022-12-05 18:00:00,52,188,12,12,745,542,203,10
8131,2022-12-05 19:00:00,83,124,9,10,795,715,80,14
8132,2022-12-05 20:00:00,96,204,9,12,612,456,156,6
8133,2022-12-05 21:00:00,76,153,5,11,706,579,127,6
8134,2022-12-05 22:00:00,99,144,8,10,737,603,134,8
8135,2022-12-05 23:00:00,116,290,11,12,759,646,113,6
8136,2022-12-06 00:00:00,97,216,8,13,564,403,161,11
8137,2022-12-06 01:00:00,79,106,8,19,600,513,87,9
8138,2022-12-06 02:00:00,121,219,13,11,768,644,124,8
8139,2022-12-06 03:00:00,64,207,14,19,622,499,123,12
8140,2022-12-06 04:00:00,130,230,7,16,793,665,128,6
8141,2022-12-06 05:00:00,116,181,14,18,721,519,202,6
8142,2022-12-06 06:00:00,92,175,6,16,702,559,143,7
8143,2022-12-06 07:00:00,142,234,8,16,791,643,148,8
8144,2022-12-06 08:00:00,100,141,6,17,707,581,126,13
8145,2022-12-06 09:00:00,103,296,10,12,777,630,147,8
8146,2022-12-06 10:00:00,50,283,6,18,680,512,168,5
8147,2022-12-06 11:00:00,55,162,5,10,585,469,116,5
8148,2022-12-06 12:00:00,78,198,10,15,575,509,66,11
8149,2022-12-06 13:00:00,148,176,14,14,779,687,92,14
8150,2022-12-06 14:00:00,73,226,6,18,695,602,93,10
8151,2022-12-06 15:00:00,72,217,11,17,550,428,122,10
8152,2022-12-06 16:00:00,112,274,6,14,577,428,149,13
8153,2022-12-06 17:00:00,57,194,11,12,779,564,215,5
8154,2022-12-06 18:00:00,70,192,5,17,686,527,159,9
8155,2022-12-06 19:00:00,111,261,8,15,558,397,161,7
8156,2022-12-06 20:00:00,69,238,8,15,635,480,155,6
8157,2022-12-06 21:00:00,74,218,5,10,502,390,112,7
8158,2022-12-06 22:00:00,50,134,11,12,613,522,91,5
8159,2022-12-06 23:00:00,120,109,7,14,756,643,113,6
8160,2022-12-07 00:00:00,115,171,9,15,595,509,86,10
8161,2022-12-07 01:00:00,53,208,12,14,782,581,201,11
8162,2022-12-07 02:00:00,84,260,9,10,614,494,120,14
8163,2022-12-07 03:00:00,93,274,6,16,653,517,136,7
8164,2022-12-07 04:00:00,80,134,12,15,729,536,193,8
8165,2022-12-07 05:00:00,113,241,14,11,650,561,89,7
8166,2022-12-07 06:00:00,140,162,8,18,592,501,91,5
8167,2022-12-07 07:00:00,130,166,5,18,526,429,97,13
8168,2022-12-07 08:00:00,54,227,7,16,568,486,82,11
8169,2022-12-07 09:00:00,103,111,7,10,780,639,141,9
8170,2022-12-07 10:00:00,81,189,10,12,656,514,142,5
8171,2022-12-07 11:00:00,119,215,9,12,782,554,228,11
8172,2022-12-07 12:00:00,99,144,8,17,565,441,124,10
8173,2022-12-07 13:00:00,59,118,5,14,654,554,100,12
8174,2022-12-07 14:00:00,88,195,8,18,799,678,121,8
8175,2022-12-07 15:00:00,110,159,6,12,772,612,160,5
8176,2022-12-07 16:00:00,122,144,8,19,631,456,175,8
8177,2022-12-07 17:00:00,76,292,11,15,604,447,157,10
8178,2022-12-07 18:00:00,89,277,12,15,764,553,211,8
8179,2022-12-07 19:00:00,79,285,13,10,559,441,118,8
8180,2022-12-07 20:00:00,141,148,11,17,605,506,99,6
8181,2022-12-07 21:00:00,64,177,7,18,696,538,158,11
8182,2022-12-07 22:00:00,84,191,6,17,797,655,142,13
8183,2022-12-07 23:00:00,57,119,7,11,522,421,101,6
8184,2022-12-08 00:00:00,67,254,8,17,785,680,105,14
8185,2022-12-08 01:00:00,89,120,14,16,541,432,109,10
8186,2022-12-08 02:00:00,97,257,6,16,595,513,82,5
8187,2022-12-08 03:00:00,57,134,5,10,613,523,90,6
8188,2022-12-08 04:00:00,136,135,5,18,752,667,85,7
8189,2022-12-08 05:00:00,93,207,12,12,521,394,127,6
8190,2022-12-08 06:00:00,105,276,14,17,564,417,147,11
8191,2022-12-08 07:00:00,113,197,14,18,740,536,204,11
8192,2022-12-08 08:00:00,73,260,7,14,629,560,69,14
8193,2022-12-08 09:00:00,64,282,11,14,531,372,159,6
8194,2022-12-08 10:00:00,89,217,11,19,586,468,118,12
8195,2022-12-08 11:00:00,95,182,9,14,530,432,98,5
8196,2022-12-08 12:00:00,149,266,9,19,510,410,100,8
8197,2022-12-08 13:00:00,55,131,5,14,622,465,157,13
8198,2022-12-08 14:00:00,132,135,8,18,609,446,163,11
8199,2022-12-08 15:00:00,95,149,8,10,656,577,79,14
8200,2022-12-08 16:00:00,115,203,9,16,682,539,143,11
8201,2022-12-08 17:00:00,134,197,10,18,665,517,148,10
8202,2022-12-08 18:00:00,98,279,10,14,708,557,151,14
8203,2022-12-08 19:00:00,135,257,10,12,587,414,173,12
8204,2022-12-08 20:00:00,118,162,8,12,511,458,53,9
8205,2022-12-08 21:00:00,83,121,8,16,672,559,113,14
8206,2022-12-08 22:00:00,56,127,5,16,759,550,209,8
8207,2022-12-08 23:00:00,77,160,12,14,769,674,95,10
8208,2022-12-09 00:00:00,68,154,12,12,747,533,214,13
8209,2022-12-09 01:00:00,116,151,9,19,774,588,186,12
8210,2022-12-09 02:00:00,68,221,11,16,798,569,229,5
8211,2022-12-09 03:00:00,147,220,8,19,717,573,144,14
8212,2022-12-09 04:00:00,117,205,7,10,594,417,177,12
8213,2022-12-09 05:00:00,63,102,9,14,725,635,90,14
8214,2022-12-09 06:00:00,59,130,12,13,641,513,128,12
8215,2022-12-09 07:00:00,56,221,7,18,625,557,68,14
8216,2022-12-09 08:00:00,106,148,8,13,785,666,119,5
8217,2022-12-09 09:00:00,52,246,7,14,613,497,116,7
8218,2022-12-09 10:00:00,75,175,9,16,739,658,81,5
8219,2022-12-09 11:00:00,102,220,10,14,503,410,93,6
8220,2022-12-09 12:00:00,94,115,11,13,679,490,189,14
8221,2022-12-09 13:00:00,103,200,9,14,570,454,116,13
8222,2022-12-09 14:00:00,127,242,14,14,664,513,151,8
8223,2022-12-09 15:00:00,63,183,10,19,792,647,145,12
8224,2022-12-09 16:00:00,148,208,9,11,713,503,210,5
8225,2022-12-09 17:00:00,81,219,8,11,747,584,163,10
8226,2022-12-09 18:00:00,89,219,13,11,732,577,155,9
8227,2022-12-09 19:00:00,57,208,10,18,772,680,92,11
8228,2022-12-09 20:00:00,116,147,14,12,745,632,113,11
8229,2022-12-09 21:00:00,56,158,11,17,798,692,106,8
8230,2022-12-09 22:00:00,138,122,7,19,626,501,125,10
8231,2022-12-09 23:00:00,101,208,13,19,665,470,195,8
8232,2022-12-10 00:00:00,63,155,8,19,756,544,212,11
8233,2022-12-10 01:00:00,77,210,12,14,747,647,100,12
8234,2022-12-10 02:00:00,93,100,6,19,596,522,74,13
8235,2022-12-10 03:00:00,89,237,8,11,648,509,139,8
8236,2022-12-10 04:00:00,65,101,12,13,518,376,142,10
8237,2022-12-10 05:00:00,116,273,8,10,582,441,141,11
8238,2022-12-10 06:00:00,83,113,13,18,759,567,192,5
8239,2022-12-10 07:00:00,50,295,9,17,552,422,130,14
8240,2022-12-10 08:00:00,107,238,7,18,512,427,85,14
8241,2022-12-10 09:00:00,90,169,14,17,741,609,132,13
8242,2022-12-10 10:00:00,112,190,14,12,617,468,149,6
8243,2022-12-10 11:00:00,137,250,10,18,728,574,154,11
8244,2022-12-10 12:00:00,63,126,12,15,617,510,107,14
8245,2022-12-10 13:00:00,135,265,12,12,577,417,160,8
8246,2022-12-10 14:00:00,57,110,11,12,625,558,67,13
8247,2022-12-10 15:00:00,135,215,10,13,775,674,101,5
8248,2022-12-10 16:00:00,77,179,7,17,560,411,149,7
8249,2022-12-10 17:00:00,71,128,9,13,772,631,141,12
8250,2022-12-10 18:00:00,64,262,8,17,533,395,138,14
8251,2022-12-10 19:00:00,94,169,9,13,526,381,145,10
8252,2022-12-10 20:00:00,89,178,8,17,538,382,156,11
8253,2022-12-10 21:00:00,135,239,6,11,695,565,130,5
8254,2022-12-10 22:00:00,89,212,10,18,510,429,81,10
8255,2022-12-10 23:00:00,107,116,14,13,697,620,77,5
8256,2022-12-11 00:00:00,135,207,11,15,559,484,75,7
8257,2022-12-11 01:00:00,90,166,14,10,602,527,75,12
8258,2022-12-11 02:00:00,140,104,9,18,645,536,109,14
8259,2022-12-11 03:00:00,138,277,14,14,574,423,151,13
8260,2022-12-11 04:00:00,114,203,12,19,765,670,95,7
8261,2022-12-11 05:00:00,117,105,14,11,791,610,181,11
8262,2022-12-11 06:00:00,58,187,5,16,616,473,143,11
8263,2022-12-11 07:00:00,133,269,7,15,760,628,132,12
8264,2022-12-11 08:00:00,126,151,8,19,522,406,116,10
8265,2022-12-11 09:00:00,119,276,13,14,605,525,80,9
8266,2022-12-11 10:00:00,82,145,6,19,750,557,193,11
8267,2022-12-11 11:00:00,131,256,14,15,783,553,230,11
8268,2022-12-11 12:00:00,149,199,5,19,678,553,125,7
8269,2022-12-11 13:00:00,136,125,11,13,776,673,103,13
8270,2022-12-11 14:00:00,96,133,9,14,682,533,149,13
8271,2022-12-11 15:00:00,114,249,8,11,690,565,125,12
8272,2022-12-11 16:00:00,106,275,8,13,731,535,196,11
8273,2022-12-11 17:00:00,143,160,13,17,686,517,169,9
8274,2022-12-11 18:00:00,93,121,11,13,598,475,123,10
8275,2022-12-11 19:00:00,123,154,14,15,719,585,134,14
8276,2022-12-11 20:00:00,107,218,14,19,509,428,81,12
8277,2022-12-11 21:00:00,145,263,12,10,699,590,109,8
8278,2022-12-11 22:00:00,119,167,9,14,664,473,191,7
8279,2022-12-11 23:00:00,55,106,6,13,560,466,94,14
8280,2022-12-12 00:00:00,142,267,13,15,770,614,156,13
8281,2022-12-12 01:00:00,141,191,7,17,562,495,67,14
8282,2022-12-12 02:00:00,84,230,8,11,591,425,166,12
8283,2022-12-12 03:00:00,88,244,9,13,617,522,95,5
8284,2022-12-12 04:00:00,64,215,13,11,560,479,81,9
8285,2022-12-12 05:00:00,50,121,7,13,584,429,155,14
8286,2022-12-12 06:00:00,59,230,5,16,532,388,144,12
8287,2022-12-12 07:00:00,103,213,7,19,715,629,86,9
8288,2022-12-12 08:00:00,83,170,9,13,533,397,136,10
8289,2022-12-12 09:00:00,135,276,6,13,503,395,108,12
8290,2022-12-12 10:00:00,97,292,6,19,593,446,147,7
8291,2022-12-12 11:00:00,85,101,5,13,622,499,123,8
8292,2022-12-12 12:00:00,89,124,12,16,501,398,103,9
8293,2022-12-12 13:00:00,143,138,14,19,759,631,128,7
8294,2022-12-12 14:00:00,103,243,8,12,730,540,190,12
8295,2022-12-12 15:00:00,114,276,11,16,520,393,127,13
8296,2022-12-12 16:00:00,128,162,6,19,732,531,201,9
8297,2022-12-12 17:00:00,93,285,9,15,777,562,215,14
8298,2022-12-12 18:00:00,107,275,14,10,566,492,74,10
8299,2022-12-12 19:00:00,137,200,10,11,544,416,128,7
8300,2022-12-12 20:00:00,69,138,14,11,695,500,195,13
8301,2022-12-12 21:00:00,135,278,13,18,566,463,103,6
8302,2022-12-12 22:00:00,80,254,7,19,623,502,121,5
8303,2022-12-12 23:00:00,105,263,11,15,676,606,70,8
8304,2022-12-13 00:00:00,149,252,9,11,751,653,98,5
8305,2022-12-13 01:00:00,149,140,9,18,532,454,78,13
8306,2022-12-13 02:00:00,61,135,10,11,662,573,89,6
8307,2022-12-13 03:00:00,83,170,7,12,671,536,135,5
8308,2022-12-13 04:00:00,93,104,14,18,797,625,172,11
8309,2022-12-13 05:00:00,102,200,6,19,604,516,88,9
8310,2022-12-13 06:00:00,92,296,10,16,733,650,83,13
8311,2022-12-13 07:00:00,122,215,10,16,519,372,147,11
8312,2022-12-13 08:00:00,108,118,14,18,670,528,142,7
8313,2022-12-13 09:00:00,142,112,9,11,750,595,155,10
8314,2022-12-13 10:00:00,117,226,9,17,660,590,70,14
8315,2022-12-13 11:00:00,102,189,8,18,713,502,211,5
8316,2022-12-13 12:00:00,143,137,7,14,759,589,170,7
8317,2022-12-13 13:00:00,76,220,5,16,764,535,229,8
8318,2022-12-13 14:00:00,107,139,11,10,787,611,176,14
8319,2022-12-13 15:00:00,54,260,9,18,751,532,219,11
8320,2022-12-13 16:00:00,135,257,8,11,790,686,104,5
8321,2022-12-13 17:00:00,53,104,7,17,525,448,77,9
8322,2022-12-13 18:00:00,146,269,5,17,674,558,116,11
8323,2022-12-13 19:00:00,144,266,12,14,616,493,123,12
8324,2022-12-13 20:00:00,91,158,8,11,711,517,194,8
8325,2022-12-13 21:00:00,96,268,12,19,642,540,102,13
8326,2022-12-13 22:00:00,93,117,10,13,525,411,114,6
8327,2022-12-13 23:00:00,81,182,6,19,722,604,118,13
8328,2022-12-14 00:00:00,89,242,5,18,582,513,69,12
8329,2022-12-14 01:00:00,100,235,8,19,704,575,129,9
8330,2022-12-14 02:00:00,63,112,6,19,761,650,111,8
8331,2022-12-14 03:00:00,89,144,13,14,500,411,89,11
8332,2022-12-14 04:00:00,136,154,10,12,670,573,97,7
8333,2022-12-14 05:00:00,98,173,7,13,568,482,86,7
8334,2022-12-14 06:00:00,57,286,14,12,538,386,152,8
8335,2022-12-14 07:00:00,129,177,13,13,536,454,82,13
8336,2022-12-14 08:00:00,74,278,5,17,530,450,80,13
8337,2022-12-14 09:00:00,80,196,9,19,774,554,220,10
8338,2022-12-14 10:00:00,127,172,9,18,702,536,166,11
8339,2022-12-14 11:00:00,110,244,6,13,731,639,92,5
8340,2022-12-14 12:00:00,117,231,10,11,711,517,194,14
8341,2022-12-14 13:00:00,128,239,10,18,644,570,74,7
8342,2022-12-14 14:00:00,135,178,14,17,516,371,145,7
8343,2022-12-14 15:00:00,134,259,10,13,716,507,209,12
8344,2022-12-14 16:00:00,99,133,12,14,533,425,108,12
8345,2022-12-14 17:00:00,137,192,8,16,573,499,74,13
8346,2022-12-14 18:00:00,77,193,7,11,605,462,143,13
8347,2022-12-14 19:00:00,134,119,10,11,725,600,125,12
8348,2022-12-14 20:00:00,67,186,14,15,557,432,125,10
8349,2022-12-14 21:00:00,132,292,12,10,585,449,136,8
8350,2022-12-14 22:00:00,116,105,9,12,711,636,75,12
8351,2022-12-14 23:00:00,142,107,6,13,630,525,105,13
8352,2022-12-15 00:00:00,147,210,11,15,618,512,106,14
8353,2022-12-15 01:00:00,99,110,11,14,655,470,185,10
8354,2022-12-15 02:00:00,117,274,12,19,708,546,162,10
8355,2022-12-15 03:00:00,75,127,12,12,592,432,160,9
8356,2022-12-15 04:00:00,88,292,10,11,758,604,154,11
8357,2022-12-15 05:00:00,131,106,9,12,671,563,108,5
8358,2022-12-15 06:00:00,56,277,5,15,570,487,83,9
8359,2022-12-15 07:00:00,138,239,11,14,676,490,186,8
8360,2022-12-15 08:00:00,60,178,11,16,670,592,78,14
8361,2022-12-15 09:00:00,100,155,10,18,502,357,145,7
8362,2022-12-15 10:00:00,144,226,7,16,614,498,116,7
8363,2022-12-15 11:00:00,68,125,8,16,680,488,192,10
8364,2022-12-15 12:00:00,143,167,14,10,699,503,196,6
8365,2022-12-15 13:00:00,74,165,11,14,699,530,169,11
8366,2022-12-15 14:00:00,134,104,6,13,622,455,167,9
8367,2022-12-15 15:00:00,53,111,11,14,765,542,223,14
8368,2022-12-15 16:00:00,144,283,11,15,530,466,64,8
8369,2022-12-15 17:00:00,130,218,10,15,693,565,128,14
8370,2022-12-15 18:00:00,66,226,14,17,784,599,185,14
8371,2022-12-15 19:00:00,60,182,8,10,613,482,131,6
8372,2022-12-15 20:00:00,137,175,13,19,655,569,86,8
8373,2022-12-15 21:00:00,124,212,13,19,605,499,106,7
8374,2022-12-15 22:00:00,138,167,12,15,580,418,162,12
8375,2022-12-15 23:00:00,143,164,13,15,615,459,156,10
8376,2022-12-16 00:00:00,103,219,7,16,791,613,178,9
8377,2022-12-16 01:00:00,88,163,10,12,617,528,89,5
8378,2022-12-16 02:00:00,142,269,11,11,713,598,115,5
8379,2022-12-16 03:00:00,82,290,7,10,654,513,141,6
8380,2022-12-16 04:00:00,114,169,13,15,723,571,152,9
8381,2022-12-16 05:00:00,91,275,8,16,515,426,89,12
8382,2022-12-16 06:00:00,97,269,14,11,554,487,67,8
8383,2022-12-16 07:00:00,115,167,7,14,612,433,179,11
8384,2022-12-16 08:00:00,89,145,5,18,617,498,119,9
8385,2022-12-16 09:00:00,63,225,9,12,797,656,141,9
8386,2022-12-16 10:00:00,104,299,14,14,572,476,96,7
8387,2022-12-16 11:00:00,107,228,5,18,575,413,162,12
8388,2022-12-16 12:00:00,99,148,13,11,552,471,81,10
8389,2022-12-16 13:00:00,78,190,12,16,507,360,147,8
8390,2022-12-16 14:00:00,50,110,6,15,523,378,145,8
8391,2022-12-16 15:00:00,85,187,12,18,744,526,218,12
8392,2022-12-16 16:00:00,85,294,5,17,649,513,136,8
8393,2022-12-16 17:00:00,65,190,8,13,582,456,126,14
8394,2022-12-16 18:00:00,75,170,10,18,743,636,107,12
8395,2022-12-16 19:00:00,72,248,12,13,743,565,178,10
8396,2022-12-16 20:00:00,104,170,5,18,687,548,139,14
8397,2022-12-16 21:00:00,130,282,13,11,659,566,93,7
8398,2022-12-16 22:00:00,127,259,5,19,615,462,153,10
8399,2022-12-16 23:00:00,96,261,14,16,525,444,81,11
8400,2022-12-17 00:00:00,116,180,5,14,509,444,65,6
8401,2022-12-17 01:00:00,85,211,9,17,635,494,141,10
8402,2022-12-17 02:00:00,96,180,9,14,684,554,130,6
8403,2022-12-17 03:00:00,102,275,8,13,588,523,65,12
8404,2022-12-17 04:00:00,127,179,11,14,797,592,205,10
8405,2022-12-17 05:00:00,103,141,12,10,607,496,111,12
8406,2022-12-17 06:00:00,102,202,13,10,575,429,146,5
8407,2022-12-17 07:00:00,96,231,14,10,677,556,121,8
8408,2022-12-17 08:00:00,115,171,9,11,723,569,154,10
8409,2022-12-17 09:00:00,51,227,8,14,726,631,95,10
8410,2022-12-17 10:00:00,106,129,12,16,759,600,159,8
8411,2022-12-17 11:00:00,143,104,9,12,782,666,116,5
8412,2022-12-17 12:00:00,51,148,6,10,694,535,159,9
8413,2022-12-17 13:00:00,119,293,10,13,630,558,72,6
8414,2022-12-17 14:00:00,94,241,9,12,766,688,78,12
8415,2022-12-17 15:00:00,118,243,12,15,657,568,89,9
8416,2022-12-17 16:00:00,108,276,12,14,649,568,81,10
8417,2022-12-17 17:00:00,55,100,5,19,746,557,189,9
8418,2022-12-17 18:00:00,88,143,11,14,788,613,175,14
8419,2022-12-17 19:00:00,118,185,7,17,602,443,159,11
8420,2022-12-17 20:00:00,87,275,7,18,548,396,152,12
8421,2022-12-17 21:00:00,75,215,10,11,672,603,69,9
8422,2022-12-17 22:00:00,104,216,13,17,771,649,122,6
8423,2022-12-17 23:00:00,121,117,14,18,595,529,66,6
8424,2022-12-18 00:00:00,110,154,13,10,533,374,159,14
8425,2022-12-18 01:00:00,103,124,14,14,720,504,216,12
8426,2022-12-18 02:00:00,138,149,8,18,599,435,164,11
8427,2022-12-18 03:00:00,85,166,7,17,679,551,128,8
8428,2022-12-18 04:00:00,127,155,14,16,574,508,66,9
8429,2022-12-18 05:00:00,139,184,10,18,537,424,113,7
8430,2022-12-18 06:00:00,117,121,13,17,704,512,192,11
8431,2022-12-18 07:00:00,108,148,10,15,518,377,141,9
8432,2022-12-18 08:00:00,57,246,6,14,563,497,66,11
8433,2022-12-18 09:00:00,91,217,13,19,539,427,112,8
8434,2022-12-18 10:00:00,134,215,8,13,589,437,152,7
8435,2022-12-18 11:00:00,60,140,6,10,587,425,162,5
8436,2022-12-18 12:00:00,146,237,13,12,569,436,133,5
8437,2022-12-18 13:00:00,98,133,6,14,661,506,155,10
8438,2022-12-18 14:00:00,85,266,6,19,571,451,120,7
8439,2022-12-18 15:00:00,61,222,5,12,685,524,161,7
8440,2022-12-18 16:00:00,113,155,9,10,543,428,115,13
8441,2022-12-18 17:00:00,95,167,11,13,515,404,111,9
8442,2022-12-18 18:00:00,113,289,13,15,690,554,136,14
8443,2022-12-18 19:00:00,115,167,13,18,786,672,114,9
8444,2022-12-18 20:00:00,78,255,5,10,751,596,155,8
8445,2022-12-18 21:00:00,92,272,8,16,618,546,72,12
8446,2022-12-18 22:00:00,117,131,13,19,658,537,121,9
8447,2022-12-18 23:00:00,99,283,9,10,634,457,177,10
8448,2022-12-19 00:00:00,134,284,14,11,702,582,120,8
8449,2022-12-19 01:00:00,105,212,12,14,579,476,103,11
8450,2022-12-19 02:00:00,99,260,5,15,540,429,111,12
8451,2022-12-19 03:00:00,123,103,6,17,682,556,126,12
8452,2022-12-19 04:00:00,79,167,10,15,721,519,202,7
8453,2022-12-19 05:00:00,62,166,7,14,607,455,152,5
8454,2022-12-19 06:00:00,59,279,7,17,541,480,61,6
8455,2022-12-19 07:00:00,117,150,14,13,608,516,92,14
8456,2022-12-19 08:00:00,113,284,8,15,718,630,88,14
8457,2022-12-19 09:00:00,114,179,12,16,663,475,188,10
8458,2022-12-19 10:00:00,70,295,12,16,646,534,112,8
8459,2022-12-19 11:00:00,106,249,7,17,601,530,71,9
8460,2022-12-19 12:00:00,93,130,12,17,706,629,77,13
8461,2022-12-19 13:00:00,147,165,10,10,561,484,77,9
8462,2022-12-19 14:00:00,111,145,14,17,548,391,157,5
8463,2022-12-19 15:00:00,80,199,12,14,714,633,81,14
8464,2022-12-19 16:00:00,128,208,9,11,572,404,168,8
8465,2022-12-19 17:00:00,78,156,9,16,594,489,105,9
8466,2022-12-19 18:00:00,115,233,5,15,781,659,122,14
8467,2022-12-19 19:00:00,70,238,6,14,628,533,95,11
8468,2022-12-19 20:00:00,80,220,11,14,583,435,148,9
8469,2022-12-19 21:00:00,116,261,13,14,672,586,86,8
8470,2022-12-19 22:00:00,110,179,14,13,635,526,109,5
8471,2022-12-19 23:00:00,70,203,13,17,691,578,113,13
8472,2022-12-20 00:00:00,125,117,14,18,667,591,76,8
8473,2022-12-20 01:00:00,136,136,10,17,629,514,115,11
8474,2022-12-20 02:00:00,67,191,9,12,741,616,125,6
8475,2022-12-20 03:00:00,131,248,5,19,546,437,109,7
8476,2022-12-20 04:00:00,141,256,8,13,509,448,61,12
8477,2022-12-20 05:00:00,101,176,9,16,572,431,141,12
8478,2022-12-20 06:00:00,134,236,11,19,579,435,144,5
8479,2022-12-20 07:00:00,84,175,14,16,528,406,122,13
8480,2022-12-20 08:00:00,146,186,11,15,780,650,130,5
8481,2022-12-20 09:00:00,121,248,12,10,592,431,161,12
8482,2022-12-20 10:00:00,123,204,9,12,598,454,144,9
8483,2022-12-20 11:00:00,88,292,10,19,782,693,89,11
8484,2022-12-20 12:00:00,146,265,9,10,549,393,156,13
8485,2022-12-20 13:00:00,136,111,13,15,785,645,140,13
8486,2022-12-20 14:00:00,52,293,5,19,529,441,88,13
8487,2022-12-20 15:00:00,65,141,12,16,732,600,132,8
8488,2022-12-20 16:00:00,56,193,14,13,587,457,130,7
8489,2022-12-20 17:00:00,66,290,5,16,788,603,185,5
8490,2022-12-20 18:00:00,132,297,11,12,768,640,128,11
8491,2022-12-20 19:00:00,96,283,14,16,668,567,101,5
8492,2022-12-20 20:00:00,61,233,8,15,534,428,106,13
8493,2022-12-20 21:00:00,57,137,14,18,532,380,152,12
8494,2022-12-20 22:00:00,106,298,7,16,775,542,233,10
8495,2022-12-20 23:00:00,51,135,14,15,748,524,224,11
8496,2022-12-21 00:00:00,137,221,8,15,649,520,129,13
8497,2022-12-21 01:00:00,87,287,6,13,699,562,137,14
8498,2022-12-21 02:00:00,123,127,9,10,550,441,109,10
8499,2022-12-21 03:00:00,76,236,13,13,771,585,186,13
8500,2022-12-21 04:00:00,92,203,7,19,546,485,61,5
8501,2022-12-21 05:00:00,71,167,6,19,686,502,184,10
8502,2022-12-21 06:00:00,56,208,5,19,574,436,138,6
8503,2022-12-21 07:00:00,97,119,9,15,620,442,178,14
8504,2022-12-21 08:00:00,134,166,9,16,618,443,175,8
8505,2022-12-21 09:00:00,96,208,9,19,705,570,135,5
8506,2022-12-21 10:00:00,82,199,12,19,789,680,109,13
8507,2022-12-21 11:00:00,136,233,14,16,622,438,184,7
8508,2022-12-21 12:00:00,147,156,6,11,505,450,55,6
8509,2022-12-21 13:00:00,63,234,10,19,765,539,226,6
8510,2022-12-21 14:00:00,92,287,6,12,607,499,108,12
8511,2022-12-21 15:00:00,86,122,13,16,768,607,161,12
8512,2022-12-21 16:00:00,99,116,10,10,670,588,82,11
8513,2022-12-21 17:00:00,66,186,10,16,687,558,129,8
8514,2022-12-21 18:00:00,59,183,7,18,641,490,151,7
8515,2022-12-21 19:00:00,133,152,6,19,747,591,156,14
8516,2022-12-21 20:00:00,116,115,13,11,726,554,172,7
8517,2022-12-21 21:00:00,96,279,5,14,665,471,194,8
8518,2022-12-21 22:00:00,52,243,9,15,670,541,129,14
8519,2022-12-21 23:00:00,50,262,7,19,757,627,130,6
8520,2022-12-22 00:00:00,120,197,14,12,556,410,146,10
8521,2022-12-22 01:00:00,66,276,12,16,696,584,112,10
8522,2022-12-22 02:00:00,78,264,12,16,547,388,159,13
8523,2022-12-22 03:00:00,100,224,11,11,638,469,169,6
8524,2022-12-22 04:00:00,105,208,10,14,798,692,106,14
8525,2022-12-22 05:00:00,83,231,11,11,562,398,164,13
8526,2022-12-22 06:00:00,88,101,6,16,612,459,153,7
8527,2022-12-22 07:00:00,124,274,14,12,670,544,126,10
8528,2022-12-22 08:00:00,90,139,11,10,560,433,127,9
8529,2022-12-22 09:00:00,142,252,7,11,661,496,165,12
8530,2022-12-22 10:00:00,107,164,13,10,513,399,114,9
8531,2022-12-22 11:00:00,103,273,6,14,695,524,171,5
8532,2022-12-22 12:00:00,141,127,14,17,693,536,157,14
8533,2022-12-22 13:00:00,130,266,9,18,660,558,102,9
8534,2022-12-22 14:00:00,61,227,9,11,600,447,153,8
8535,2022-12-22 15:00:00,70,155,14,10,537,390,147,10
8536,2022-12-22 16:00:00,73,257,6,11,622,487,135,8
8537,2022-12-22 17:00:00,117,286,8,19,583,429,154,10
8538,2022-12-22 18:00:00,109,288,14,15,777,575,202,11
8539,2022-12-22 19:00:00,128,187,13,17,783,592,191,11
8540,2022-12-22 20:00:00,62,275,12,15,645,495,150,13
8541,2022-12-22 21:00:00,100,157,6,16,592,494,98,8
8542,2022-12-22 22:00:00,144,240,13,10,664,583,81,10
8543,2022-12-22 23:00:00,90,297,7,12,524,415,109,10
8544,2022-12-23 00:00:00,80,167,13,12,743,651,92,10
8545,2022-12-23 01:00:00,89,128,7,13,715,562,153,11
8546,2022-12-23 02:00:00,75,238,6,17,517,461,56,5
8547,2022-12-23 03:00:00,53,190,9,13,581,513,68,8
8548,2022-12-23 04:00:00,52,127,8,10,660,561,99,7
8549,2022-12-23 05:00:00,84,295,13,12,567,437,130,14
8550,2022-12-23 06:00:00,117,207,6,12,576,450,126,5
8551,2022-12-23 07:00:00,118,131,13,16,529,424,105,5
8552,2022-12-23 08:00:00,128,189,9,11,564,502,62,6
8553,2022-12-23 09:00:00,66,142,10,19,723,519,204,14
8554,2022-12-23 10:00:00,139,207,11,15,638,467,171,7
8555,2022-12-23 11:00:00,149,173,7,14,531,444,87,8
8556,2022-12-23 12:00:00,119,155,12,14,701,614,87,7
8557,2022-12-23 13:00:00,63,156,13,10,738,637,101,5
8558,2022-12-23 14:00:00,120,120,13,13,569,472,97,6
8559,2022-12-23 15:00:00,138,185,9,14,757,596,161,7
8560,2022-12-23 16:00:00,65,265,7,10,760,536,224,7
8561,2022-12-23 17:00:00,127,140,13,10,550,420,130,12
8562,2022-12-23 18:00:00,71,295,8,13,597,533,64,9
8563,2022-12-23 19:00:00,119,237,5,10,582,518,64,12
8564,2022-12-23 20:00:00,84,278,8,19,739,572,167,14
8565,2022-12-23 21:00:00,77,276,14,11,574,508,66,13
8566,2022-12-23 22:00:00,58,268,8,18,660,540,120,12
8567,2022-12-23 23:00:00,92,285,13,11,620,550,70,7
8568,2022-12-24 00:00:00,112,186,11,18,792,603,189,12
8569,2022-12-24 01:00:00,148,231,10,16,681,528,153,13
8570,2022-12-24 02:00:00,99,124,5,14,626,471,155,14
8571,2022-12-24 03:00:00,108,103,7,13,734,548,186,8
8572,2022-12-24 04:00:00,90,190,5,10,558,398,160,7
8573,2022-12-24 05:00:00,59,243,13,10,748,551,197,8
8574,2022-12-24 06:00:00,86,176,11,17,582,439,143,12
8575,2022-12-24 07:00:00,113,106,8,12,518,424,94,11
8576,2022-12-24 08:00:00,144,191,9,13,798,617,181,7
8577,2022-12-24 09:00:00,132,263,13,10,737,529,208,6
8578,2022-12-24 10:00:00,114,286,10,11,519,458,61,7
8579,2022-12-24 11:00:00,139,178,11,18,590,507,83,5
8580,2022-12-24 12:00:00,93,193,8,19,780,555,225,6
8581,2022-12-24 13:00:00,123,179,13,17,519,418,101,12
8582,2022-12-24 14:00:00,101,189,7,12,670,508,162,12
8583,2022-12-24 15:00:00,65,275,10,17,682,597,85,14
8584,2022-12-24 16:00:00,135,207,8,15,598,459,139,11
8585,2022-12-24 17:00:00,92,135,9,14,779,681,98,11
8586,2022-12-24 18:00:00,76,214,12,17,567,485,82,10
8587,2022-12-24 19:00:00,77,226,12,16,632,543,89,13
8588,2022-12-24 20:00:00,50,194,10,13,570,406,164,12
8589,2022-12-24 21:00:00,135,147,9,17,728,624,104,5
8590,2022-12-24 22:00:00,70,255,8,14,650,460,190,5
8591,2022-12-24 23:00:00,134,157,8,15,666,487,179,5
8592,2022-12-25 00:00:00,122,195,8,16,741,648,93,8
8593,2022-12-25 01:00:00,80,252,14,17,513,363,150,10
8594,2022-12-25 02:00:00,60,103,12,18,571,436,135,11
8595,2022-12-25 03:00:00,111,241,11,10,767,625,142,12
8596,2022-12-25 04:00:00,102,125,7,11,510,361,149,7
8597,2022-12-25 05:00:00,137,150,7,11,589,511,78,6
8598,2022-12-25 06:00:00,62,193,12,14,794,585,209,7
8599,2022-12-25 07:00:00,115,108,6,15,632,520,112,14
8600,2022-12-25 08:00:00,60,273,11,14,715,504,211,10
8601,2022-12-25 09:00:00,130,242,11,12,631,563,68,14
8602,2022-12-25 10:00:00,118,190,6,12,788,561,227,8
8603,2022-12-25 11:00:00,71,296,7,17,728,639,89,11
8604,2022-12-25 12:00:00,106,200,11,12,678,547,131,10
8605,2022-12-25 13:00:00,66,175,14,15,509,440,69,13
8606,2022-12-25 14:00:00,120,164,8,11,514,399,115,14
8607,2022-12-25 15:00:00,107,245,11,12,575,517,58,7
8608,2022-12-25 16:00:00,107,125,14,18,513,377,136,13
8609,2022-12-25 17:00:00,132,259,7,18,703,565,138,8
8610,2022-12-25 18:00:00,94,223,5,10,663,499,164,14
8611,2022-12-25 19:00:00,79,176,6,11,759,571,188,10
8612,2022-12-25 20:00:00,80,106,5,18,796,650,146,13
8613,2022-12-25 21:00:00,95,227,11,11,751,527,224,6
8614,2022-12-25 22:00:00,97,257,9,16,676,595,81,6
8615,2022-12-25 23:00:00,123,299,12,13,791,647,144,13
8616,2022-12-26 00:00:00,123,159,13,12,601,455,146,8
8617,2022-12-26 01:00:00,148,220,14,17,795,622,173,6
8618,2022-12-26 02:00:00,129,178,9,19,633,544,89,13
8619,2022-12-26 03:00:00,72,166,11,12,571,465,106,8
8620,2022-12-26 04:00:00,128,216,8,14,548,486,62,5
8621,2022-12-26 05:00:00,56,196,14,10,709,515,194,13
8622,2022-12-26 06:00:00,95,252,12,19,750,586,164,5
8623,2022-12-26 07:00:00,123,110,6,18,679,585,94,6
8624,2022-12-26 08:00:00,130,276,5,18,609,514,95,7
8625,2022-12-26 09:00:00,77,296,5,17,750,572,178,5
8626,2022-12-26 10:00:00,84,256,8,12,747,623,124,10
8627,2022-12-26 11:00:00,97,183,8,10,594,442,152,11
8628,2022-12-26 12:00:00,77,294,12,10,598,496,102,5
8629,2022-12-26 13:00:00,92,257,10,12,650,474,176,5
8630,2022-12-26 14:00:00,57,163,11,17,787,595,192,7
8631,2022-12-26 15:00:00,128,294,14,15,752,631,121,11
8632,2022-12-26 16:00:00,107,187,7,17,581,493,88,8
8633,2022-12-26 17:00:00,111,212,10,13,792,659,133,5
8634,2022-12-26 18:00:00,69,202,5,16,537,473,64,12
8635,2022-12-26 19:00:00,107,291,12,16,664,533,131,6
8636,2022-12-26 20:00:00,97,205,10,10,609,490,119,8
8637,2022-12-26 21:00:00,61,274,13,11,552,434,118,5
8638,2022-12-26 22:00:00,75,244,6,12,535,423,112,9
8639,2022-12-26 23:00:00,88,117,10,16,781,697,84,14
8640,2022-12-27 00:00:00,109,105,6,15,715,573,142,12
8641,2022-12-27 01:00:00,95,288,7,16,786,701,85,7
8642,2022-12-27 02:00:00,132,145,6,16,708,496,212,8
8643,2022-12-27 03:00:00,59,237,9,11,629,555,74,14
8644,2022-12-27 04:00:00,147,125,14,10,568,455,113,5
8645,2022-12-27 05:00:00,84,253,7,18,672,476,196,10
8646,2022-12-27 06:00:00,144,292,6,10,761,682,79,6
8647,2022-12-27 07:00:00,119,191,13,15,595,526,69,13
8648,2022-12-27 08:00:00,75,186,7,11,699,513,186,10
8649,2022-12-27 09:00:00,130,193,11,13,530,377,153,9
8650,2022-12-27 10:00:00,135,103,13,12,562,482,80,11
8651,2022-12-27 11:00:00,148,134,13,17,587,481,106,7
8652,2022-12-27 12:00:00,86,292,14,14,641,495,146,11
8653,2022-12-27 13:00:00,87,143,10,19,521,441,80,10
8654,2022-12-27 14:00:00,91,177,11,15,576,508,68,6
8655,2022-12-27 15:00:00,99,172,5,16,632,465,167,14
8656,2022-12-27 16:00:00,138,253,8,16,730,643,87,9
8657,2022-12-27 17:00:00,111,139,14,13,578,424,154,9
8658,2022-12-27 18:00:00,58,199,9,11,634,560,74,10
8659,2022-12-27 19:00:00,117,157,9,14,578,482,96,9
8660,2022-12-27 20:00:00,70,254,6,18,540,460,80,14
8661,2022-12-27 21:00:00,134,185,7,13,774,644,130,8
8662,2022-12-27 22:00:00,120,269,8,10,598,480,118,6
8663,2022-12-27 23:00:00,119,209,9,12,784,704,80,8
8664,2022-12-28 00:00:00,92,207,14,14,709,552,157,13
8665,2022-12-28 01:00:00,72,147,12,14,778,636,142,7
8666,2022-12-28 02:00:00,118,192,10,12,734,623,111,7
8667,2022-12-28 03:00:00,87,151,10,18,567,477,90,9
8668,2022-12-28 04:00:00,139,211,5,18,690,532,158,11
8669,2022-12-28 05:00:00,144,144,6,13,599,461,138,13
8670,2022-12-28 06:00:00,84,102,11,17,744,541,203,7
8671,2022-12-28 07:00:00,143,219,5,13,574,412,162,9
8672,2022-12-28 08:00:00,61,181,6,14,591,519,72,9
8673,2022-12-28 09:00:00,117,146,9,12,726,548,178,13
8674,2022-12-28 10:00:00,110,276,8,18,739,541,198,6
8675,2022-12-28 11:00:00,63,277,13,16,616,481,135,14
8676,2022-12-28 12:00:00,61,266,10,14,686,612,74,12
8677,2022-12-28 13:00:00,104,297,12,16,566,489,77,6
8678,2022-12-28 14:00:00,53,242,14,15,717,539,178,7
8679,2022-12-28 15:00:00,73,181,7,15,776,625,151,5
8680,2022-12-28 16:00:00,73,190,8,14,718,597,121,7
8681,2022-12-28 17:00:00,90,197,6,10,635,473,162,6
8682,2022-12-28 18:00:00,145,233,14,14,547,414,133,10
8683,2022-12-28 19:00:00,109,283,5,13,642,575,67,7
8684,2022-12-28 20:00:00,60,226,12,13,625,512,113,10
8685,2022-12-28 21:00:00,86,115,10,14,654,557,97,12
8686,2022-12-28 22:00:00,126,217,14,17,689,575,114,7
8687,2022-12-28 23:00:00,138,103,10,14,657,474,183,8
8688,2022-12-29 00:00:00,67,126,7,14,619,523,96,6
8689,2022-12-29 01:00:00,129,255,5,17,636,490,146,6
8690,2022-12-29 02:00:00,129,282,14,12,790,601,189,11
8691,2022-12-29 03:00:00,65,285,12,19,690,573,117,5
8692,2022-12-29 04:00:00,87,209,8,15,675,569,106,10
8693,2022-12-29 05:00:00,65,194,13,18,686,544,142,14
8694,2022-12-29 06:00:00,86,165,10,11,528,414,114,14
8695,2022-12-29 07:00:00,121,112,5,19,555,423,132,13
8696,2022-12-29 08:00:00,89,209,14,18,654,577,77,8
8697,2022-12-29 09:00:00,64,228,5,13,655,485,170,12
8698,2022-12-29 10:00:00,55,287,13,10,558,425,133,7
8699,2022-12-29 11:00:00,139,175,8,13,521,366,155,9
8700,2022-12-29 12:00:00,86,215,6,14,579,433,146,10
8701,2022-12-29 13:00:00,140,191,5,12,557,470,87,5
8702,2022-12-29 14:00:00,130,214,9,14,764,590,174,5
8703,2022-12-29 15:00:00,77,126,11,10,568,481,87,14
8704,2022-12-29 16:00:00,60,249,9,10,568,483,85,8
8705,2022-12-29 17:00:00,91,166,9,16,653,518,135,14
8706,2022-12-29 18:00:00,125,240,7,10,725,524,201,9
8707,2022-12-29 19:00:00,145,135,14,16,553,487,66,10
8708,2022-12-29 20:00:00,148,103,13,13,607,481,126,9
8709,2022-12-29 21:00:00,60,195,13,16,723,522,201,8
8710,2022-12-29 22:00:00,110,152,7,12,700,498,202,14
8711,2022-12-29 23:00:00,130,143,7,12,608,508,100,7
8712,2022-12-30 00:00:00,120,146,6,15,780,585,195,7
8713,2022-12-30 01:00:00,73,241,9,19,560,416,144,12
8714,2022-12-30 02:00:00,110,100,9,14,518,428,90,11
8715,2022-12-30 03:00:00,109,299,10,15,505,362,143,11
8716,2022-12-30 04:00:00,59,125,5,18,653,503,150,6
8717,2022-12-30 05:00:00,61,154,13,19,578,476,102,14
8718,2022-12-30 06:00:00,86,228,13,10,567,422,145,8
8719,2022-12-30 07:00:00,77,237,5,12,775,548,227,9
8720,2022-12-30 08:00:00,100,118,11,17,638,571,67,6
8721,2022-12-30 09:00:00,92,229,11,13,549,393,156,7
8722,2022-12-30 10:00:00,116,200,11,12,527,421,106,13
8723,2022-12-30 11:00:00,147,123,6,15,560,429,131,14
8724,2022-12-30 12:00:00,76,153,7,18,760,571,189,5
8725,2022-12-30 13:00:00,123,103,9,13,695,528,167,10
8726,2022-12-30 14:00:00,74,142,12,13,746,561,185,5
8727,2022-12-30 15:00:00,106,210,10,11,696,609,87,14
8728,2022-12-30 16:00:00,72,141,6,16,731,529,202,10
8729,2022-12-30 17:00:00,83,118,8,15,578,497,81,13
8730,2022-12-30 18:00:00,115,160,12,11,675,587,88,10
8731,2022-12-30 19:00:00,92,146,5,11,695,616,79,14
8732,2022-12-30 20:00:00,51,290,5,14,558,439,119,9
8733,2022-12-30 21:00:00,113,277,11,17,648,544,104,12
8734,2022-12-30 22:00:00,60,245,11,16,618,443,175,7
8735,2022-12-30 23:00:00,101,108,7,14,619,506,113,13
8736,2022-12-31 00:00:00,73,208,14,12,714,601,113,7
8737,2022-12-31 01:00:00,85,115,6,17,546,388,158,6
8738,2022-12-31 02:00:00,139,275,7,13,793,576,217,9
8739,2022-12-31 03:00:00,109,144,7,15,625,531,94,5
8740,2022-12-31 04:00:00,53,279,8,17,762,604,158,10
8741,2022-12-31 05:00:00,81,127,9,19,577,508,69,12
8742,2022-12-31 06:00:00,131,288,6,12,729,640,89,8
8743,2022-12-31 07:00:00,95,147,7,18,568,490,78,8
8744,2022-12-31 08:00:00,56,134,7,16,519,434,85,7
8745,2022-12-31 09:00:00,64,241,12,14,703,577,126,5
8746,2022-12-31 10:00:00,69,219,5,11,759,680,79,11
8747,2022-12-31 11:00:00,108,129,7,16,637,545,92,12
8748,2022-12-31 12:00:00,120,226,7,15,567,458,109,13
8749,2022-12-31 13:00:00,91,132,12,14,734,603,131,7
8750,2022-12-31 14:00:00,92,229,6,16,520,429,91,11
8751,2022-12-31 15:00:00,120,281,7,10,738,622,116,9
8752,2022-12-31 16:00:00,130,177,14,12,692,599,93,8
8753,2022-12-31 17:00:00,107,131,7,10,693,498,195,11
8754,2022-12-31 18:00:00,77,249,12,17,634,500,134,6
8755,2022-12-31 19:00:00,121,237,10,11,613,470,143,10
8756,2022-12-31 20:00:00,86,156,13,15,520,406,114,10
8757,2022-12-31 21:00:00,117,198,12,18,644,478,166,11
8758,2022-12-31 22:00:00,100,180,11,13,669,489,180,6
8759,2022-12-31 23:00:00,148,241,8,19,749,536,213,11
8760,2023-01-01 00:00:00,136,135,5,11,717,558,159,8
8761,2023-01-01 01:00:00,142,193,14,14,718,640,78,8
8762,2023-01-01 02:00:00,142,219,14,18,771,548,223,6
8763,2023-01-01 03:00:00,141,226,10,14,613,511,102,9
8764,2023-01-01 04:00:00,54,278,11,19,786,574,212,10
8765,2023-01-01 05:00:00,64,191,10,16,518,429,89,5
8766,2023-01-01 06:00:00,149,281,12,14,688,597,91,14
8767,2023-01-01 07:00:00,144,203,12,15,556,482,74,5
8768,2023-01-01 08:00:00,133,241,9,18,518,421,97,8
8769,2023-01-01 09:00:00,140,100,7,10,504,428,76,13
8770,2023-01-01 10:00:00,125,264,13,16,600,525,75,10
8771,2023-01-01 11:00:00,132,158,7,13,539,484,55,6
8772,2023-01-01 12:00:00,94,287,9,12,518,388,130,7
8773,2023-01-01 13:00:00,107,178,12,10,798,582,216,9
8774,2023-01-01 14:00:00,71,209,9,17,671,582,89,5
8775,2023-01-01 15:00:00,85,159,7,15,727,652,75,6
8776,2023-01-01 16:00:00,103,264,11,14,696,579,117,10
8777,2023-01-01 17:00:00,125,218,8,10,594,460,134,5
8778,2023-01-01 18:00:00,89,231,12,11,636,545,91,10
8779,2023-01-01 19:00:00,53,186,12,10,581,462,119,8
8780,2023-01-01 20:00:00,58,208,9,18,730,647,83,11
8781,2023-01-01 21:00:00,108,282,8,18,685,507,178,10
8782,2023-01-01 22:00:00,78,126,7,11,562,459,103,8
8783,2023-01-01 23:00:00,142,229,12,16,788,669,119,13
8784,2023-01-02 00:00:00,138,216,8,18,643,533,110,13
8785,2023-01-02 01:00:00,95,261,9,15,613,500,113,5
8786,2023-01-02 02:00:00,92,183,9,14,576,484,92,13
8787,2023-01-02 03:00:00,101,261,8,16,738,588,150,5
8788,2023-01-02 04:00:00,101,239,11,18,682,560,122,6
8789,2023-01-02 05:00:00,68,187,7,12,730,645,85,5
8790,2023-01-02 06:00:00,107,246,8,16,598,508,90,9
8791,2023-01-02 07:00:00,89,272,10,11,763,537,226,10
8792,2023-01-02 08:00:00,140,231,9,13,500,422,78,5
8793,2023-01-02 09:00:00,118,146,11,10,568,460,108,7
8794,2023-01-02 10:00:00,114,247,7,13,705,497,208,13
8795,2023-01-02 11:00:00,85,281,5,12,667,598,69,12
8796,2023-01-02 12:00:00,67,229,9,16,521,388,133,12
8797,2023-01-02 13:00:00,90,179,13,13,640,528,112,10
8798,2023-01-02 14:00:00,74,246,9,12,591,426,165,7
8799,2023-01-02 15:00:00,52,114,9,12,533,460,73,8
8800,2023-01-02 16:00:00,109,278,9,10,529,373,156,9
8801,2023-01-02 17:00:00,138,134,5,15,682,606,76,9
8802,2023-01-02 18:00:00,91,139,8,11,752,555,197,7
8803,2023-01-02 19:00:00,70,187,6,16,659,547,112,11
8804,2023-01-02 20:00:00,103,187,12,14,709,578,131,12
8805,2023-01-02 21:00:00,74,279,12,14,526,387,139,8
8806,2023-01-02 22:00:00,122,236,7,13,738,655,83,7
8807,2023-01-02 23:00:00,61,220,10,11,636,462,174,5
8808,2023-01-03 00:00:00,142,145,6,16,701,546,155,10
8809,2023-01-03 01:00:00,62,219,5,19,582,437,145,10
8810,2023-01-03 02:00:00,113,152,7,12,679,610,69,14
8811,2023-01-03 03:00:00,106,191,12,15,646,552,94,5
8812,2023-01-03 04:00:00,109,283,6,17,742,542,200,10
8813,2023-01-03 05:00:00,69,199,11,10,785,657,128,12
8814,2023-01-03 06:00:00,60,148,9,14,793,621,172,8
8815,2023-01-03 07:00:00,132,159,14,16,568,458,110,6
8816,2023-01-03 08:00:00,76,170,14,13,736,649,87,13
8817,2023-01-03 09:00:00,149,158,14,13,773,656,117,8
8818,2023-01-03 10:00:00,56,288,12,15,559,419,140,12
8819,2023-01-03 11:00:00,72,155,8,11,582,505,77,8
8820,2023-01-03 12:00:00,58,140,7,17,751,572,179,14
8821,2023-01-03 13:00:00,85,163,13,12,718,604,114,12
8822,2023-01-03 14:00:00,71,246,10,11,735,657,78,7
8823,2023-01-03 15:00:00,52,237,9,16,786,650,136,12
8824,2023-01-03 16:00:00,139,263,14,13,517,464,53,5
8825,2023-01-03 17:00:00,76,246,13,13,546,400,146,8
8826,2023-01-03 18:00:00,147,269,7,16,763,643,120,8
8827,2023-01-03 19:00:00,71,155,9,19,600,500,100,10
8828,2023-01-03 20:00:00,108,276,9,12,586,457,129,10
8829,2023-01-03 21:00:00,72,202,14,10,543,386,157,9
8830,2023-01-03 22:00:00,107,160,6,18,536,479,57,6
8831,2023-01-03 23:00:00,84,180,10,14,706,598,108,13
8832,2023-01-04 00:00:00,109,224,14,15,578,508,70,7
8833,2023-01-04 01:00:00,80,122,13,18,790,672,118,7
8834,2023-01-04 02:00:00,115,236,9,14,788,619,169,8
8835,2023-01-04 03:00:00,144,229,8,11,756,591,165,11
8836,2023-01-04 04:00:00,144,274,12,14,726,539,187,8
8837,2023-01-04 05:00:00,93,101,11,11,641,567,74,9
8838,2023-01-04 06:00:00,144,116,6,18,690,616,74,5
8839,2023-01-04 07:00:00,78,194,9,17,752,655,97,11
8840,2023-01-04 08:00:00,140,257,8,10,785,637,148,8
8841,2023-01-04 09:00:00,113,102,9,16,530,382,148,9
8842,2023-01-04 10:00:00,64,104,5,18,521,422,99,12
8843,2023-01-04 11:00:00,58,269,14,15,596,421,175,12
8844,2023-01-04 12:00:00,89,122,11,17,531,435,96,6
8845,2023-01-04 13:00:00,100,188,11,16,614,455,159,9
8846,2023-01-04 14:00:00,133,178,5,14,749,544,205,5
8847,2023-01-04 15:00:00,111,198,9,17,782,662,120,11
8848,2023-01-04 16:00:00,55,207,11,12,793,583,210,11
8849,2023-01-04 17:00:00,62,145,7,14,741,659,82,10
8850,2023-01-04 18:00:00,87,229,8,13,694,618,76,7
8851,2023-01-04 19:00:00,95,175,12,19,596,485,111,7
8852,2023-01-04 20:00:00,90,219,6,17,685,534,151,9
8853,2023-01-04 21:00:00,65,179,12,14,774,673,101,8
8854,2023-01-04 22:00:00,130,237,8,15,584,463,121,13
8855,2023-01-04 23:00:00,91,247,7,18,752,600,152,11
8856,2023-01-05 00:00:00,59,119,9,16,577,422,155,10
8857,2023-01-05 01:00:00,130,288,5,11,541,423,118,10
8858,2023-01-05 02:00:00,62,249,7,18,779,694,85,7
8859,2023-01-05 03:00:00,110,240,13,19,510,410,100,5
8860,2023-01-05 04:00:00,94,163,12,13,635,488,147,5
8861,2023-01-05 05:00:00,71,164,8,17,786,647,139,12
8862,2023-01-05 06:00:00,72,173,7,19,519,384,135,9
8863,2023-01-05 07:00:00,90,134,11,15,778,675,103,5
8864,2023-01-05 08:00:00,148,163,5,19,714,554,160,7
8865,2023-01-05 09:00:00,112,155,5,18,775,625,150,7
8866,2023-01-05 10:00:00,141,275,10,18,602,490,112,7
8867,2023-01-05 11:00:00,77,152,11,16,619,545,74,9
8868,2023-01-05 12:00:00,147,258,8,12,516,388,128,11
8869,2023-01-05 13:00:00,105,269,11,12,650,541,109,8
8870,2023-01-05 14:00:00,122,273,11,11,688,551,137,8
8871,2023-01-05 15:00:00,61,188,12,10,571,477,94,8
8872,2023-01-05 16:00:00,123,151,6,12,684,587,97,7
8873,2023-01-05 17:00:00,118,114,14,19,554,447,107,8
8874,2023-01-05 18:00:00,93,249,13,13,594,530,64,8
8875,2023-01-05 19:00:00,76,145,13,11,514,378,136,11
8876,2023-01-05 20:00:00,62,151,11,15,533,376,157,11
8877,2023-01-05 21:00:00,86,194,5,10,525,417,108,5
8878,2023-01-05 22:00:00,146,160,5,19,658,504,154,12
8879,2023-01-05 23:00:00,101,140,8,10,715,642,73,8
8880,2023-01-06 00:00:00,62,158,8,11,660,556,104,7
8881,2023-01-06 01:00:00,52,210,13,12,723,548,175,7
8882,2023-01-06 02:00:00,83,225,5,13,638,505,133,7
8883,2023-01-06 03:00:00,148,271,9,16,525,369,156,7
8884,2023-01-06 04:00:00,142,259,8,14,689,516,173,10
8885,2023-01-06 05:00:00,123,115,11,11,620,535,85,5
8886,2023-01-06 06:00:00,92,296,7,16,681,576,105,11
8887,2023-01-06 07:00:00,87,298,10,18,528,405,123,10
8888,2023-01-06 08:00:00,142,166,9,10,557,490,67,10
8889,2023-01-06 09:00:00,134,222,11,16,784,576,208,14
8890,2023-01-06 10:00:00,132,109,13,12,665,544,121,8
8891,2023-01-06 11:00:00,132,130,13,11,579,514,65,13
8892,2023-01-06 12:00:00,143,175,5,16,708,631,77,9
8893,2023-01-06 13:00:00,121,205,13,10,572,459,113,10
8894,2023-01-06 14:00:00,118,292,11,10,630,483,147,8
8895,2023-01-06 15:00:00,149,208,10,11,700,609,91,12
8896,2023-01-06 16:00:00,117,184,5,13,644,453,191,8
8897,2023-01-06 17:00:00,68,168,13,16,677,591,86,7
8898,2023-01-06 18:00:00,125,231,11,14,508,431,77,14
8899,2023-01-06 19:00:00,130,240,13,13,518,376,142,12
8900,2023-01-06 20:00:00,142,276,6,13,570,404,166,13
8901,2023-01-06 21:00:00,99,133,12,18,665,571,94,6
8902,2023-01-06 22:00:00,78,189,5,17,696,617,79,12
8903,2023-01-06 23:00:00,92,112,12,13,542,448,94,7
8904,2023-01-07 00:00:00,117,253,9,18,525,420,105,8
8905,2023-01-07 01:00:00,122,208,8,12,756,676,80,12
8906,2023-01-07 02:00:00,65,185,9,14,592,469,123,7
8907,2023-01-07 03:00:00,121,156,8,12,564,501,63,5
8908,2023-01-07 04:00:00,89,143,12,18,721,557,164,6
8909,2023-01-07 05:00:00,129,162,11,12,557,425,132,9
8910,2023-01-07 06:00:00,54,270,5,18,669,593,76,14
8911,2023-01-07 07:00:00,145,158,11,17,789,704,85,11
8912,2023-01-07 08:00:00,142,142,6,15,551,406,145,11
8913,2023-01-07 09:00:00,58,254,8,14,596,485,111,13
8914,2023-01-07 10:00:00,87,230,5,17,603,424,179,7
8915,2023-01-07 11:00:00,76,122,14,13,671,500,171,13
8916,2023-01-07 12:00:00,113,179,10,13,615,498,117,5
8917,2023-01-07 13:00:00,118,276,7,14,776,645,131,7
8918,2023-01-07 14:00:00,63,226,8,19,543,426,117,10
8919,2023-01-07 15:00:00,52,216,9,18,742,655,87,10
8920,2023-01-07 16:00:00,95,296,10,16,798,716,82,10
8921,2023-01-07 17:00:00,104,204,7,14,688,539,149,8
8922,2023-01-07 18:00:00,70,103,6,13,789,619,170,5
8923,2023-01-07 19:00:00,87,197,12,12,626,532,94,11
8924,2023-01-07 20:00:00,131,136,6,14,797,690,107,7
8925,2023-01-07 21:00:00,137,133,5,18,784,658,126,6
8926,2023-01-07 22:00:00,109,263,5,12,657,514,143,9
8927,2023-01-07 23:00:00,97,218,12,10,747,579,168,5
8928,2023-01-08 00:00:00,145,234,5,14,679,491,188,5
8929,2023-01-08 01:00:00,135,214,9,13,755,558,197,11
8930,2023-01-08 02:00:00,83,284,13,12,515,380,135,13
8931,2023-01-08 03:00:00,79,266,7,10,556,404,152,8
8932,2023-01-08 04:00:00,79,158,7,12,695,602,93,9
8933,2023-01-08 05:00:00,80,208,6,15,664,477,187,5
8934,2023-01-08 06:00:00,68,202,7,19,573,456,117,13
8935,2023-01-08 07:00:00,147,194,9,11,540,378,162,13
8936,2023-01-08 08:00:00,104,156,14,19,645,517,128,5
8937,2023-01-08 09:00:00,147,290,14,14,743,558,185,12
8938,2023-01-08 10:00:00,78,122,8,18,501,436,65,5
8939,2023-01-08 11:00:00,64,139,10,10,582,510,72,7
8940,2023-01-08 12:00:00,85,236,9,16,623,518,105,13
8941,2023-01-08 13:00:00,53,286,8,16,526,381,145,10
8942,2023-01-08 14:00:00,135,139,7,19,567,499,68,14
8943,2023-01-08 15:00:00,120,286,8,11,669,560,109,11
8944,2023-01-08 16:00:00,96,257,5,11,574,405,169,5
8945,2023-01-08 17:00:00,82,291,10,12,551,487,64,10
8946,2023-01-08 18:00:00,79,163,6,19,667,540,127,8
8947,2023-01-08 19:00:00,108,152,12,16,522,433,89,11
8948,2023-01-08 20:00:00,53,252,12,16,617,539,78,9
8949,2023-01-08 21:00:00,143,285,13,10,664,520,144,12
8950,2023-01-08 22:00:00,125,119,14,11,609,444,165,6
8951,2023-01-08 23:00:00,114,299,7,18,714,520,194,13
8952,2023-01-09 00:00:00,59,277,14,10,689,491,198,12
8953,2023-01-09 01:00:00,82,113,11,13,537,474,63,10
8954,2023-01-09 02:00:00,98,129,10,18,633,459,174,14
8955,2023-01-09 03:00:00,145,175,14,12,518,456,62,5
8956,2023-01-09 04:00:00,124,213,6,16,523,428,95,7
8957,2023-01-09 05:00:00,108,169,6,19,533,427,106,13
8958,2023-01-09 06:00:00,120,294,13,14,664,489,175,13
8959,2023-01-09 07:00:00,57,230,14,15,772,657,115,13
8960,2023-01-09 08:00:00,122,255,11,15,738,625,113,7
8961,2023-01-09 09:00:00,145,207,5,19,527,402,125,8
8962,2023-01-09 10:00:00,128,104,10,12,547,480,67,5
8963,2023-01-09 11:00:00,90,216,14,18,765,567,198,10
8964,2023-01-09 12:00:00,70,274,8,18,672,546,126,8
8965,2023-01-09 13:00:00,96,214,11,14,541,475,66,9
8966,2023-01-09 14:00:00,86,123,5,14,537,377,160,8
8967,2023-01-09 15:00:00,64,192,9,12,534,468,66,13
8968,2023-01-09 16:00:00,78,147,13,16,519,375,144,13
8969,2023-01-09 17:00:00,111,101,10,17,727,595,132,8
8970,2023-01-09 18:00:00,98,228,10,16,673,593,80,6
8971,2023-01-09 19:00:00,76,283,13,11,544,467,77,12
8972,2023-01-09 20:00:00,56,261,11,15,592,424,168,5
8973,2023-01-09 21:00:00,77,137,11,17,614,452,162,12
8974,2023-01-09 22:00:00,79,172,6,13,710,510,200,7
8975,2023-01-09 23:00:00,91,174,13,12,641,543,98,13
8976,2023-01-10 00:00:00,123,173,5,16,616,444,172,7
8977,2023-01-10 01:00:00,118,297,14,14,720,516,204,10
8978,2023-01-10 02:00:00,105,243,8,19,572,454,118,12
8979,2023-01-10 03:00:00,70,178,12,12,781,655,126,14
8980,2023-01-10 04:00:00,97,296,8,15,665,503,162,14
8981,2023-01-10 05:00:00,57,172,10,15,720,591,129,10
8982,2023-01-10 06:00:00,95,176,11,11,674,570,104,7
8983,2023-01-10 07:00:00,123,130,14,17,762,672,90,8
8984,2023-01-10 08:00:00,93,252,6,17,767,606,161,9
8985,2023-01-10 09:00:00,127,117,13,13,591,416,175,9
8986,2023-01-10 10:00:00,124,273,12,12,792,589,203,11
8987,2023-01-10 11:00:00,92,194,9,13,662,468,194,5
8988,2023-01-10 12:00:00,142,251,8,15,529,453,76,7
8989,2023-01-10 13:00:00,104,188,12,13,650,496,154,6
8990,2023-01-10 14:00:00,112,121,10,19,610,542,68,5
8991,2023-01-10 15:00:00,141,255,9,15,589,454,135,9
8992,2023-01-10 16:00:00,137,206,7,10,588,452,136,10
8993,2023-01-10 17:00:00,104,289,5,13,686,489,197,10
8994,2023-01-10 18:00:00,71,296,5,10,639,561,78,14
8995,2023-01-10 19:00:00,119,206,6,11,675,503,172,10
8996,2023-01-10 20:00:00,109,104,12,14,586,456,130,10
8997,2023-01-10 21:00:00,140,251,9,13,524,451,73,12
8998,2023-01-10 22:00:00,77,289,11,16,544,468,76,5
8999,2023-01-10 23:00:00,70,165,12,18,629,532,97,11
9000,2023-01-11 00:00:00,111,280,9,17,713,560,153,9
9001,2023-01-11 01:00:00,88,228,10,15,740,532,208,7
9002,2023-01-11 02:00:00,60,155,11,10,550,466,84,6
9003,2023-01-11 03:00:00,116,181,5,10,696,488,208,12
9004,2023-01-11 04:00:00,108,218,9,12,689,518,171,10
9005,2023-01-11 05:00:00,54,148,13,14,753,624,129,11
9006,2023-01-11 06:00:00,127,129,9,15,686,582,104,14
9007,2023-01-11 07:00:00,147,121,9,12,706,600,106,7
9008,2023-01-11 08:00:00,121,227,5,18,549,459,90,6
9009,2023-01-11 09:00:00,74,168,5,17,551,489,62,6
9010,2023-01-11 10:00:00,111,290,13,15,573,467,106,8
9011,2023-01-11 11:00:00,116,287,11,19,572,464,108,9
9012,2023-01-11 12:00:00,119,187,9,12,686,516,170,14
9013,2023-01-11 13:00:00,76,154,11,18,511,405,106,6
9014,2023-01-11 14:00:00,110,247,13,11,575,497,78,5
9015,2023-01-11 15:00:00,71,221,14,13,781,611,170,8
9016,2023-01-11 16:00:00,75,120,11,12,503,367,136,9
9017,2023-01-11 17:00:00,70,228,8,15,622,542,80,5
9018,2023-01-11 18:00:00,62,276,8,17,565,415,150,8
9019,2023-01-11 19:00:00,71,100,10,18,784,566,218,10
9020,2023-01-11 20:00:00,84,208,11,11,788,668,120,12
9021,2023-01-11 21:00:00,141,227,6,15,567,477,90,5
9022,2023-01-11 22:00:00,101,148,14,14,524,396,128,12
9023,2023-01-11 23:00:00,81,290,5,19,689,573,116,9
9024,2023-01-12 00:00:00,109,173,14,18,599,429,170,14
9025,2023-01-12 01:00:00,118,191,6,18,544,468,76,5
9026,2023-01-12 02:00:00,136,227,6,10,760,668,92,14
9027,2023-01-12 03:00:00,92,242,5,15,719,562,157,11
9028,2023-01-12 04:00:00,115,160,12,18,788,577,211,5
9029,2023-01-12 05:00:00,144,196,7,17,507,433,74,7
9030,2023-01-12 06:00:00,62,282,9,16,657,472,185,11
9031,2023-01-12 07:00:00,76,275,13,15,681,606,75,9
9032,2023-01-12 08:00:00,106,172,13,10,606,434,172,12
9033,2023-01-12 09:00:00,126,190,10,13,789,575,214,11
9034,2023-01-12 10:00:00,108,107,6,15,779,638,141,12
9035,2023-01-12 11:00:00,79,288,8,10,767,629,138,13
9036,2023-01-12 12:00:00,134,115,12,18,775,661,114,7
9037,2023-01-12 13:00:00,104,218,8,16,601,440,161,13
9038,2023-01-12 14:00:00,147,223,10,13,512,420,92,13
9039,2023-01-12 15:00:00,135,270,12,17,769,605,164,10
9040,2023-01-12 16:00:00,55,244,8,14,618,498,120,11
9041,2023-01-12 17:00:00,146,258,13,13,628,547,81,13
9042,2023-01-12 18:00:00,51,132,14,16,608,441,167,11
9043,2023-01-12 19:00:00,110,167,8,10,719,611,108,6
9044,2023-01-12 20:00:00,148,163,7,19,798,641,157,12
9045,2023-01-12 21:00:00,113,196,6,11,694,562,132,14
9046,2023-01-12 22:00:00,75,154,10,16,704,600,104,8
9047,2023-01-12 23:00:00,113,231,10,17,517,409,108,11
9048,2023-01-13 00:00:00,105,245,11,13,509,415,94,9
9049,2023-01-13 01:00:00,135,202,10,11,777,664,113,11
9050,2023-01-13 02:00:00,126,278,10,17,649,470,179,11
9051,2023-01-13 03:00:00,110,290,7,13,510,433,77,7
9052,2023-01-13 04:00:00,74,280,11,16,735,591,144,5
9053,2023-01-13 05:00:00,135,184,13,18,512,404,108,11
9054,2023-01-13 06:00:00,138,280,13,18,543,431,112,8
9055,2023-01-13 07:00:00,95,287,9,10,665,482,183,9
9056,2023-01-13 08:00:00,100,127,14,11,520,461,59,14
9057,2023-01-13 09:00:00,138,140,13,17,700,518,182,6
9058,2023-01-13 10:00:00,65,220,9,14,754,610,144,6
9059,2023-01-13 11:00:00,117,281,12,14,623,525,98,13
9060,2023-01-13 12:00:00,74,119,9,18,693,563,130,8
9061,2023-01-13 13:00:00,107,248,8,16,694,504,190,13
9062,2023-01-13 14:00:00,58,262,9,18,735,621,114,10
9063,2023-01-13 15:00:00,137,154,5,15,695,617,78,10
9064,2023-01-13 16:00:00,74,242,8,15,796,596,200,8
9065,2023-01-13 17:00:00,94,160,6,19,627,496,131,6
9066,2023-01-13 18:00:00,94,177,10,19,752,544,208,6
9067,2023-01-13 19:00:00,105,207,13,11,504,449,55,12
9068,2023-01-13 20:00:00,109,202,6,16,509,360,149,6
9069,2023-01-13 21:00:00,140,228,9,18,526,375,151,10
9070,2023-01-13 22:00:00,115,198,6,19,729,557,172,6
9071,2023-01-13 23:00:00,132,169,8,17,559,409,150,6
9072,2023-01-14 00:00:00,116,220,12,11,749,579,170,14
9073,2023-01-14 01:00:00,59,107,8,11,620,554,66,14
9074,2023-01-14 02:00:00,82,228,12,17,501,396,105,5
9075,2023-01-14 03:00:00,60,116,10,10,618,461,157,6
9076,2023-01-14 04:00:00,53,119,5,13,533,476,57,8
9077,2023-01-14 05:00:00,131,134,7,10,585,464,121,8
9078,2023-01-14 06:00:00,114,266,7,18,626,442,184,14
9079,2023-01-14 07:00:00,130,111,11,19,628,445,183,9
9080,2023-01-14 08:00:00,122,220,9,13,723,607,116,6
9081,2023-01-14 09:00:00,58,142,13,19,773,624,149,13
9082,2023-01-14 10:00:00,66,242,11,14,625,497,128,10
9083,2023-01-14 11:00:00,87,276,13,16,755,628,127,9
9084,2023-01-14 12:00:00,98,175,14,17,775,613,162,8
9085,2023-01-14 13:00:00,101,197,14,18,592,521,71,12
9086,2023-01-14 14:00:00,116,245,14,13,549,420,129,6
9087,2023-01-14 15:00:00,78,153,14,18,610,510,100,9
9088,2023-01-14 16:00:00,143,184,11,17,619,535,84,11
9089,2023-01-14 17:00:00,60,193,11,17,593,477,116,7
9090,2023-01-14 18:00:00,106,135,14,17,550,446,104,11
9091,2023-01-14 19:00:00,90,257,7,18,664,521,143,12
9092,2023-01-14 20:00:00,102,128,14,16,617,484,133,13
9093,2023-01-14 21:00:00,59,101,14,14,743,617,126,14
9094,2023-01-14 22:00:00,141,141,11,10,795,616,179,11
9095,2023-01-14 23:00:00,89,129,7,10,625,521,104,6
9096,2023-01-15 00:00:00,57,188,7,15,551,443,108,5
9097,2023-01-15 01:00:00,72,228,5,17,692,501,191,9
9098,2023-01-15 02:00:00,143,270,11,13,753,598,155,11
9099,2023-01-15 03:00:00,106,169,7,18,663,534,129,8
9100,2023-01-15 04:00:00,59,150,12,14,620,545,75,12
9101,2023-01-15 05:00:00,97,294,11,19,636,485,151,10
9102,2023-01-15 06:00:00,121,257,10,19,701,555,146,5
9103,2023-01-15 07:00:00,85,182,10,10,600,527,73,5
9104,2023-01-15 08:00:00,108,166,9,10,782,647,135,6
9105,2023-01-15 09:00:00,138,292,13,17,704,619,85,9
9106,2023-01-15 10:00:00,68,275,9,15,764,654,110,7
9107,2023-01-15 11:00:00,60,203,13,18,677,501,176,6
9108,2023-01-15 12:00:00,74,177,14,19,602,538,64,5
9109,2023-01-15 13:00:00,72,293,12,16,556,452,104,11
9110,2023-01-15 14:00:00,57,233,6,15,654,470,184,8
9111,2023-01-15 15:00:00,149,194,9,10,783,565,218,13
9112,2023-01-15 16:00:00,65,241,12,18,701,614,87,7
9113,2023-01-15 17:00:00,54,186,14,10,764,602,162,10
9114,2023-01-15 18:00:00,101,277,14,11,576,430,146,10
9115,2023-01-15 19:00:00,53,156,10,14,746,627,119,10
9116,2023-01-15 20:00:00,149,205,6,19,664,531,133,6
9117,2023-01-15 21:00:00,100,290,8,11,646,486,160,12
9118,2023-01-15 22:00:00,122,225,7,16,510,363,147,7
9119,2023-01-15 23:00:00,138,237,10,19,735,657,78,13
9120,2023-01-16 00:00:00,83,176,13,15,594,446,148,14
9121,2023-01-16 01:00:00,142,204,11,14,658,509,149,10
9122,2023-01-16 02:00:00,118,154,8,10,786,635,151,14
9123,2023-01-16 03:00:00,90,269,10,18,568,432,136,7
9124,2023-01-16 04:00:00,56,262,7,18,501,379,122,11
9125,2023-01-16 05:00:00,118,214,12,15,720,604,116,6
9126,2023-01-16 06:00:00,133,171,9,11,596,430,166,7
9127,2023-01-16 07:00:00,60,220,10,15,601,473,128,8
9128,2023-01-16 08:00:00,67,172,14,11,724,541,183,11
9129,2023-01-16 09:00:00,146,206,10,11,568,414,154,12
9130,2023-01-16 10:00:00,133,135,8,17,781,592,189,14
9131,2023-01-16 11:00:00,113,265,10,13,696,600,96,8
9132,2023-01-16 12:00:00,110,191,8,18,792,707,85,12
9133,2023-01-16 13:00:00,149,135,8,17,628,452,176,14
9134,2023-01-16 14:00:00,75,212,12,19,576,496,80,9
9135,2023-01-16 15:00:00,147,176,10,12,502,389,113,14
9136,2023-01-16 16:00:00,134,101,7,19,761,584,177,12
9137,2023-01-16 17:00:00,100,118,10,17,622,462,160,13
9138,2023-01-16 18:00:00,92,255,10,11,613,440,173,9
9139,2023-01-16 19:00:00,93,106,8,14,731,610,121,14
9140,2023-01-16 20:00:00,100,111,6,19,577,458,119,13
9141,2023-01-16 21:00:00,110,140,7,17,619,458,161,7
9142,2023-01-16 22:00:00,135,121,10,17,563,472,91,13
9143,2023-01-16 23:00:00,121,245,11,19,766,556,210,6
9144,2023-01-17 00:00:00,147,108,6,14,667,506,161,11
9145,2023-01-17 01:00:00,141,118,8,12,639,495,144,10
9146,2023-01-17 02:00:00,65,189,8,17,654,555,99,10
9147,2023-01-17 03:00:00,78,108,5,15,690,607,83,11
9148,2023-01-17 04:00:00,109,115,11,13,686,489,197,11
9149,2023-01-17 05:00:00,84,225,11,18,698,510,188,13
9150,2023-01-17 06:00:00,123,268,7,19,663,529,134,9
9151,2023-01-17 07:00:00,101,286,9,18,678,485,193,7
9152,2023-01-17 08:00:00,88,135,8,13,605,473,132,9
9153,2023-01-17 09:00:00,145,175,9,11,638,567,71,14
9154,2023-01-17 10:00:00,105,226,8,17,748,551,197,7
9155,2023-01-17 11:00:00,51,275,6,15,708,570,138,11
9156,2023-01-17 12:00:00,126,297,8,14,526,470,56,5
9157,2023-01-17 13:00:00,122,223,6,17,760,546,214,5
9158,2023-01-17 14:00:00,130,180,8,16,796,603,193,12
9159,2023-01-17 15:00:00,92,127,6,18,571,449,122,5
9160,2023-01-17 16:00:00,81,144,13,19,537,468,69,13
9161,2023-01-17 17:00:00,111,186,6,12,618,524,94,13
9162,2023-01-17 18:00:00,97,104,10,17,564,440,124,8
9163,2023-01-17 19:00:00,114,134,5,19,746,567,179,7
9164,2023-01-17 20:00:00,96,166,10,14,646,457,189,13
9165,2023-01-17 21:00:00,127,279,5,11,685,532,153,5
9166,2023-01-17 22:00:00,58,256,8,19,508,363,145,10
9167,2023-01-17 23:00:00,99,210,7,13,596,434,162,11
9168,2023-01-18 00:00:00,136,237,6,15,728,566,162,11
9169,2023-01-18 01:00:00,80,240,10,15,531,425,106,13
9170,2023-01-18 02:00:00,126,225,6,14,722,571,151,12
9171,2023-01-18 03:00:00,112,101,5,13,786,571,215,14
9172,2023-01-18 04:00:00,138,154,14,13,687,501,186,13
9173,2023-01-18 05:00:00,117,240,10,12,670,487,183,11
9174,2023-01-18 06:00:00,94,211,12,10,791,577,214,14
9175,2023-01-18 07:00:00,87,211,13,17,618,538,80,12
9176,2023-01-18 08:00:00,61,110,6,12,735,547,188,9
9177,2023-01-18 09:00:00,113,280,6,16,616,437,179,8
9178,2023-01-18 10:00:00,135,168,9,18,593,470,123,10
9179,2023-01-18 11:00:00,120,158,9,16,750,571,179,5
9180,2023-01-18 12:00:00,51,159,6,13,751,659,92,12
9181,2023-01-18 13:00:00,129,108,13,18,611,540,71,7
9182,2023-01-18 14:00:00,143,218,6,12,515,397,118,8
9183,2023-01-18 15:00:00,91,146,11,10,551,495,56,8
9184,2023-01-18 16:00:00,97,206,6,13,733,604,129,12
9185,2023-01-18 17:00:00,53,114,7,10,596,502,94,8
9186,2023-01-18 18:00:00,70,289,6,15,757,594,163,9
9187,2023-01-18 19:00:00,99,169,11,12,614,501,113,9
9188,2023-01-18 20:00:00,70,123,10,12,624,437,187,5
9189,2023-01-18 21:00:00,62,138,14,14,763,630,133,9
9190,2023-01-18 22:00:00,112,253,13,13,775,633,142,10
9191,2023-01-18 23:00:00,129,185,10,19,518,436,82,9
9192,2023-01-19 00:00:00,94,299,13,14,578,473,105,5
9193,2023-01-19 01:00:00,135,124,14,13,599,480,119,9
9194,2023-01-19 02:00:00,79,261,6,19,657,549,108,9
9195,2023-01-19 03:00:00,99,236,13,18,578,449,129,12
9196,2023-01-19 04:00:00,95,231,12,15,547,432,115,6
9197,2023-01-19 05:00:00,115,188,11,17,600,445,155,9
9198,2023-01-19 06:00:00,146,191,11,15,759,678,81,7
9199,2023-01-19 07:00:00,149,298,12,16,673,596,77,6
9200,2023-01-19 08:00:00,138,111,9,17,658,551,107,14
9201,2023-01-19 09:00:00,67,127,11,11,510,406,104,11
9202,2023-01-19 10:00:00,130,169,8,11,628,491,137,5
9203,2023-01-19 11:00:00,123,232,6,14,788,567,221,14
9204,2023-01-19 12:00:00,139,243,5,12,576,414,162,14
9205,2023-01-19 13:00:00,69,241,13,16,668,557,111,11
9206,2023-01-19 14:00:00,145,257,5,17,752,534,218,5
9207,2023-01-19 15:00:00,80,265,6,11,728,546,182,5
9208,2023-01-19 16:00:00,137,293,9,18,561,393,168,14
9209,2023-01-19 17:00:00,89,130,6,10,598,462,136,13
9210,2023-01-19 18:00:00,67,293,9,12,584,448,136,10
9211,2023-01-19 19:00:00,61,262,5,13,523,429,94,10
9212,2023-01-19 20:00:00,101,293,8,17,621,525,96,5
9213,2023-01-19 21:00:00,80,211,13,19,655,572,83,10
9214,2023-01-19 22:00:00,75,259,6,13,631,469,162,10
9215,2023-01-19 23:00:00,146,263,7,11,672,526,146,9
9216,2023-01-20 00:00:00,109,133,5,11,724,643,81,12
9217,2023-01-20 01:00:00,51,122,7,15,594,458,136,12
9218,2023-01-20 02:00:00,108,234,12,11,743,650,93,5
9219,2023-01-20 03:00:00,121,291,8,11,515,379,136,7
9220,2023-01-20 04:00:00,142,240,8,12,534,423,111,9
9221,2023-01-20 05:00:00,83,209,11,17,511,455,56,9
9222,2023-01-20 06:00:00,136,134,13,12,727,578,149,13
9223,2023-01-20 07:00:00,123,160,8,19,622,473,149,14
9224,2023-01-20 08:00:00,127,151,11,15,620,504,116,9
9225,2023-01-20 09:00:00,66,162,14,16,751,528,223,6
9226,2023-01-20 10:00:00,101,192,11,12,596,482,114,9
9227,2023-01-20 11:00:00,85,286,12,12,559,478,81,11
9228,2023-01-20 12:00:00,79,178,8,13,530,415,115,6
9229,2023-01-20 13:00:00,126,187,13,16,672,517,155,14
9230,2023-01-20 14:00:00,137,141,6,18,743,592,151,13
9231,2023-01-20 15:00:00,149,157,14,17,664,537,127,7
9232,2023-01-20 16:00:00,93,134,14,19,692,545,147,9
9233,2023-01-20 17:00:00,56,158,9,13,779,675,104,14
9234,2023-01-20 18:00:00,89,229,10,14,604,468,136,9
9235,2023-01-20 19:00:00,104,188,9,17,605,481,124,9
9236,2023-01-20 20:00:00,128,178,7,16,520,450,70,5
9237,2023-01-20 21:00:00,144,188,7,12,565,468,97,7
9238,2023-01-20 22:00:00,133,223,6,11,764,602,162,12
9239,2023-01-20 23:00:00,63,273,7,13,682,569,113,11
9240,2023-01-21 00:00:00,57,180,13,19,725,570,155,10
9241,2023-01-21 01:00:00,92,204,12,14,577,518,59,13
9242,2023-01-21 02:00:00,124,279,10,10,570,472,98,9
9243,2023-01-21 03:00:00,121,159,6,17,786,557,229,14
9244,2023-01-21 04:00:00,89,153,10,14,549,474,75,5
9245,2023-01-21 05:00:00,107,199,9,16,569,474,95,13
9246,2023-01-21 06:00:00,89,206,13,14,685,496,189,6
9247,2023-01-21 07:00:00,123,193,9,11,523,430,93,8
9248,2023-01-21 08:00:00,84,117,9,19,742,525,217,11
9249,2023-01-21 09:00:00,90,201,10,11,626,443,183,12
9250,2023-01-21 10:00:00,143,226,10,14,553,470,83,8
9251,2023-01-21 11:00:00,78,299,5,16,708,632,76,12
9252,2023-01-21 12:00:00,118,286,14,12,749,600,149,10
9253,2023-01-21 13:00:00,124,212,10,13,608,472,136,6
9254,2023-01-21 14:00:00,149,266,12,13,539,387,152,10
9255,2023-01-21 15:00:00,60,204,7,14,747,585,162,14
9256,2023-01-21 16:00:00,120,176,9,13,688,552,136,8
9257,2023-01-21 17:00:00,50,183,6,14,565,477,88,14
9258,2023-01-21 18:00:00,69,181,5,13,581,515,66,13
9259,2023-01-21 19:00:00,79,110,9,18,743,567,176,8
9260,2023-01-21 20:00:00,91,119,14,11,676,517,159,5
9261,2023-01-21 21:00:00,138,238,11,17,613,452,161,10
9262,2023-01-21 22:00:00,138,234,7,17,503,410,93,11
9263,2023-01-21 23:00:00,148,152,11,10,633,481,152,12
9264,2023-01-22 00:00:00,78,146,9,11,736,566,170,6
9265,2023-01-22 01:00:00,122,282,11,13,712,535,177,14
9266,2023-01-22 02:00:00,58,179,5,10,749,666,83,9
9267,2023-01-22 03:00:00,136,216,11,16,525,452,73,8
9268,2023-01-22 04:00:00,64,154,8,12,758,565,193,9
9269,2023-01-22 05:00:00,111,201,8,19,774,562,212,10
9270,2023-01-22 06:00:00,56,140,7,17,504,385,119,8
9271,2023-01-22 07:00:00,89,197,6,12,738,573,165,7
9272,2023-01-22 08:00:00,148,244,13,15,568,436,132,9
9273,2023-01-22 09:00:00,96,265,9,13,519,413,106,14
9274,2023-01-22 10:00:00,110,256,9,17,646,532,114,9
9275,2023-01-22 11:00:00,69,176,10,15,532,377,155,9
9276,2023-01-22 12:00:00,147,237,11,15,797,624,173,9
9277,2023-01-22 13:00:00,100,184,8,15,760,545,215,9
9278,2023-01-22 14:00:00,129,246,5,15,618,553,65,13
9279,2023-01-22 15:00:00,135,260,13,16,650,551,99,11
9280,2023-01-22 16:00:00,63,191,11,17,781,699,82,9
9281,2023-01-22 17:00:00,79,184,6,17,636,492,144,10
9282,2023-01-22 18:00:00,97,284,7,19,604,499,105,8
9283,2023-01-22 19:00:00,145,179,14,14,593,450,143,13
9284,2023-01-22 20:00:00,70,122,8,15,779,675,104,13
9285,2023-01-22 21:00:00,61,240,5,11,563,449,114,10
9286,2023-01-22 22:00:00,109,114,9,17,571,500,71,9
9287,2023-01-22 23:00:00,53,188,14,12,767,575,192,7
9288,2023-01-23 00:00:00,51,281,8,15,754,654,100,8
9289,2023-01-23 01:00:00,91,118,5,16,650,570,80,8
9290,2023-01-23 02:00:00,119,195,9,11,550,419,131,9
9291,2023-01-23 03:00:00,145,104,8,18,655,495,160,6
9292,2023-01-23 04:00:00,64,280,7,14,675,596,79,8
9293,2023-01-23 05:00:00,106,223,11,14,601,439,162,9
9294,2023-01-23 06:00:00,65,108,9,12,772,574,198,8
9295,2023-01-23 07:00:00,103,233,12,18,569,429,140,7
9296,2023-01-23 08:00:00,54,259,8,11,757,636,121,9
9297,2023-01-23 09:00:00,52,141,9,10,792,611,181,12
9298,2023-01-23 10:00:00,95,256,6,18,766,554,212,8
9299,2023-01-23 11:00:00,56,215,10,16,602,519,83,14
9300,2023-01-23 12:00:00,96,222,13,10,698,494,204,9
9301,2023-01-23 13:00:00,69,234,10,12,680,597,83,12
9302,2023-01-23 14:00:00,84,245,9,15,513,386,127,10
9303,2023-01-23 15:00:00,86,150,12,19,509,371,138,10
9304,2023-01-23 16:00:00,90,132,13,15,552,410,142,7
9305,2023-01-23 17:00:00,94,216,13,15,669,474,195,13
9306,2023-01-23 18:00:00,148,252,10,14,735,593,142,9
9307,2023-01-23 19:00:00,79,284,13,10,724,595,129,13
9308,2023-01-23 20:00:00,93,159,13,19,523,420,103,10
9309,2023-01-23 21:00:00,101,188,5,11,524,381,143,14
9310,2023-01-23 22:00:00,100,222,13,15,558,398,160,6
9311,2023-01-23 23:00:00,127,171,6,18,760,552,208,11
9312,2023-01-24 00:00:00,145,202,14,13,636,479,157,8
9313,2023-01-24 01:00:00,97,169,7,13,511,409,102,14
9314,2023-01-24 02:00:00,60,201,12,14,740,581,159,5
9315,2023-01-24 03:00:00,114,282,9,14,501,375,126,8
9316,2023-01-24 04:00:00,148,271,5,19,743,633,110,14
9317,2023-01-24 05:00:00,66,122,6,16,716,633,83,12
9318,2023-01-24 06:00:00,109,239,6,11,500,424,76,9
9319,2023-01-24 07:00:00,145,178,7,14,616,508,108,7
9320,2023-01-24 08:00:00,106,151,13,18,741,535,206,8
9321,2023-01-24 09:00:00,127,154,10,15,569,477,92,14
9322,2023-01-24 10:00:00,54,231,12,16,680,476,204,5
9323,2023-01-24 11:00:00,85,202,8,12,681,508,173,5
9324,2023-01-24 12:00:00,51,288,7,14,582,497,85,11
9325,2023-01-24 13:00:00,82,117,13,15,792,617,175,6
9326,2023-01-24 14:00:00,96,197,8,11,505,367,138,9
9327,2023-01-24 15:00:00,87,226,14,13,797,698,99,13
9328,2023-01-24 16:00:00,113,100,13,19,778,582,196,10
9329,2023-01-24 17:00:00,109,215,10,16,556,465,91,14
9330,2023-01-24 18:00:00,114,247,5,14,543,468,75,10
9331,2023-01-24 19:00:00,139,264,5,19,759,541,218,6
9332,2023-01-24 20:00:00,147,213,9,18,665,590,75,12
9333,2023-01-24 21:00:00,129,167,10,12,604,524,80,8
9334,2023-01-24 22:00:00,61,159,6,15,691,562,129,5
9335,2023-01-24 23:00:00,111,294,13,13,752,654,98,12
9336,2023-01-25 00:00:00,126,154,5,17,658,557,101,8
9337,2023-01-25 01:00:00,129,243,10,11,772,656,116,8
9338,2023-01-25 02:00:00,51,160,11,16,782,671,111,5
9339,2023-01-25 03:00:00,64,194,11,15,568,492,76,13
9340,2023-01-25 04:00:00,129,251,10,15,748,644,104,11
9341,2023-01-25 05:00:00,101,124,7,10,555,492,63,10
9342,2023-01-25 06:00:00,63,299,5,17,789,581,208,13
9343,2023-01-25 07:00:00,110,158,10,13,754,619,135,5
9344,2023-01-25 08:00:00,100,107,6,13,536,471,65,10
9345,2023-01-25 09:00:00,66,147,6,13,769,540,229,8
9346,2023-01-25 10:00:00,133,266,11,15,701,606,95,6
9347,2023-01-25 11:00:00,59,233,13,19,675,574,101,11
9348,2023-01-25 12:00:00,60,176,12,18,756,532,224,8
9349,2023-01-25 13:00:00,94,158,6,18,620,508,112,14
9350,2023-01-25 14:00:00,56,220,10,10,772,597,175,13
9351,2023-01-25 15:00:00,105,198,7,18,516,400,116,6
9352,2023-01-25 16:00:00,78,140,12,15,564,445,119,7
9353,2023-01-25 17:00:00,83,215,5,12,674,583,91,11
9354,2023-01-25 18:00:00,111,214,11,19,513,378,135,10
9355,2023-01-25 19:00:00,142,187,12,19,695,602,93,9
9356,2023-01-25 20:00:00,96,168,12,11,508,435,73,5
9357,2023-01-25 21:00:00,62,214,6,19,686,520,166,11
9358,2023-01-25 22:00:00,140,282,13,14,524,449,75,9
9359,2023-01-25 23:00:00,148,238,6,13,556,490,66,8
9360,2023-01-26 00:00:00,146,166,9,18,757,632,125,14
9361,2023-01-26 01:00:00,69,261,11,19,578,513,65,10
9362,2023-01-26 02:00:00,138,210,11,11,656,521,135,14
9363,2023-01-26 03:00:00,121,272,7,12,642,510,132,10
9364,2023-01-26 04:00:00,68,174,10,12,553,388,165,8
9365,2023-01-26 05:00:00,51,236,11,18,501,395,106,8
9366,2023-01-26 06:00:00,131,243,5,19,676,600,76,8
9367,2023-01-26 07:00:00,91,298,11,12,734,617,117,14
9368,2023-01-26 08:00:00,70,104,14,10,537,459,78,10
9369,2023-01-26 09:00:00,88,165,11,13,631,445,186,9
9370,2023-01-26 10:00:00,115,244,13,12,722,578,144,14
9371,2023-01-26 11:00:00,133,233,10,14,642,560,82,8
9372,2023-01-26 12:00:00,64,152,13,10,623,512,111,9
9373,2023-01-26 13:00:00,129,286,11,19,574,404,170,10
9374,2023-01-26 14:00:00,106,163,14,14,706,576,130,13
9375,2023-01-26 15:00:00,108,110,7,13,768,560,208,13
9376,2023-01-26 16:00:00,95,231,9,19,586,428,158,13
9377,2023-01-26 17:00:00,119,260,12,17,614,444,170,10
9378,2023-01-26 18:00:00,90,246,8,18,749,655,94,9
9379,2023-01-26 19:00:00,143,211,8,19,621,513,108,9
9380,2023-01-26 20:00:00,102,266,9,15,738,524,214,10
9381,2023-01-26 21:00:00,72,242,11,11,729,524,205,10
9382,2023-01-26 22:00:00,149,166,5,12,752,557,195,10
9383,2023-01-26 23:00:00,75,215,9,17,606,478,128,7
9384,2023-01-27 00:00:00,143,255,9,13,628,517,111,8
9385,2023-01-27 01:00:00,142,147,8,13,650,519,131,7
9386,2023-01-27 02:00:00,66,297,14,17,536,397,139,14
9387,2023-01-27 03:00:00,101,106,12,17,564,474,90,5
9388,2023-01-27 04:00:00,82,179,5,16,532,450,82,14
9389,2023-01-27 05:00:00,120,146,6,10,725,636,89,6
9390,2023-01-27 06:00:00,116,273,14,19,607,426,181,14
9391,2023-01-27 07:00:00,99,287,9,14,506,428,78,7
9392,2023-01-27 08:00:00,80,273,6,15,523,383,140,12
9393,2023-01-27 09:00:00,67,233,11,14,547,477,70,8
9394,2023-01-27 10:00:00,85,102,9,18,578,456,122,10
9395,2023-01-27 11:00:00,130,298,9,15,763,603,160,9
9396,2023-01-27 12:00:00,75,247,10,18,642,471,171,11
9397,2023-01-27 13:00:00,113,182,7,13,735,573,162,11
9398,2023-01-27 14:00:00,106,287,7,12,645,534,111,9
9399,2023-01-27 15:00:00,51,231,14,18,791,594,197,10
9400,2023-01-27 16:00:00,60,227,6,17,609,478,131,11
9401,2023-01-27 17:00:00,130,192,12,12,583,459,124,12
9402,2023-01-27 18:00:00,68,278,11,16,697,613,84,11
9403,2023-01-27 19:00:00,125,181,14,16,643,474,169,13
9404,2023-01-27 20:00:00,111,179,12,12,734,620,114,9
9405,2023-01-27 21:00:00,94,162,7,12,716,583,133,9
9406,2023-01-27 22:00:00,87,289,10,11,756,583,173,7
9407,2023-01-27 23:00:00,90,248,12,10,511,398,113,10
9408,2023-01-28 00:00:00,81,180,6,14,794,689,105,14
9409,2023-01-28 01:00:00,94,151,11,14,569,454,115,14
9410,2023-01-28 02:00:00,105,125,5,18,794,595,199,7
9411,2023-01-28 03:00:00,82,130,7,11,543,473,70,14
9412,2023-01-28 04:00:00,143,185,8,16,688,496,192,7
9413,2023-01-28 05:00:00,147,257,10,17,736,616,120,13
9414,2023-01-28 06:00:00,126,131,9,16,631,467,164,8
9415,2023-01-28 07:00:00,103,253,14,18,634,516,118,6
9416,2023-01-28 08:00:00,68,240,5,18,532,477,55,13
9417,2023-01-28 09:00:00,136,102,14,19,700,554,146,11
9418,2023-01-28 10:00:00,104,194,11,11,622,497,125,8
9419,2023-01-28 11:00:00,139,108,6,12,764,621,143,11
9420,2023-01-28 12:00:00,96,236,8,13,583,486,97,6
9421,2023-01-28 13:00:00,105,263,13,19,667,544,123,8
9422,2023-01-28 14:00:00,137,261,9,17,559,476,83,14
9423,2023-01-28 15:00:00,112,234,5,19,767,589,178,12
9424,2023-01-28 16:00:00,125,121,6,15,785,572,213,12
9425,2023-01-28 17:00:00,121,161,6,10,599,472,127,13
9426,2023-01-28 18:00:00,127,201,14,18,606,449,157,10
9427,2023-01-28 19:00:00,123,180,13,10,610,488,122,7
9428,2023-01-28 20:00:00,110,152,5,14,539,429,110,9
9429,2023-01-28 21:00:00,122,171,13,14,653,548,105,5
9430,2023-01-28 22:00:00,111,275,6,17,584,464,120,5
9431,2023-01-28 23:00:00,106,296,8,17,657,587,70,10
9432,2023-01-29 00:00:00,56,134,11,14,603,498,105,13
9433,2023-01-29 01:00:00,69,147,13,14,615,523,92,13
9434,2023-01-29 02:00:00,98,201,6,18,595,461,134,13
9435,2023-01-29 03:00:00,145,134,14,11,682,545,137,8
9436,2023-01-29 04:00:00,101,188,8,11,776,640,136,12
9437,2023-01-29 05:00:00,65,124,9,19,730,564,166,12
9438,2023-01-29 06:00:00,65,259,5,17,742,660,82,13
9439,2023-01-29 07:00:00,131,223,13,14,582,482,100,11
9440,2023-01-29 08:00:00,136,221,7,11,545,473,72,7
9441,2023-01-29 09:00:00,132,240,5,14,623,518,105,8
9442,2023-01-29 10:00:00,97,128,5,16,543,449,94,12
9443,2023-01-29 11:00:00,92,165,6,19,767,576,191,6
9444,2023-01-29 12:00:00,71,185,6,16,694,549,145,9
9445,2023-01-29 13:00:00,70,102,12,16,744,651,93,7
9446,2023-01-29 14:00:00,91,277,5,12,613,527,86,6
9447,2023-01-29 15:00:00,127,120,13,12,529,370,159,10
9448,2023-01-29 16:00:00,135,233,5,18,782,598,184,12
9449,2023-01-29 17:00:00,101,236,6,12,708,609,99,7
9450,2023-01-29 18:00:00,131,121,5,11,540,466,74,8
9451,2023-01-29 19:00:00,62,198,10,15,621,454,167,8
9452,2023-01-29 20:00:00,97,142,14,18,556,424,132,11
9453,2023-01-29 21:00:00,117,289,6,12,659,481,178,12
9454,2023-01-29 22:00:00,115,222,5,12,513,364,149,9
9455,2023-01-29 23:00:00,76,253,11,13,578,507,71,7
9456,2023-01-30 00:00:00,121,146,9,19,600,529,71,7
9457,2023-01-30 01:00:00,107,246,6,18,515,461,54,11
9458,2023-01-30 02:00:00,127,248,7,17,737,564,173,12
9459,2023-01-30 03:00:00,71,146,13,16,528,403,125,14
9460,2023-01-30 04:00:00,88,228,8,10,759,653,106,11
9461,2023-01-30 05:00:00,101,129,10,10,718,566,152,8
9462,2023-01-30 06:00:00,83,238,13,11,507,447,60,6
9463,2023-01-30 07:00:00,104,123,10,16,790,593,197,7
9464,2023-01-30 08:00:00,117,172,7,15,519,391,128,12
9465,2023-01-30 09:00:00,77,135,13,12,685,533,152,9
9466,2023-01-30 10:00:00,105,149,13,15,725,630,95,13
9467,2023-01-30 11:00:00,125,201,14,11,632,445,187,14
9468,2023-01-30 12:00:00,144,225,14,15,502,406,96,9
9469,2023-01-30 13:00:00,90,201,13,15,748,666,82,14
9470,2023-01-30 14:00:00,91,262,6,19,768,665,103,11
9471,2023-01-30 15:00:00,125,293,11,18,677,488,189,7
9472,2023-01-30 16:00:00,146,296,8,13,544,429,115,14
9473,2023-01-30 17:00:00,72,146,12,15,664,536,128,14
9474,2023-01-30 18:00:00,52,292,9,17,594,476,118,12
9475,2023-01-30 19:00:00,108,198,10,16,545,443,102,5
9476,2023-01-30 20:00:00,54,196,11,14,760,660,100,11
9477,2023-01-30 21:00:00,64,131,11,19,628,556,72,12
9478,2023-01-30 22:00:00,106,266,9,15,532,425,107,11
9479,2023-01-30 23:00:00,91,240,13,15,555,397,158,5
9480,2023-01-31 00:00:00,142,189,13,12,652,463,189,7
9481,2023-01-31 01:00:00,134,254,6,16,633,519,114,11
9482,2023-01-31 02:00:00,78,156,8,16,704,583,121,14
9483,2023-01-31 03:00:00,120,265,11,19,749,595,154,10
9484,2023-01-31 04:00:00,128,128,7,19,696,567,129,13
9485,2023-01-31 05:00:00,138,274,9,17,776,546,230,13
9486,2023-01-31 06:00:00,110,213,10,11,689,526,163,5
9487,2023-01-31 07:00:00,107,266,10,14,513,454,59,12
9488,2023-01-31 08:00:00,106,175,14,13,668,575,93,11
9489,2023-01-31 09:00:00,83,132,12,13,674,494,180,8
9490,2023-01-31 10:00:00,138,210,13,16,692,533,159,8
9491,2023-01-31 11:00:00,87,217,10,18,530,375,155,9
9492,2023-01-31 12:00:00,111,220,8,15,538,467,71,12
9493,2023-01-31 13:00:00,149,296,6,13,634,485,149,7
9494,2023-01-31 14:00:00,62,183,12,11,790,591,199,13
9495,2023-01-31 15:00:00,94,255,9,10,740,600,140,7
9496,2023-01-31 16:00:00,123,229,7,16,785,554,231,7
9497,2023-01-31 17:00:00,78,127,12,16,576,485,91,9
9498,2023-01-31 18:00:00,104,121,9,10,561,425,136,11
9499,2023-01-31 19:00:00,135,238,9,11,763,548,215,13
9500,2023-01-31 20:00:00,123,243,13,16,532,422,110,12
9501,2023-01-31 21:00:00,123,105,12,10,685,561,124,6
9502,2023-01-31 22:00:00,119,203,6,13,652,456,196,10
9503,2023-01-31 23:00:00,133,183,10,19,700,511,189,7
9504,2023-02-01 00:00:00,70,285,11,13,726,570,156,5
9505,2023-02-01 01:00:00,96,276,9,16,789,597,192,12
9506,2023-02-01 02:00:00,73,171,6,11,537,386,151,13
9507,2023-02-01 03:00:00,130,192,8,16,737,568,169,6
9508,2023-02-01 04:00:00,123,120,8,18,557,402,155,6
9509,2023-02-01 05:00:00,87,134,12,18,648,542,106,6
9510,2023-02-01 06:00:00,106,139,5,13,664,558,106,11
9511,2023-02-01 07:00:00,147,150,9,10,733,532,201,9
9512,2023-02-01 08:00:00,98,177,6,12,629,517,112,8
9513,2023-02-01 09:00:00,68,183,11,16,623,553,70,7
9514,2023-02-01 10:00:00,85,199,5,12,692,599,93,13
9515,2023-02-01 11:00:00,87,109,12,10,678,532,146,9
9516,2023-02-01 12:00:00,53,224,7,12,500,443,57,10
9517,2023-02-01 13:00:00,140,288,7,19,640,524,116,8
9518,2023-02-01 14:00:00,76,276,6,13,703,514,189,10
9519,2023-02-01 15:00:00,103,212,5,16,659,501,158,13
9520,2023-02-01 16:00:00,90,260,8,11,581,481,100,8
9521,2023-02-01 17:00:00,122,148,8,18,620,549,71,8
9522,2023-02-01 18:00:00,53,288,9,13,724,574,150,13
9523,2023-02-01 19:00:00,140,127,14,12,609,498,111,10
9524,2023-02-01 20:00:00,133,241,9,11,572,434,138,12
9525,2023-02-01 21:00:00,92,170,12,10,762,556,206,12
9526,2023-02-01 22:00:00,81,272,14,15,776,599,177,8
9527,2023-02-01 23:00:00,127,244,6,18,579,517,62,11
9528,2023-02-02 00:00:00,100,187,7,19,627,455,172,6
9529,2023-02-02 01:00:00,62,294,6,12,747,549,198,7
9530,2023-02-02 02:00:00,117,194,9,10,739,617,122,8
9531,2023-02-02 03:00:00,120,249,5,16,791,578,213,11
9532,2023-02-02 04:00:00,110,119,14,19,546,392,154,5
9533,2023-02-02 05:00:00,106,172,5,13,522,462,60,13
9534,2023-02-02 06:00:00,54,100,8,17,664,528,136,13
9535,2023-02-02 07:00:00,67,279,10,16,727,563,164,13
9536,2023-02-02 08:00:00,125,232,9,15,534,449,85,13
9537,2023-02-02 09:00:00,79,268,8,18,617,459,158,9
9538,2023-02-02 10:00:00,77,124,13,12,663,492,171,11
9539,2023-02-02 11:00:00,85,130,13,12,761,628,133,12
9540,2023-02-02 12:00:00,112,113,10,11,579,498,81,11
9541,2023-02-02 13:00:00,135,120,11,15,630,494,136,10
9542,2023-02-02 14:00:00,82,108,5,17,548,414,134,13
9543,2023-02-02 15:00:00,70,254,7,18,631,541,90,11
9544,2023-02-02 16:00:00,66,266,12,19,728,617,111,9
9545,2023-02-02 17:00:00,115,139,11,16,741,649,92,12
9546,2023-02-02 18:00:00,56,192,13,18,795,708,87,9
9547,2023-02-02 19:00:00,55,145,9,11,516,411,105,6
9548,2023-02-02 20:00:00,59,124,11,19,619,435,184,7
9549,2023-02-02 21:00:00,128,193,6,14,784,606,178,9
9550,2023-02-02 22:00:00,74,242,10,18,663,521,142,10
9551,2023-02-02 23:00:00,128,271,10,12,664,504,160,14
9552,2023-02-03 00:00:00,117,220,14,15,634,502,132,14
9553,2023-02-03 01:00:00,148,259,6,15,601,483,118,8
9554,2023-02-03 02:00:00,135,132,6,18,627,499,128,11
9555,2023-02-03 03:00:00,99,256,12,11,618,525,93,14
9556,2023-02-03 04:00:00,120,292,6,18,746,580,166,13
9557,2023-02-03 05:00:00,79,161,14,14,532,430,102,8
9558,2023-02-03 06:00:00,113,283,12,12,754,631,123,13
9559,2023-02-03 07:00:00,129,236,7,13,548,467,81,5
9560,2023-02-03 08:00:00,145,234,6,14,513,416,97,5
9561,2023-02-03 09:00:00,130,128,14,13,672,527,145,11
9562,2023-02-03 10:00:00,90,236,9,10,722,616,106,7
9563,2023-02-03 11:00:00,105,296,9,15,534,384,150,14
9564,2023-02-03 12:00:00,58,163,11,19,539,481,58,6
9565,2023-02-03 13:00:00,132,233,9,19,500,426,74,9
9566,2023-02-03 14:00:00,102,144,13,13,636,466,170,13
9567,2023-02-03 15:00:00,55,293,14,16,644,467,177,12
9568,2023-02-03 16:00:00,58,258,13,18,596,475,121,13
9569,2023-02-03 17:00:00,86,126,5,17,625,456,169,7
9570,2023-02-03 18:00:00,63,165,12,18,581,437,144,7
9571,2023-02-03 19:00:00,108,146,8,12,642,461,181,11
9572,2023-02-03 20:00:00,104,124,9,11,747,559,188,9
9573,2023-02-03 21:00:00,56,131,11,16,706,595,111,5
9574,2023-02-03 22:00:00,102,100,6,13,593,513,80,7
9575,2023-02-03 23:00:00,139,182,11,12,622,458,164,12
9576,2023-02-04 00:00:00,131,133,11,10,521,375,146,14
9577,2023-02-04 01:00:00,123,188,12,17,709,508,201,6
9578,2023-02-04 02:00:00,64,128,10,19,781,614,167,14
9579,2023-02-04 03:00:00,89,187,9,11,790,609,181,9
9580,2023-02-04 04:00:00,64,297,7,17,781,580,201,14
9581,2023-02-04 05:00:00,132,205,13,13,627,493,134,8
9582,2023-02-04 06:00:00,76,215,5,15,617,515,102,12
9583,2023-02-04 07:00:00,88,108,8,19,668,546,122,5
9584,2023-02-04 08:00:00,76,103,12,10,517,436,81,13
9585,2023-02-04 09:00:00,148,123,5,15,685,494,191,11
9586,2023-02-04 10:00:00,149,101,12,17,630,491,139,13
9587,2023-02-04 11:00:00,142,128,11,12,617,453,164,8
9588,2023-02-04 12:00:00,55,154,12,18,686,584,102,10
9589,2023-02-04 13:00:00,114,129,13,17,791,665,126,8
9590,2023-02-04 14:00:00,110,125,12,10,576,481,95,11
9591,2023-02-04 15:00:00,93,129,13,13,555,404,151,7
9592,2023-02-04 16:00:00,107,286,6,19,685,590,95,12
9593,2023-02-04 17:00:00,83,264,9,17,633,524,109,5
9594,2023-02-04 18:00:00,130,192,9,12,638,551,87,7
9595,2023-02-04 19:00:00,114,155,12,15,554,414,140,13
9596,2023-02-04 20:00:00,63,243,12,16,641,543,98,7
9597,2023-02-04 21:00:00,98,237,5,15,706,577,129,9
9598,2023-02-04 22:00:00,85,214,9,14,659,584,75,14
9599,2023-02-04 23:00:00,141,144,14,19,759,682,77,6
9600,2023-02-05 00:00:00,124,175,14,12,698,616,82,5
9601,2023-02-05 01:00:00,52,247,10,10,522,383,139,10
9602,2023-02-05 02:00:00,147,132,11,17,635,447,188,12
9603,2023-02-05 03:00:00,65,204,6,11,770,690,80,7
9604,2023-02-05 04:00:00,114,187,12,16,698,603,95,14
9605,2023-02-05 05:00:00,79,220,6,14,777,668,109,6
9606,2023-02-05 06:00:00,53,237,6,16,657,546,111,13
9607,2023-02-05 07:00:00,137,151,7,13,696,617,79,7
9608,2023-02-05 08:00:00,61,231,9,13,797,568,229,9
9609,2023-02-05 09:00:00,71,212,8,11,631,529,102,10
9610,2023-02-05 10:00:00,78,285,10,10,548,489,59,9
9611,2023-02-05 11:00:00,106,117,5,11,581,432,149,9
9612,2023-02-05 12:00:00,71,178,9,10,542,474,68,6
9613,2023-02-05 13:00:00,60,248,12,16,745,635,110,14
9614,2023-02-05 14:00:00,86,233,10,16,634,509,125,11
9615,2023-02-05 15:00:00,69,233,9,15,598,484,114,11
9616,2023-02-05 16:00:00,68,222,13,13,549,455,94,8
9617,2023-02-05 17:00:00,111,156,11,11,727,637,90,7
9618,2023-02-05 18:00:00,78,234,8,19,754,650,104,6
9619,2023-02-05 19:00:00,134,231,10,11,563,437,126,9
9620,2023-02-05 20:00:00,147,277,11,17,683,612,71,14
9621,2023-02-05 21:00:00,132,286,9,11,568,439,129,10
9622,2023-02-05 22:00:00,116,163,6,14,673,593,80,11
9623,2023-02-05 23:00:00,70,246,11,13,608,509,99,11
9624,2023-02-06 00:00:00,133,114,11,16,589,499,90,13
9625,2023-02-06 01:00:00,106,205,11,11,654,541,113,9
9626,2023-02-06 02:00:00,130,242,11,19,690,587,103,14
9627,2023-02-06 03:00:00,135,163,13,18,634,545,89,10
9628,2023-02-06 04:00:00,142,231,6,13,628,475,153,13
9629,2023-02-06 05:00:00,78,104,14,10,675,531,144,5
9630,2023-02-06 06:00:00,127,284,5,17,768,658,110,8
9631,2023-02-06 07:00:00,98,215,12,19,757,591,166,13
9632,2023-02-06 08:00:00,114,285,11,15,580,508,72,5
9633,2023-02-06 09:00:00,112,273,8,17,792,554,238,5
9634,2023-02-06 10:00:00,51,190,5,13,670,510,160,6
9635,2023-02-06 11:00:00,59,130,9,14,661,470,191,13
9636,2023-02-06 12:00:00,94,257,7,17,758,631,127,5
9637,2023-02-06 13:00:00,112,190,10,12,769,671,98,9
9638,2023-02-06 14:00:00,64,101,6,19,592,529,63,11
9639,2023-02-06 15:00:00,142,232,13,14,504,427,77,6
9640,2023-02-06 16:00:00,121,138,12,14,556,495,61,11
9641,2023-02-06 17:00:00,70,148,10,16,528,389,139,6
9642,2023-02-06 18:00:00,117,130,10,15,762,596,166,9
9643,2023-02-06 19:00:00,79,272,13,18,773,573,200,8
9644,2023-02-06 20:00:00,142,150,6,11,674,559,115,13
9645,2023-02-06 21:00:00,118,129,11,15,706,548,158,6
9646,2023-02-06 22:00:00,126,120,5,11,513,429,84,10
9647,2023-02-06 23:00:00,82,205,12,13,738,564,174,7
9648,2023-02-07 00:00:00,89,250,5,16,706,581,125,14
9649,2023-02-07 01:00:00,98,148,14,11,703,626,77,14
9650,2023-02-07 02:00:00,81,145,6,10,697,622,75,6
9651,2023-02-07 03:00:00,54,289,7,18,669,569,100,9
9652,2023-02-07 04:00:00,74,228,13,14,578,502,76,13
9653,2023-02-07 05:00:00,116,268,6,18,747,585,162,8
9654,2023-02-07 06:00:00,81,158,8,10,535,479,56,9
9655,2023-02-07 07:00:00,111,278,14,10,714,585,129,13
9656,2023-02-07 08:00:00,140,173,10,11,676,592,84,13
9657,2023-02-07 09:00:00,111,142,12,10,727,527,200,6
9658,2023-02-07 10:00:00,127,215,5,19,720,563,157,9
9659,2023-02-07 11:00:00,58,175,5,13,615,545,70,10
9660,2023-02-07 12:00:00,86,124,13,12,682,505,177,14
9661,2023-02-07 13:00:00,53,254,8,17,500,425,75,12
9662,2023-02-07 14:00:00,149,282,7,18,600,506,94,9
9663,2023-02-07 15:00:00,127,225,14,19,621,507,114,9
9664,2023-02-07 16:00:00,145,135,14,19,639,523,116,6
9665,2023-02-07 17:00:00,120,245,12,19,703,571,132,8
9666,2023-02-07 18:00:00,127,270,12,10,720,535,185,7
9667,2023-02-07 19:00:00,149,280,9,13,544,450,94,6
9668,2023-02-07 20:00:00,114,277,12,13,546,465,81,11
9669,2023-02-07 21:00:00,149,180,7,11,502,365,137,11
9670,2023-02-07 22:00:00,66,229,13,11,607,526,81,10
9671,2023-02-07 23:00:00,147,184,10,13,727,530,197,7
9672,2023-02-08 00:00:00,113,169,13,13,527,373,154,11
9673,2023-02-08 01:00:00,107,189,7,15,760,643,117,5
9674,2023-02-08 02:00:00,102,108,11,13,676,570,106,6
9675,2023-02-08 03:00:00,58,195,6,16,687,499,188,10
9676,2023-02-08 04:00:00,76,216,13,19,705,518,187,6
9677,2023-02-08 05:00:00,98,215,7,19,679,610,69,10
9678,2023-02-08 06:00:00,146,191,7,15,700,622,78,14
9679,2023-02-08 07:00:00,72,124,11,14,626,479,147,11
9680,2023-02-08 08:00:00,60,115,10,14,558,428,130,13
9681,2023-02-08 09:00:00,111,144,13,10,543,386,157,10
9682,2023-02-08 10:00:00,144,249,7,17,798,610,188,9
9683,2023-02-08 11:00:00,136,209,7,11,667,569,98,8
9684,2023-02-08 12:00:00,62,279,10,15,591,447,144,7
9685,2023-02-08 13:00:00,78,289,6,17,675,604,71,6
9686,2023-02-08 14:00:00,97,215,7,13,584,495,89,9
9687,2023-02-08 15:00:00,132,286,9,17,512,435,77,7
9688,2023-02-08 16:00:00,71,205,13,18,792,614,178,11
9689,2023-02-08 17:00:00,98,254,10,17,756,610,146,7
9690,2023-02-08 18:00:00,135,181,14,18,608,485,123,12
9691,2023-02-08 19:00:00,146,280,13,17,559,477,82,10
9692,2023-02-08 20:00:00,100,216,12,17,706,557,149,7
9693,2023-02-08 21:00:00,135,265,12,12,550,440,110,8
9694,2023-02-08 22:00:00,142,292,7,16,526,443,83,12
9695,2023-02-08 23:00:00,62,114,9,12,523,447,76,9
9696,2023-02-09 00:00:00,104,203,11,13,782,649,133,7
9697,2023-02-09 01:00:00,126,228,10,18,566,499,67,14
9698,2023-02-09 02:00:00,58,170,12,18,576,509,67,10
9699,2023-02-09 03:00:00,52,143,11,12,708,621,87,13
9700,2023-02-09 04:00:00,60,103,6,17,549,454,95,9
9701,2023-02-09 05:00:00,108,236,9,17,755,591,164,5
9702,2023-02-09 06:00:00,121,100,11,18,610,487,123,11
9703,2023-02-09 07:00:00,129,200,9,12,622,444,178,11
9704,2023-02-09 08:00:00,80,242,14,17,693,622,71,7
9705,2023-02-09 09:00:00,120,122,5,16,502,382,120,11
9706,2023-02-09 10:00:00,57,126,7,18,568,444,124,7
9707,2023-02-09 11:00:00,73,173,14,16,673,546,127,12
9708,2023-02-09 12:00:00,146,117,7,19,668,537,131,5
9709,2023-02-09 13:00:00,92,154,8,11,541,462,79,8
9710,2023-02-09 14:00:00,89,297,12,15,701,539,162,7
9711,2023-02-09 15:00:00,78,210,11,12,602,441,161,9
9712,2023-02-09 16:00:00,109,178,5,16,633,549,84,9
9713,2023-02-09 17:00:00,72,290,9,11,676,497,179,14
9714,2023-02-09 18:00:00,85,295,7,16,605,505,100,12
9715,2023-02-09 19:00:00,52,136,5,13,771,618,153,14
9716,2023-02-09 20:00:00,126,195,13,17,502,363,139,12
9717,2023-02-09 21:00:00,86,185,11,19,547,429,118,11
9718,2023-02-09 22:00:00,86,127,12,18,541,388,153,9
9719,2023-02-09 23:00:00,120,188,7,18,721,638,83,12
9720,2023-02-10 00:00:00,78,191,6,12,501,385,116,13
9721,2023-02-10 01:00:00,68,204,5,13,707,627,80,12
9722,2023-02-10 02:00:00,91,236,8,19,745,670,75,12
9723,2023-02-10 03:00:00,119,143,6,15,769,595,174,5
9724,2023-02-10 04:00:00,118,132,10,16,734,638,96,9
9725,2023-02-10 05:00:00,141,264,8,15,711,515,196,13
9726,2023-02-10 06:00:00,147,199,13,13,793,640,153,8
9727,2023-02-10 07:00:00,99,193,6,18,667,530,137,9
9728,2023-02-10 08:00:00,127,206,5,10,631,522,109,12
9729,2023-02-10 09:00:00,127,237,6,10,746,625,121,7
9730,2023-02-10 10:00:00,131,232,14,19,531,399,132,11
9731,2023-02-10 11:00:00,134,251,7,13,623,465,158,12
9732,2023-02-10 12:00:00,78,165,14,15,781,660,121,13
9733,2023-02-10 13:00:00,110,220,14,13,546,424,122,5
9734,2023-02-10 14:00:00,110,160,6,16,782,548,234,11
9735,2023-02-10 15:00:00,123,111,11,19,528,430,98,7
9736,2023-02-10 16:00:00,136,172,12,17,628,561,67,9
9737,2023-02-10 17:00:00,95,140,11,18,778,689,89,5
9738,2023-02-10 18:00:00,143,246,11,18,547,451,96,6
9739,2023-02-10 19:00:00,51,131,10,13,624,501,123,7
9740,2023-02-10 20:00:00,91,139,9,10,733,559,174,12
9741,2023-02-10 21:00:00,85,187,5,18,532,465,67,9
9742,2023-02-10 22:00:00,120,287,5,10,570,452,118,8
9743,2023-02-10 23:00:00,111,225,12,13,641,467,174,13
9744,2023-02-11 00:00:00,111,279,7,19,629,500,129,5
9745,2023-02-11 01:00:00,82,166,6,15,569,421,148,9
9746,2023-02-11 02:00:00,115,198,14,10,511,372,139,12
9747,2023-02-11 03:00:00,103,221,6,13,505,373,132,13
9748,2023-02-11 04:00:00,79,130,5,11,513,418,95,10
9749,2023-02-11 05:00:00,65,272,11,19,612,444,168,12
9750,2023-02-11 06:00:00,82,210,10,14,510,453,57,10
9751,2023-02-11 07:00:00,108,232,7,18,643,476,167,10
9752,2023-02-11 08:00:00,59,203,5,12,550,431,119,8
9753,2023-02-11 09:00:00,146,265,7,16,697,605,92,12
9754,2023-02-11 10:00:00,78,288,8,13,680,576,104,9
9755,2023-02-11 11:00:00,76,290,12,10,784,626,158,14
9756,2023-02-11 12:00:00,90,277,14,13,726,622,104,10
9757,2023-02-11 13:00:00,108,106,5,11,547,477,70,14
9758,2023-02-11 14:00:00,95,104,14,17,549,391,158,11
9759,2023-02-11 15:00:00,67,251,7,14,786,636,150,12
9760,2023-02-11 16:00:00,89,214,10,18,727,597,130,5
9761,2023-02-11 17:00:00,77,155,8,18,599,533,66,5
9762,2023-02-11 18:00:00,62,134,9,13,628,546,82,13
9763,2023-02-11 19:00:00,116,275,7,10,628,537,91,9
9764,2023-02-11 20:00:00,87,139,6,16,542,438,104,6
9765,2023-02-11 21:00:00,127,143,5,16,796,699,97,10
9766,2023-02-11 22:00:00,55,274,7,19,584,430,154,9
9767,2023-02-11 23:00:00,144,180,10,16,576,507,69,13
9768,2023-02-12 00:00:00,112,174,11,15,602,514,88,9
9769,2023-02-12 01:00:00,139,194,5,16,575,467,108,7
9770,2023-02-12 02:00:00,147,182,13,18,720,505,215,12
9771,2023-02-12 03:00:00,56,176,8,11,597,522,75,10
9772,2023-02-12 04:00:00,91,296,14,18,709,592,117,13
9773,2023-02-12 05:00:00,138,299,11,12,601,539,62,10
9774,2023-02-12 06:00:00,141,210,12,18,672,583,89,10
9775,2023-02-12 07:00:00,136,290,6,10,782,692,90,11
9776,2023-02-12 08:00:00,135,235,11,14,551,461,90,10
9777,2023-02-12 09:00:00,71,189,14,19,543,464,79,10
9778,2023-02-12 10:00:00,137,146,11,10,732,516,216,7
9779,2023-02-12 11:00:00,101,215,6,15,618,485,133,9
9780,2023-02-12 12:00:00,72,152,12,10,769,669,100,6
9781,2023-02-12 13:00:00,90,186,7,10,601,444,157,7
9782,2023-02-12 14:00:00,140,127,11,17,789,634,155,13
9783,2023-02-12 15:00:00,95,172,5,12,572,479,93,14
9784,2023-02-12 16:00:00,139,101,8,10,647,487,160,12
9785,2023-02-12 17:00:00,61,201,5,18,587,477,110,8
9786,2023-02-12 18:00:00,96,257,10,17,635,569,66,13
9787,2023-02-12 19:00:00,110,133,7,13,689,582,107,12
9788,2023-02-12 20:00:00,106,235,11,13,752,675,77,14
9789,2023-02-12 21:00:00,135,104,9,15,530,438,92,14
9790,2023-02-12 22:00:00,74,231,10,18,518,365,153,13
9791,2023-02-12 23:00:00,109,261,9,13,772,686,86,11
9792,2023-02-13 00:00:00,50,178,7,16,762,605,157,13
9793,2023-02-13 01:00:00,73,236,5,18,576,415,161,7
9794,2023-02-13 02:00:00,63,125,5,17,609,501,108,5
9795,2023-02-13 03:00:00,103,136,11,17,708,507,201,10
9796,2023-02-13 04:00:00,85,102,13,15,664,550,114,13
9797,2023-02-13 05:00:00,146,127,8,14,707,505,202,14
9798,2023-02-13 06:00:00,57,286,9,15,701,492,209,5
9799,2023-02-13 07:00:00,82,235,10,19,544,402,142,5
9800,2023-02-13 08:00:00,52,137,14,12,539,419,120,14
9801,2023-02-13 09:00:00,93,284,12,15,672,580,92,10
9802,2023-02-13 10:00:00,74,257,9,14,601,435,166,13
9803,2023-02-13 11:00:00,101,149,14,18,765,554,211,12
9804,2023-02-13 12:00:00,145,155,7,16,512,432,80,14
9805,2023-02-13 13:00:00,66,156,13,13,507,390,117,10
9806,2023-02-13 14:00:00,129,113,7,17,797,598,199,5
9807,2023-02-13 15:00:00,72,217,8,16,542,432,110,12
9808,2023-02-13 16:00:00,129,256,6,11,637,460,177,8
9809,2023-02-13 17:00:00,107,106,11,13,548,402,146,9
9810,2023-02-13 18:00:00,147,194,13,14,663,489,174,11
9811,2023-02-13 19:00:00,132,155,11,10,632,444,188,7
9812,2023-02-13 20:00:00,104,102,13,13,647,483,164,11
9813,2023-02-13 21:00:00,90,271,6,11,640,494,146,6
9814,2023-02-13 22:00:00,85,134,7,18,797,583,214,12
9815,2023-02-13 23:00:00,119,126,6,18,795,587,208,14
9816,2023-02-14 00:00:00,86,199,11,16,750,649,101,11
9817,2023-02-14 01:00:00,94,271,11,17,617,460,157,5
9818,2023-02-14 02:00:00,75,109,7,12,686,512,174,9
9819,2023-02-14 03:00:00,145,216,7,13,599,475,124,6
9820,2023-02-14 04:00:00,57,110,7,15,666,521,145,8
9821,2023-02-14 05:00:00,111,264,9,14,626,442,184,14
9822,2023-02-14 06:00:00,136,133,6,12,621,501,120,8
9823,2023-02-14 07:00:00,55,126,6,15,664,556,108,6
9824,2023-02-14 08:00:00,69,114,13,13,564,455,109,8
9825,2023-02-14 09:00:00,60,212,9,19,639,515,124,8
9826,2023-02-14 10:00:00,82,243,14,10,700,593,107,13
9827,2023-02-14 11:00:00,69,106,5,18,555,421,134,9
9828,2023-02-14 12:00:00,122,235,8,15,618,443,175,10
9829,2023-02-14 13:00:00,77,262,6,19,726,648,78,8
9830,2023-02-14 14:00:00,80,231,5,19,627,490,137,9
9831,2023-02-14 15:00:00,54,101,11,18,537,383,154,13
9832,2023-02-14 16:00:00,146,294,9,11,611,530,81,13
9833,2023-02-14 17:00:00,137,288,5,15,782,660,122,8
9834,2023-02-14 18:00:00,131,230,6,19,524,404,120,13
9835,2023-02-14 19:00:00,53,157,9,19,634,534,100,10
9836,2023-02-14 20:00:00,93,170,8,13,793,672,121,9
9837,2023-02-14 21:00:00,80,194,10,12,688,502,186,5
9838,2023-02-14 22:00:00,71,247,5,13,774,606,168,11
9839,2023-02-14 23:00:00,73,269,12,10,674,549,125,14
9840,2023-02-15 00:00:00,54,224,10,14,653,530,123,10
9841,2023-02-15 01:00:00,101,103,11,13,742,596,146,9
9842,2023-02-15 02:00:00,107,256,12,13,509,425,84,10
9843,2023-02-15 03:00:00,54,192,7,16,547,403,144,6
9844,2023-02-15 04:00:00,67,219,12,16,580,498,82,14
9845,2023-02-15 05:00:00,115,121,9,16,622,458,164,13
9846,2023-02-15 06:00:00,137,105,5,14,625,535,90,11
9847,2023-02-15 07:00:00,84,173,6,13,578,420,158,6
9848,2023-02-15 08:00:00,116,209,5,15,765,687,78,13
9849,2023-02-15 09:00:00,94,254,11,19,520,369,151,14
9850,2023-02-15 10:00:00,78,126,13,18,711,562,149,10
9851,2023-02-15 11:00:00,146,116,6,14,585,474,111,7
9852,2023-02-15 12:00:00,82,115,10,18,584,432,152,10
9853,2023-02-15 13:00:00,67,194,8,17,509,425,84,5
9854,2023-02-15 14:00:00,100,206,10,19,642,528,114,5
9855,2023-02-15 15:00:00,63,101,9,13,794,666,128,6
9856,2023-02-15 16:00:00,84,153,5,17,796,588,208,7
9857,2023-02-15 17:00:00,62,128,13,16,659,566,93,13
9858,2023-02-15 18:00:00,70,232,8,13,522,397,125,6
9859,2023-02-15 19:00:00,97,131,5,16,779,697,82,5
9860,2023-02-15 20:00:00,79,224,8,15,779,700,79,10
9861,2023-02-15 21:00:00,50,239,7,11,774,590,184,9
9862,2023-02-15 22:00:00,126,254,10,12,520,436,84,11
9863,2023-02-15 23:00:00,141,282,13,16,508,367,141,6
9864,2023-02-16 00:00:00,131,150,6,14,748,547,201,12
9865,2023-02-16 01:00:00,131,214,10,19,543,460,83,12
9866,2023-02-16 02:00:00,122,114,6,19,572,503,69,13
9867,2023-02-16 03:00:00,94,188,7,17,705,583,122,7
9868,2023-02-16 04:00:00,127,274,12,14,663,556,107,14
9869,2023-02-16 05:00:00,82,196,10,14,581,470,111,6
9870,2023-02-16 06:00:00,130,267,12,12,602,526,76,11
9871,2023-02-16 07:00:00,67,220,12,14,694,603,91,9
9872,2023-02-16 08:00:00,131,275,13,16,729,622,107,6
9873,2023-02-16 09:00:00,64,285,6,10,783,662,121,7
9874,2023-02-16 10:00:00,106,158,9,15,529,390,139,9
9875,2023-02-16 11:00:00,125,283,14,17,718,617,101,5
9876,2023-02-16 12:00:00,58,150,14,14,661,547,114,11
9877,2023-02-16 13:00:00,116,260,6,11,640,476,164,9
9878,2023-02-16 14:00:00,106,224,11,19,565,438,127,10
9879,2023-02-16 15:00:00,76,247,7,12,693,512,181,6
9880,2023-02-16 16:00:00,94,136,6,19,604,519,85,10
9881,2023-02-16 17:00:00,122,273,6,13,677,535,142,14
9882,2023-02-16 18:00:00,96,281,12,17,756,654,102,13
9883,2023-02-16 19:00:00,145,247,9,14,605,469,136,10
9884,2023-02-16 20:00:00,104,179,9,16,595,468,127,8
9885,2023-02-16 21:00:00,147,210,10,18,674,545,129,6
9886,2023-02-16 22:00:00,71,266,8,16,632,555,77,13
9887,2023-02-16 23:00:00,103,218,14,10,644,483,161,7
9888,2023-02-17 00:00:00,122,148,11,15,684,608,76,5
9889,2023-02-17 01:00:00,117,250,13,12,683,532,151,5
9890,2023-02-17 02:00:00,134,217,7,17,505,424,81,11
9891,2023-02-17 03:00:00,129,225,14,10,526,392,134,8
9892,2023-02-17 04:00:00,88,293,8,15,747,532,215,14
9893,2023-02-17 05:00:00,149,159,5,13,785,675,110,14
9894,2023-02-17 06:00:00,113,152,12,13,551,489,62,6
9895,2023-02-17 07:00:00,148,261,10,15,783,603,180,6
9896,2023-02-17 08:00:00,144,132,6,16,563,489,74,10
9897,2023-02-17 09:00:00,85,241,10,14,664,466,198,14
9898,2023-02-17 10:00:00,83,220,11,17,713,640,73,8
9899,2023-02-17 11:00:00,103,276,6,12,772,650,122,6
9900,2023-02-17 12:00:00,53,220,11,12,749,662,87,13
9901,2023-02-17 13:00:00,74,241,7,17,511,438,73,9
9902,2023-02-17 14:00:00,98,226,8,12,730,528,202,7
9903,2023-02-17 15:00:00,104,240,7,17,616,435,181,7
9904,2023-02-17 16:00:00,83,219,6,16,652,543,109,10
9905,2023-02-17 17:00:00,107,260,8,13,657,525,132,9
9906,2023-02-17 18:00:00,132,102,9,19,505,403,102,10
9907,2023-02-17 19:00:00,120,146,10,16,602,515,87,11
9908,2023-02-17 20:00:00,62,103,8,16,512,363,149,10
9909,2023-02-17 21:00:00,139,296,12,16,724,590,134,13
9910,2023-02-17 22:00:00,116,176,14,15,698,530,168,5
9911,2023-02-17 23:00:00,88,176,13,17,617,447,170,10
9912,2023-02-18 00:00:00,61,263,7,19,725,582,143,8
9913,2023-02-18 01:00:00,133,137,7,15,538,408,130,9
9914,2023-02-18 02:00:00,56,246,12,14,529,448,81,9
9915,2023-02-18 03:00:00,130,288,5,13,616,488,128,13
9916,2023-02-18 04:00:00,142,200,8,13,646,543,103,8
9917,2023-02-18 05:00:00,70,116,9,12,527,405,122,13
9918,2023-02-18 06:00:00,93,294,11,13,721,589,132,14
9919,2023-02-18 07:00:00,62,253,8,13,535,386,149,13
9920,2023-02-18 08:00:00,64,209,9,19,604,484,120,7
9921,2023-02-18 09:00:00,82,164,9,17,548,486,62,14
9922,2023-02-18 10:00:00,111,229,10,17,640,540,100,5
9923,2023-02-18 11:00:00,89,164,12,14,612,522,90,13
9924,2023-02-18 12:00:00,97,298,7,17,515,399,116,13
9925,2023-02-18 13:00:00,115,269,7,14,551,386,165,12
9926,2023-02-18 14:00:00,101,246,12,10,591,486,105,10
9927,2023-02-18 15:00:00,128,153,7,13,750,530,220,9
9928,2023-02-18 16:00:00,91,114,6,17,553,460,93,11
9929,2023-02-18 17:00:00,81,224,8,12,557,440,117,13
9930,2023-02-18 18:00:00,142,159,11,10,508,416,92,10
9931,2023-02-18 19:00:00,143,193,6,18,638,514,124,13
9932,2023-02-18 20:00:00,138,134,12,11,547,438,109,9
9933,2023-02-18 21:00:00,100,215,7,15,666,521,145,13
9934,2023-02-18 22:00:00,74,262,11,17,610,508,102,8
9935,2023-02-18 23:00:00,54,248,12,10,636,568,68,11
9936,2023-02-19 00:00:00,128,183,14,17,632,520,112,7
9937,2023-02-19 01:00:00,71,248,5,19,782,625,157,14
9938,2023-02-19 02:00:00,59,269,10,15,507,378,129,13
9939,2023-02-19 03:00:00,97,146,7,17,613,465,148,14
9940,2023-02-19 04:00:00,73,216,7,17,633,557,76,11
9941,2023-02-19 05:00:00,92,298,12,18,535,444,91,14
9942,2023-02-19 06:00:00,139,186,7,16,763,674,89,10
9943,2023-02-19 07:00:00,93,281,11,16,610,516,94,10
9944,2023-02-19 08:00:00,68,154,10,14,754,651,103,13
9945,2023-02-19 09:00:00,58,129,14,19,544,463,81,11
9946,2023-02-19 10:00:00,110,218,10,13,685,542,143,7
9947,2023-02-19 11:00:00,142,185,8,10,616,495,121,14
9948,2023-02-19 12:00:00,56,178,7,16,691,603,88,13
9949,2023-02-19 13:00:00,73,221,13,18,565,497,68,14
9950,2023-02-19 14:00:00,100,217,9,14,714,548,166,14
9951,2023-02-19 15:00:00,118,239,11,17,783,570,213,13
9952,2023-02-19 16:00:00,124,216,7,16,541,380,161,11
9953,2023-02-19 17:00:00,98,199,10,18,602,540,62,12
9954,2023-02-19 18:00:00,72,121,12,11,711,505,206,12
9955,2023-02-19 19:00:00,117,185,10,18,798,650,148,13
9956,2023-02-19 20:00:00,70,200,8,13,696,602,94,13
9957,2023-02-19 21:00:00,138,181,5,18,528,468,60,11
9958,2023-02-19 22:00:00,79,196,8,18,698,539,159,7
9959,2023-02-19 23:00:00,144,115,10,10,566,436,130,9
9960,2023-02-20 00:00:00,112,173,5,19,582,463,119,12
9961,2023-02-20 01:00:00,58,134,10,10,662,577,85,9
9962,2023-02-20 02:00:00,117,123,9,10,644,554,90,6
9963,2023-02-20 03:00:00,52,220,9,11,572,446,126,8
9964,2023-02-20 04:00:00,100,256,5,18,677,555,122,13
9965,2023-02-20 05:00:00,69,236,11,19,766,570,196,8
9966,2023-02-20 06:00:00,55,136,12,10,628,557,71,13
9967,2023-02-20 07:00:00,95,207,7,17,621,491,130,14
9968,2023-02-20 08:00:00,129,116,12,10,519,455,64,10
9969,2023-02-20 09:00:00,62,250,12,10,789,692,97,8
9970,2023-02-20 10:00:00,52,193,7,12,644,454,190,5
9971,2023-02-20 11:00:00,143,132,13,12,624,515,109,13
9972,2023-02-20 12:00:00,70,214,6,12,562,424,138,11
9973,2023-02-20 13:00:00,88,264,9,10,523,386,137,9
9974,2023-02-20 14:00:00,72,141,7,16,526,421,105,14
9975,2023-02-20 15:00:00,72,125,14,16,574,493,81,10
9976,2023-02-20 16:00:00,99,275,7,16,769,604,165,8
9977,2023-02-20 17:00:00,97,190,10,10,568,416,152,8
9978,2023-02-20 18:00:00,66,262,5,15,525,427,98,13
9979,2023-02-20 19:00:00,128,239,14,13,799,594,205,6
9980,2023-02-20 20:00:00,94,202,14,13,594,534,60,8
9981,2023-02-20 21:00:00,120,145,13,10,686,613,73,7
9982,2023-02-20 22:00:00,96,244,14,11,725,543,182,10
9983,2023-02-20 23:00:00,142,269,6,13,781,698,83,5
9984,2023-02-21 00:00:00,98,114,14,11,745,581,164,12
9985,2023-02-21 01:00:00,100,195,11,15,599,437,162,14
9986,2023-02-21 02:00:00,103,195,7,13,662,542,120,8
9987,2023-02-21 03:00:00,85,232,5,12,545,434,111,9
9988,2023-02-21 04:00:00,114,147,10,18,732,527,205,8
9989,2023-02-21 05:00:00,73,134,7,17,795,709,86,5
9990,2023-02-21 06:00:00,67,281,11,18,657,562,95,6
9991,2023-02-21 07:00:00,104,207,11,11,653,548,105,7
9992,2023-02-21 08:00:00,65,119,9,14,620,538,82,7
9993,2023-02-21 09:00:00,91,167,6,15,566,507,59,9
9994,2023-02-21 10:00:00,124,151,11,12,579,433,146,6
9995,2023-02-21 11:00:00,61,225,6,17,722,596,126,7
9996,2023-02-21 12:00:00,68,134,12,11,660,484,176,12
9997,2023-02-21 13:00:00,83,169,9,14,611,547,64,14
9998,2023-02-21 14:00:00,125,149,6,10,769,665,104,13
9999,2023-02-21 15:00:00,85,207,14,12,784,601,183,11
10000,2023-02-21 16:00:00,66,197,5,14,696,605,91,13
10001,2023-02-21 17:00:00,112,199,6,10,667,567,100,11
10002,2023-02-21 18:00:00,97,217,9,18,520,418,102,6
10003,2023-02-21 19:00:00,126,263,8,12,775,693,82,6
10004,2023-02-21 20:00:00,129,292,8,11,604,512,92,11
10005,2023-02-21 21:00:00,146,263,8,19,577,513,64,13
10006,2023-02-21 22:00:00,53,116,7,13,598,513,85,11
10007,2023-02-21 23:00:00,50,291,12,16,541,437,104,5
10008,2023-02-22 00:00:00,144,149,11,10,578,452,126,13
10009,2023-02-22 01:00:00,109,223,11,17,500,381,119,12
10010,2023-02-22 02:00:00,62,166,10,16,560,441,119,10
10011,2023-02-22 03:00:00,115,170,7,10,744,529,215,5
10012,2023-02-22 04:00:00,100,292,14,10,769,662,107,10
10013,2023-02-22 05:00:00,57,295,7,19,572,488,84,10
10014,2023-02-22 06:00:00,90,227,6,10,690,513,177,9
10015,2023-02-22 07:00:00,61,151,7,16,557,485,72,10
10016,2023-02-22 08:00:00,141,148,9,14,777,599,178,13
10017,2023-02-22 09:00:00,56,141,9,18,592,445,147,11
10018,2023-02-22 10:00:00,58,145,7,17,793,573,220,9
10019,2023-02-22 11:00:00,88,240,13,19,571,423,148,5
10020,2023-02-22 12:00:00,122,163,9,18,632,550,82,10
10021,2023-02-22 13:00:00,112,142,8,12,633,479,154,14
10022,2023-02-22 14:00:00,90,192,14,14,690,548,142,7
10023,2023-02-22 15:00:00,52,280,14,11,588,488,100,9
10024,2023-02-22 16:00:00,62,116,9,11,539,410,129,7
10025,2023-02-22 17:00:00,69,244,6,10,549,417,132,7
10026,2023-02-22 18:00:00,53,113,10,18,600,522,78,6
10027,2023-02-22 19:00:00,64,198,12,17,538,461,77,14
10028,2023-02-22 20:00:00,124,285,13,15,594,456,138,6
10029,2023-02-22 21:00:00,92,258,9,19,781,610,171,13
10030,2023-02-22 22:00:00,131,206,13,19,711,533,178,12
10031,2023-02-22 23:00:00,85,161,7,13,589,466,123,11
10032,2023-02-23 00:00:00,102,157,10,15,513,439,74,8
10033,2023-02-23 01:00:00,62,178,13,15,579,468,111,6
10034,2023-02-23 02:00:00,106,283,11,10,682,572,110,7
10035,2023-02-23 03:00:00,148,209,9,14,636,469,167,12
10036,2023-02-23 04:00:00,52,236,13,12,635,483,152,13
10037,2023-02-23 05:00:00,142,246,11,19,625,450,175,11
10038,2023-02-23 06:00:00,108,139,9,12,712,577,135,12
10039,2023-02-23 07:00:00,92,145,9,17,572,489,83,11
10040,2023-02-23 08:00:00,107,226,12,14,696,495,201,11
10041,2023-02-23 09:00:00,73,102,7,17,513,377,136,6
10042,2023-02-23 10:00:00,86,182,10,16,500,410,90,9
10043,2023-02-23 11:00:00,134,219,14,11,556,473,83,7
10044,2023-02-23 12:00:00,80,161,9,10,599,531,68,13
10045,2023-02-23 13:00:00,100,268,14,12,731,539,192,11
10046,2023-02-23 14:00:00,97,292,12,18,622,465,157,13
10047,2023-02-23 15:00:00,141,215,11,10,636,548,88,8
10048,2023-02-23 16:00:00,129,129,11,15,780,684,96,12
10049,2023-02-23 17:00:00,89,215,13,19,558,467,91,8
10050,2023-02-23 18:00:00,116,258,7,13,660,540,120,8
10051,2023-02-23 19:00:00,145,298,14,12,597,483,114,7
10052,2023-02-23 20:00:00,112,115,7,11,555,488,67,6
10053,2023-02-23 21:00:00,94,172,6,19,517,419,98,7
10054,2023-02-23 22:00:00,131,210,12,14,747,589,158,6
10055,2023-02-23 23:00:00,100,129,7,18,563,489,74,7
10056,2023-02-24 00:00:00,64,130,14,18,707,613,94,13
10057,2023-02-24 01:00:00,86,283,5,14,759,552,207,14
10058,2023-02-24 02:00:00,112,294,13,13,634,544,90,10
10059,2023-02-24 03:00:00,103,152,14,13,618,486,132,6
10060,2023-02-24 04:00:00,90,164,5,16,770,599,171,9
10061,2023-02-24 05:00:00,108,291,12,10,514,368,146,5
10062,2023-02-24 06:00:00,76,212,9,12,765,618,147,11
10063,2023-02-24 07:00:00,148,143,10,10,657,537,120,10
10064,2023-02-24 08:00:00,142,112,6,15,534,401,133,8
10065,2023-02-24 09:00:00,102,182,9,13,570,444,126,14
10066,2023-02-24 10:00:00,112,244,14,16,741,635,106,6
10067,2023-02-24 11:00:00,136,185,10,13,697,549,148,12
10068,2023-02-24 12:00:00,67,203,7,19,570,473,97,7
10069,2023-02-24 13:00:00,88,179,6,17,545,428,117,7
10070,2023-02-24 14:00:00,120,162,6,18,570,507,63,5
10071,2023-02-24 15:00:00,78,274,13,17,743,546,197,14
10072,2023-02-24 16:00:00,80,129,14,17,774,547,227,14
10073,2023-02-24 17:00:00,133,145,9,16,738,572,166,5
10074,2023-02-24 18:00:00,148,237,13,10,576,490,86,10
10075,2023-02-24 19:00:00,98,189,7,16,735,641,94,14
10076,2023-02-24 20:00:00,135,229,9,14,706,534,172,14
10077,2023-02-24 21:00:00,102,243,9,15,786,577,209,7
10078,2023-02-24 22:00:00,128,258,9,13,608,472,136,7
10079,2023-02-24 23:00:00,86,256,8,10,679,531,148,12
10080,2023-02-25 00:00:00,72,128,12,13,575,428,147,5
10081,2023-02-25 01:00:00,118,205,14,12,518,425,93,9
10082,2023-02-25 02:00:00,70,112,14,15,611,428,183,5
10083,2023-02-25 03:00:00,149,105,12,14,701,566,135,14
10084,2023-02-25 04:00:00,95,279,9,11,619,466,153,9
10085,2023-02-25 05:00:00,117,208,14,18,722,633,89,8
10086,2023-02-25 06:00:00,50,154,9,11,521,427,94,12
10087,2023-02-25 07:00:00,74,234,5,12,508,385,123,10
10088,2023-02-25 08:00:00,139,188,8,15,668,544,124,7
10089,2023-02-25 09:00:00,144,261,14,11,525,383,142,11
10090,2023-02-25 10:00:00,125,113,9,12,752,605,147,8
10091,2023-02-25 11:00:00,65,191,10,13,511,387,124,10
10092,2023-02-25 12:00:00,133,186,6,11,528,470,58,12
10093,2023-02-25 13:00:00,115,189,12,15,614,459,155,14
10094,2023-02-25 14:00:00,88,203,5,11,697,488,209,11
10095,2023-02-25 15:00:00,59,262,11,12,795,679,116,10
10096,2023-02-25 16:00:00,57,144,9,17,796,558,238,9
10097,2023-02-25 17:00:00,100,184,13,16,543,406,137,11
10098,2023-02-25 18:00:00,58,132,13,19,526,435,91,7
10099,2023-02-25 19:00:00,141,185,14,16,557,455,102,11
10100,2023-02-25 20:00:00,64,282,7,15,520,397,123,14
10101,2023-02-25 21:00:00,146,203,11,18,621,558,63,8
10102,2023-02-25 22:00:00,130,257,14,18,685,512,173,12
10103,2023-02-25 23:00:00,55,197,14,14,584,421,163,5
10104,2023-02-26 00:00:00,143,143,11,10,512,451,61,7
10105,2023-02-26 01:00:00,138,141,10,14,786,574,212,5
10106,2023-02-26 02:00:00,111,286,11,18,559,435,124,5
10107,2023-02-26 03:00:00,133,255,11,11,561,495,66,10
10108,2023-02-26 04:00:00,89,198,11,18,522,445,77,7
10109,2023-02-26 05:00:00,136,211,12,18,729,572,157,13
10110,2023-02-26 06:00:00,111,131,13,15,612,526,86,9
10111,2023-02-26 07:00:00,62,181,6,18,787,618,169,14
10112,2023-02-26 08:00:00,149,145,6,15,513,449,64,10
10113,2023-02-26 09:00:00,143,178,11,12,689,571,118,5
10114,2023-02-26 10:00:00,55,278,8,16,728,558,170,6
10115,2023-02-26 11:00:00,104,185,7,11,597,470,127,13
10116,2023-02-26 12:00:00,94,100,9,16,521,440,81,5
10117,2023-02-26 13:00:00,97,280,13,14,599,433,166,13
10118,2023-02-26 14:00:00,100,189,10,14,647,511,136,9
10119,2023-02-26 15:00:00,77,273,9,15,523,388,135,11
10120,2023-02-26 16:00:00,77,197,7,12,670,527,143,11
10121,2023-02-26 17:00:00,127,100,12,19,795,678,117,11
10122,2023-02-26 18:00:00,108,194,9,12,565,441,124,10
10123,2023-02-26 19:00:00,104,156,8,14,698,551,147,8
10124,2023-02-26 20:00:00,75,180,9,11,551,411,140,13
10125,2023-02-26 21:00:00,78,197,7,18,766,583,183,12
10126,2023-02-26 22:00:00,144,201,11,12,755,621,134,14
10127,2023-02-26 23:00:00,63,250,11,13,766,674,92,10
10128,2023-02-27 00:00:00,110,208,8,10,721,562,159,12
10129,2023-02-27 01:00:00,121,279,6,16,586,475,111,13
10130,2023-02-27 02:00:00,107,180,9,15,630,536,94,7
10131,2023-02-27 03:00:00,133,265,14,18,789,611,178,10
10132,2023-02-27 04:00:00,148,134,13,12,506,365,141,11
10133,2023-02-27 05:00:00,127,122,6,17,676,477,199,9
10134,2023-02-27 06:00:00,98,146,6,12,746,553,193,12
10135,2023-02-27 07:00:00,80,181,10,17,670,551,119,9
10136,2023-02-27 08:00:00,66,164,13,16,788,679,109,10
10137,2023-02-27 09:00:00,68,227,5,13,604,491,113,9
10138,2023-02-27 10:00:00,80,126,9,18,625,484,141,5
10139,2023-02-27 11:00:00,115,215,11,12,767,687,80,6
10140,2023-02-27 12:00:00,65,289,9,15,633,490,143,6
10141,2023-02-27 13:00:00,86,261,13,13,757,599,158,10
10142,2023-02-27 14:00:00,71,157,12,13,761,589,172,11
10143,2023-02-27 15:00:00,87,203,12,16,726,536,190,6
10144,2023-02-27 16:00:00,107,146,12,15,710,533,177,13
10145,2023-02-27 17:00:00,77,169,14,12,753,528,225,14
10146,2023-02-27 18:00:00,53,208,5,12,783,551,232,14
10147,2023-02-27 19:00:00,114,258,7,11,659,526,133,7
10148,2023-02-27 20:00:00,117,128,8,10,656,480,176,13
10149,2023-02-27 21:00:00,141,231,12,16,515,427,88,14
10150,2023-02-27 22:00:00,110,150,11,18,682,596,86,12
10151,2023-02-27 23:00:00,126,269,8,19,699,576,123,5
10152,2023-02-28 00:00:00,112,142,14,11,709,544,165,8
10153,2023-02-28 01:00:00,136,145,14,15,506,438,68,7
10154,2023-02-28 02:00:00,52,209,6,10,625,490,135,5
10155,2023-02-28 03:00:00,73,107,7,15,655,507,148,8
10156,2023-02-28 04:00:00,107,128,7,12,510,362,148,6
10157,2023-02-28 05:00:00,92,156,11,13,569,506,63,5
10158,2023-02-28 06:00:00,55,107,11,16,516,366,150,12
10159,2023-02-28 07:00:00,87,260,9,14,751,598,153,11
10160,2023-02-28 08:00:00,71,253,8,12,578,472,106,12
10161,2023-02-28 09:00:00,55,170,10,17,771,614,157,13
10162,2023-02-28 10:00:00,63,275,13,17,687,563,124,14
10163,2023-02-28 11:00:00,134,137,6,16,551,478,73,8
10164,2023-02-28 12:00:00,100,224,5,19,775,588,187,14
10165,2023-02-28 13:00:00,136,161,14,13,586,485,101,7
10166,2023-02-28 14:00:00,68,172,10,13,783,697,86,11
10167,2023-02-28 15:00:00,94,140,12,14,781,624,157,13
10168,2023-02-28 16:00:00,125,175,7,11,772,619,153,14
10169,2023-02-28 17:00:00,114,219,9,15,625,447,178,7
10170,2023-02-28 18:00:00,115,278,12,17,624,444,180,8
10171,2023-02-28 19:00:00,125,141,7,12,502,400,102,12
10172,2023-02-28 20:00:00,63,235,11,11,797,641,156,14
10173,2023-02-28 21:00:00,71,133,13,13,781,593,188,14
10174,2023-02-28 22:00:00,94,277,11,12,722,587,135,8
10175,2023-02-28 23:00:00,96,107,11,15,508,380,128,7
10176,2023-03-01 00:00:00,113,116,10,16,719,638,81,9
10177,2023-03-01 01:00:00,92,295,6,12,570,453,117,5
10178,2023-03-01 02:00:00,116,140,5,15,524,449,75,8
10179,2023-03-01 03:00:00,75,287,6,15,666,532,134,7
10180,2023-03-01 04:00:00,124,293,7,11,560,446,114,8
10181,2023-03-01 05:00:00,130,149,13,15,568,426,142,6
10182,2023-03-01 06:00:00,98,120,14,14,571,465,106,5
10183,2023-03-01 07:00:00,104,241,6,13,657,467,190,8
10184,2023-03-01 08:00:00,124,228,9,16,534,383,151,6
10185,2023-03-01 09:00:00,59,163,10,19,755,611,144,8
10186,2023-03-01 10:00:00,104,102,6,19,598,536,62,6
10187,2023-03-01 11:00:00,102,240,6,18,783,693,90,6
10188,2023-03-01 12:00:00,79,189,5,11,661,557,104,5
10189,2023-03-01 13:00:00,56,158,8,13,666,472,194,9
10190,2023-03-01 14:00:00,54,264,10,10,750,627,123,11
10191,2023-03-01 15:00:00,124,240,6,17,678,518,160,6
10192,2023-03-01 16:00:00,134,140,7,16,732,545,187,7
10193,2023-03-01 17:00:00,142,234,11,18,526,438,88,11
10194,2023-03-01 18:00:00,62,158,11,18,548,462,86,5
10195,2023-03-01 19:00:00,71,182,12,18,591,454,137,9
10196,2023-03-01 20:00:00,121,191,9,15,729,535,194,10
10197,2023-03-01 21:00:00,98,101,6,19,528,457,71,5
10198,2023-03-01 22:00:00,78,105,10,15,692,514,178,10
10199,2023-03-01 23:00:00,139,280,6,17,761,570,191,12
10200,2023-03-02 00:00:00,92,157,6,13,625,498,127,10
10201,2023-03-02 01:00:00,124,166,10,11,542,475,67,13
10202,2023-03-02 02:00:00,78,172,14,10,589,518,71,11
10203,2023-03-02 03:00:00,141,219,5,16,715,515,200,9
10204,2023-03-02 04:00:00,145,228,7,14,641,529,112,13
10205,2023-03-02 05:00:00,85,288,9,12,682,480,202,13
10206,2023-03-02 06:00:00,77,185,6,18,578,458,120,12
10207,2023-03-02 07:00:00,58,177,8,15,657,537,120,5
10208,2023-03-02 08:00:00,80,158,13,17,662,496,166,8
10209,2023-03-02 09:00:00,83,127,14,13,647,489,158,10
10210,2023-03-02 10:00:00,98,289,6,19,755,628,127,10
10211,2023-03-02 11:00:00,52,258,6,13,639,537,102,12
10212,2023-03-02 12:00:00,78,120,10,13,644,499,145,5
10213,2023-03-02 13:00:00,63,266,6,19,783,676,107,8
10214,2023-03-02 14:00:00,77,139,10,16,621,470,151,6
10215,2023-03-02 15:00:00,84,256,6,12,624,489,135,14
10216,2023-03-02 16:00:00,123,122,13,14,782,620,162,5
10217,2023-03-02 17:00:00,144,212,12,13,516,464,52,5
10218,2023-03-02 18:00:00,147,149,13,18,573,438,135,7
10219,2023-03-02 19:00:00,74,125,10,10,698,600,98,11
10220,2023-03-02 20:00:00,75,190,7,15,648,560,88,10
10221,2023-03-02 21:00:00,106,277,12,14,611,513,98,9
10222,2023-03-02 22:00:00,115,205,10,11,533,376,157,11
10223,2023-03-02 23:00:00,77,220,13,15,524,453,71,9
10224,2023-03-03 00:00:00,117,172,8,10,769,634,135,11
10225,2023-03-03 01:00:00,129,175,14,16,742,593,149,8
10226,2023-03-03 02:00:00,50,253,8,18,678,551,127,6
10227,2023-03-03 03:00:00,55,141,14,17,640,455,185,8
10228,2023-03-03 04:00:00,105,241,12,11,737,582,155,13
10229,2023-03-03 05:00:00,93,288,6,11,538,418,120,10
10230,2023-03-03 06:00:00,87,240,14,13,706,525,181,7
10231,2023-03-03 07:00:00,137,215,12,12,730,653,77,10
10232,2023-03-03 08:00:00,77,116,7,19,683,524,159,9
10233,2023-03-03 09:00:00,94,170,13,15,791,649,142,12
10234,2023-03-03 10:00:00,57,192,11,19,624,461,163,10
10235,2023-03-03 11:00:00,76,166,12,14,769,574,195,6
10236,2023-03-03 12:00:00,56,250,12,12,756,533,223,8
10237,2023-03-03 13:00:00,134,196,6,17,647,488,159,7
10238,2023-03-03 14:00:00,54,299,8,12,511,458,53,11
10239,2023-03-03 15:00:00,130,143,11,13,589,466,123,14
10240,2023-03-03 16:00:00,69,120,5,11,687,522,165,6
10241,2023-03-03 17:00:00,101,274,5,13,645,502,143,13
10242,2023-03-03 18:00:00,79,196,6,12,768,627,141,11
10243,2023-03-03 19:00:00,72,233,10,18,798,628,170,8
10244,2023-03-03 20:00:00,148,192,8,11,634,503,131,9
10245,2023-03-03 21:00:00,147,275,12,13,584,415,169,9
10246,2023-03-03 22:00:00,81,183,14,19,532,417,115,5
10247,2023-03-03 23:00:00,59,267,13,11,794,564,230,11
10248,2023-03-04 00:00:00,64,139,10,10,731,593,138,10
10249,2023-03-04 01:00:00,136,277,9,19,735,643,92,5
10250,2023-03-04 02:00:00,114,137,13,13,692,619,73,11
10251,2023-03-04 03:00:00,54,189,11,17,729,576,153,5
10252,2023-03-04 04:00:00,113,178,5,17,788,606,182,10
10253,2023-03-04 05:00:00,96,195,7,14,641,552,89,14
10254,2023-03-04 06:00:00,71,236,13,13,767,617,150,7
10255,2023-03-04 07:00:00,72,108,11,19,624,534,90,11
10256,2023-03-04 08:00:00,55,176,14,16,640,473,167,9
10257,2023-03-04 09:00:00,146,154,12,12,529,472,57,6
10258,2023-03-04 10:00:00,55,164,6,19,590,430,160,10
10259,2023-03-04 11:00:00,68,119,14,12,566,494,72,10
10260,2023-03-04 12:00:00,133,262,10,19,679,498,181,13
10261,2023-03-04 13:00:00,84,249,6,18,516,366,150,10
10262,2023-03-04 14:00:00,110,265,10,17,725,546,179,13
10263,2023-03-04 15:00:00,103,129,6,13,790,585,205,6
10264,2023-03-04 16:00:00,87,139,12,15,709,525,184,14
10265,2023-03-04 17:00:00,117,233,7,17,731,626,105,13
10266,2023-03-04 18:00:00,80,270,7,19,547,406,141,11
10267,2023-03-04 19:00:00,93,177,10,18,673,522,151,10
10268,2023-03-04 20:00:00,127,288,6,12,536,380,156,14
10269,2023-03-04 21:00:00,135,239,6,13,763,686,77,6
10270,2023-03-04 22:00:00,68,239,12,16,618,552,66,6
10271,2023-03-04 23:00:00,126,299,11,13,599,519,80,14
10272,2023-03-05 00:00:00,68,201,12,11,613,524,89,7
10273,2023-03-05 01:00:00,89,250,8,12,728,509,219,14
10274,2023-03-05 02:00:00,133,110,9,15,741,540,201,11
10275,2023-03-05 03:00:00,144,282,9,16,646,556,90,14
10276,2023-03-05 04:00:00,146,131,6,15,709,577,132,9
10277,2023-03-05 05:00:00,143,111,11,13,523,433,90,13
10278,2023-03-05 06:00:00,104,199,12,14,514,375,139,13
10279,2023-03-05 07:00:00,61,295,14,13,624,496,128,11
10280,2023-03-05 08:00:00,145,116,9,10,582,491,91,11
10281,2023-03-05 09:00:00,86,236,12,10,545,414,131,9
10282,2023-03-05 10:00:00,81,108,6,14,761,679,82,10
10283,2023-03-05 11:00:00,53,278,8,11,727,573,154,10
10284,2023-03-05 12:00:00,67,182,5,12,731,596,135,7
10285,2023-03-05 13:00:00,101,173,12,16,674,489,185,5
10286,2023-03-05 14:00:00,132,219,11,11,573,413,160,12
10287,2023-03-05 15:00:00,133,255,6,12,710,620,90,14
10288,2023-03-05 16:00:00,73,104,8,15,691,552,139,11
10289,2023-03-05 17:00:00,127,199,11,12,514,449,65,14
10290,2023-03-05 18:00:00,100,228,11,18,688,617,71,10
10291,2023-03-05 19:00:00,58,174,6,10,610,462,148,10
10292,2023-03-05 20:00:00,77,171,12,19,692,564,128,8
10293,2023-03-05 21:00:00,54,136,9,16,536,451,85,6
10294,2023-03-05 22:00:00,55,134,6,11,610,431,179,11
10295,2023-03-05 23:00:00,60,138,7,11,787,570,217,8
10296,2023-03-06 00:00:00,149,207,5,16,712,573,139,10
10297,2023-03-06 01:00:00,134,254,13,15,782,664,118,6
10298,2023-03-06 02:00:00,59,182,5,13,776,671,105,7
10299,2023-03-06 03:00:00,86,234,11,16,701,543,158,7
10300,2023-03-06 04:00:00,60,280,9,14,593,467,126,10
10301,2023-03-06 05:00:00,144,281,8,13,503,392,111,10
10302,2023-03-06 06:00:00,137,242,11,13,504,410,94,11
10303,2023-03-06 07:00:00,79,171,6,13,542,419,123,8
10304,2023-03-06 08:00:00,97,217,8,11,731,598,133,11
10305,2023-03-06 09:00:00,133,280,7,10,760,591,169,7
10306,2023-03-06 10:00:00,58,242,12,16,555,485,70,11
10307,2023-03-06 11:00:00,51,123,9,16,716,511,205,11
10308,2023-03-06 12:00:00,141,251,11,14,568,510,58,11
10309,2023-03-06 13:00:00,87,198,5,11,711,516,195,14
10310,2023-03-06 14:00:00,122,138,14,11,571,487,84,13
10311,2023-03-06 15:00:00,92,167,10,12,748,540,208,10
10312,2023-03-06 16:00:00,147,279,10,10,568,440,128,13
10313,2023-03-06 17:00:00,129,280,11,18,681,589,92,8
10314,2023-03-06 18:00:00,77,268,14,13,524,460,64,13
10315,2023-03-06 19:00:00,73,246,5,10,754,669,85,7
10316,2023-03-06 20:00:00,102,268,6,19,728,602,126,9
10317,2023-03-06 21:00:00,148,143,7,10,750,596,154,10
10318,2023-03-06 22:00:00,86,132,13,10,638,465,173,8
10319,2023-03-06 23:00:00,140,126,12,19,568,466,102,7
10320,2023-03-07 00:00:00,78,126,9,15,773,647,126,11
10321,2023-03-07 01:00:00,90,131,9,12,775,623,152,13
10322,2023-03-07 02:00:00,101,120,13,11,779,622,157,14
10323,2023-03-07 03:00:00,142,263,13,12,616,529,87,10
10324,2023-03-07 04:00:00,119,257,10,17,751,635,116,12
10325,2023-03-07 05:00:00,69,270,8,18,567,460,107,9
10326,2023-03-07 06:00:00,61,250,11,19,524,408,116,7
10327,2023-03-07 07:00:00,112,208,13,13,613,504,109,8
10328,2023-03-07 08:00:00,50,175,8,11,593,427,166,9
10329,2023-03-07 09:00:00,59,260,8,14,519,409,110,11
10330,2023-03-07 10:00:00,144,179,12,18,789,616,173,14
10331,2023-03-07 11:00:00,84,203,5,17,631,451,180,12
10332,2023-03-07 12:00:00,73,190,11,15,598,537,61,8
10333,2023-03-07 13:00:00,117,162,11,17,670,565,105,13
10334,2023-03-07 14:00:00,88,201,8,12,722,540,182,10
10335,2023-03-07 15:00:00,100,196,10,10,633,521,112,13
10336,2023-03-07 16:00:00,50,136,14,18,521,403,118,9
10337,2023-03-07 17:00:00,137,291,6,14,577,432,145,10
10338,2023-03-07 18:00:00,52,188,13,17,661,568,93,14
10339,2023-03-07 19:00:00,53,185,13,11,546,406,140,5
10340,2023-03-07 20:00:00,103,268,12,11,717,507,210,10
10341,2023-03-07 21:00:00,149,204,14,15,752,666,86,10
10342,2023-03-07 22:00:00,143,213,7,14,696,509,187,11
10343,2023-03-07 23:00:00,57,155,7,17,780,657,123,10
10344,2023-03-08 00:00:00,126,156,6,13,610,486,124,11
10345,2023-03-08 01:00:00,141,162,6,10,758,664,94,12
10346,2023-03-08 02:00:00,133,160,9,13,700,498,202,5
10347,2023-03-08 03:00:00,93,170,10,18,508,453,55,5
10348,2023-03-08 04:00:00,109,282,7,15,595,501,94,13
10349,2023-03-08 05:00:00,104,287,8,17,628,525,103,14
10350,2023-03-08 06:00:00,140,149,11,14,619,522,97,5
10351,2023-03-08 07:00:00,128,264,8,17,668,530,138,5
10352,2023-03-08 08:00:00,97,239,9,19,573,421,152,12
10353,2023-03-08 09:00:00,63,242,10,12,638,471,167,10
10354,2023-03-08 10:00:00,135,149,14,14,750,560,190,7
10355,2023-03-08 11:00:00,85,124,8,17,673,565,108,6
10356,2023-03-08 12:00:00,95,264,11,10,501,443,58,11
10357,2023-03-08 13:00:00,55,244,14,16,615,446,169,14
10358,2023-03-08 14:00:00,81,279,6,11,714,567,147,9
10359,2023-03-08 15:00:00,109,157,10,11,704,613,91,11
10360,2023-03-08 16:00:00,75,290,11,11,784,644,140,11
10361,2023-03-08 17:00:00,110,188,8,14,696,603,93,12
10362,2023-03-08 18:00:00,104,261,7,16,743,655,88,9
10363,2023-03-08 19:00:00,57,214,14,12,510,362,148,10
10364,2023-03-08 20:00:00,74,223,7,15,594,504,90,8
10365,2023-03-08 21:00:00,137,250,5,17,720,561,159,11
10366,2023-03-08 22:00:00,94,163,11,10,543,462,81,8
10367,2023-03-08 23:00:00,96,286,14,12,501,374,127,10
10368,2023-03-09 00:00:00,79,169,14,13,543,402,141,13
10369,2023-03-09 01:00:00,144,247,7,18,634,444,190,10
10370,2023-03-09 02:00:00,129,218,10,17,685,555,130,11
10371,2023-03-09 03:00:00,137,260,12,12,773,683,90,7
10372,2023-03-09 04:00:00,62,131,6,13,723,579,144,9
10373,2023-03-09 05:00:00,66,144,5,18,683,535,148,5
10374,2023-03-09 06:00:00,100,108,7,10,705,631,74,13
10375,2023-03-09 07:00:00,125,200,13,18,678,525,153,12
10376,2023-03-09 08:00:00,137,212,10,18,533,474,59,8
10377,2023-03-09 09:00:00,143,138,8,10,570,472,98,11
10378,2023-03-09 10:00:00,144,269,14,12,629,520,109,8
10379,2023-03-09 11:00:00,145,227,11,11,718,565,153,12
10380,2023-03-09 12:00:00,119,280,10,11,608,496,112,9
10381,2023-03-09 13:00:00,119,263,5,10,608,510,98,6
10382,2023-03-09 14:00:00,127,124,5,13,770,549,221,10
10383,2023-03-09 15:00:00,53,244,12,18,562,405,157,8
10384,2023-03-09 16:00:00,71,295,11,12,558,399,159,9
10385,2023-03-09 17:00:00,93,266,13,17,715,551,164,12
10386,2023-03-09 18:00:00,98,102,13,18,572,504,68,12
10387,2023-03-09 19:00:00,127,207,6,17,756,617,139,8
10388,2023-03-09 20:00:00,69,249,11,15,609,428,181,12
10389,2023-03-09 21:00:00,128,297,5,12,702,613,89,10
10390,2023-03-09 22:00:00,62,252,9,12,702,560,142,13
10391,2023-03-09 23:00:00,135,265,6,14,534,407,127,8
10392,2023-03-10 00:00:00,103,191,5,11,592,429,163,10
10393,2023-03-10 01:00:00,77,135,11,12,737,624,113,5
10394,2023-03-10 02:00:00,59,117,6,12,755,635,120,5
10395,2023-03-10 03:00:00,54,152,10,19,590,526,64,13
10396,2023-03-10 04:00:00,127,238,11,19,641,533,108,8
10397,2023-03-10 05:00:00,139,238,9,18,677,504,173,8
10398,2023-03-10 06:00:00,144,252,5,14,791,563,228,11
10399,2023-03-10 07:00:00,74,155,7,11,552,414,138,9
10400,2023-03-10 08:00:00,88,192,10,15,691,554,137,7
10401,2023-03-10 09:00:00,90,219,6,15,555,486,69,9
10402,2023-03-10 10:00:00,63,165,13,11,754,633,121,7
10403,2023-03-10 11:00:00,87,174,9,10,680,566,114,14
10404,2023-03-10 12:00:00,69,280,11,19,769,583,186,13
10405,2023-03-10 13:00:00,139,137,9,10,539,470,69,12
10406,2023-03-10 14:00:00,74,232,9,16,613,512,101,6
10407,2023-03-10 15:00:00,91,180,12,13,525,430,95,12
10408,2023-03-10 16:00:00,146,270,13,17,673,535,138,13
10409,2023-03-10 17:00:00,103,192,12,19,532,439,93,9
10410,2023-03-10 18:00:00,143,221,13,18,511,444,67,13
10411,2023-03-10 19:00:00,57,245,12,18,544,396,148,8
10412,2023-03-10 20:00:00,99,171,10,13,602,508,94,13
10413,2023-03-10 21:00:00,124,248,9,14,588,523,65,9
10414,2023-03-10 22:00:00,52,164,14,14,793,573,220,5
10415,2023-03-10 23:00:00,122,177,11,18,634,478,156,14
10416,2023-03-11 00:00:00,106,125,7,19,758,654,104,13
10417,2023-03-11 01:00:00,57,247,9,16,590,465,125,7
10418,2023-03-11 02:00:00,137,291,13,13,500,416,84,8
10419,2023-03-11 03:00:00,76,262,7,11,679,597,82,12
10420,2023-03-11 04:00:00,65,263,11,10,677,598,79,7
10421,2023-03-11 05:00:00,89,151,10,16,698,607,91,6
10422,2023-03-11 06:00:00,63,143,10,18,789,552,237,6
10423,2023-03-11 07:00:00,129,295,11,13,594,482,112,6
10424,2023-03-11 08:00:00,97,219,6,16,728,594,134,6
10425,2023-03-11 09:00:00,50,243,5,17,587,436,151,12
10426,2023-03-11 10:00:00,110,278,6,12,592,456,136,8
10427,2023-03-11 11:00:00,63,118,13,12,612,506,106,14
10428,2023-03-11 12:00:00,134,105,8,17,639,491,148,12
10429,2023-03-11 13:00:00,57,227,10,10,518,418,100,7
10430,2023-03-11 14:00:00,105,178,13,11,588,525,63,5
10431,2023-03-11 15:00:00,85,200,14,17,770,648,122,12
10432,2023-03-11 16:00:00,71,271,9,15,686,534,152,8
10433,2023-03-11 17:00:00,75,135,13,10,538,448,90,5
10434,2023-03-11 18:00:00,115,265,12,16,714,539,175,12
10435,2023-03-11 19:00:00,130,288,8,12,769,614,155,12
10436,2023-03-11 20:00:00,69,236,5,15,660,469,191,7
10437,2023-03-11 21:00:00,94,141,13,17,646,516,130,10
10438,2023-03-11 22:00:00,99,166,7,18,653,546,107,10
10439,2023-03-11 23:00:00,95,143,12,12,565,424,141,9
10440,2023-03-12 00:00:00,71,195,12,14,653,498,155,7
10441,2023-03-12 01:00:00,145,266,14,14,543,458,85,7
10442,2023-03-12 02:00:00,63,212,10,19,703,532,171,13
10443,2023-03-12 03:00:00,116,247,7,19,622,498,124,10
10444,2023-03-12 04:00:00,94,122,13,18,504,433,71,5
10445,2023-03-12 05:00:00,53,235,10,16,698,579,119,8
10446,2023-03-12 06:00:00,68,278,11,11,728,587,141,8
10447,2023-03-12 07:00:00,121,267,9,15,533,473,60,9
10448,2023-03-12 08:00:00,88,202,14,14,761,645,116,5
10449,2023-03-12 09:00:00,74,285,12,11,649,528,121,9
10450,2023-03-12 10:00:00,129,230,5,16,741,663,78,13
10451,2023-03-12 11:00:00,95,274,8,11,776,609,167,9
10452,2023-03-12 12:00:00,145,263,6,19,503,358,145,12
10453,2023-03-12 13:00:00,92,166,7,18,690,564,126,7
10454,2023-03-12 14:00:00,121,291,6,16,575,509,66,6
10455,2023-03-12 15:00:00,77,224,10,14,675,601,74,11
10456,2023-03-12 16:00:00,77,131,6,15,762,680,82,12
10457,2023-03-12 17:00:00,57,240,14,19,605,431,174,12
10458,2023-03-12 18:00:00,91,122,10,14,541,455,86,14
10459,2023-03-12 19:00:00,104,284,7,10,687,549,138,8
10460,2023-03-12 20:00:00,59,175,11,16,571,439,132,11
10461,2023-03-12 21:00:00,127,163,13,13,569,475,94,13
10462,2023-03-12 22:00:00,145,289,10,14,790,684,106,8
10463,2023-03-12 23:00:00,96,195,12,13,540,431,109,8
10464,2023-03-13 00:00:00,51,121,10,18,606,445,161,10
10465,2023-03-13 01:00:00,109,281,14,18,721,515,206,5
10466,2023-03-13 02:00:00,119,171,10,19,775,663,112,6
10467,2023-03-13 03:00:00,133,246,9,12,732,599,133,11
10468,2023-03-13 04:00:00,123,171,14,10,753,640,113,10
10469,2023-03-13 05:00:00,108,254,13,12,790,655,135,13
10470,2023-03-13 06:00:00,96,281,10,18,565,432,133,12
10471,2023-03-13 07:00:00,149,219,5,18,636,518,118,6
10472,2023-03-13 08:00:00,127,163,10,13,545,410,135,9
10473,2023-03-13 09:00:00,68,235,14,13,785,635,150,11
10474,2023-03-13 10:00:00,105,254,13,12,798,601,197,9
10475,2023-03-13 11:00:00,80,200,9,12,634,561,73,14
10476,2023-03-13 12:00:00,69,184,10,17,501,442,59,7
10477,2023-03-13 13:00:00,142,218,11,18,572,429,143,11
10478,2023-03-13 14:00:00,75,189,14,13,637,572,65,14
10479,2023-03-13 15:00:00,79,292,8,10,582,488,94,12
10480,2023-03-13 16:00:00,77,167,8,13,528,441,87,6
10481,2023-03-13 17:00:00,137,160,13,19,741,607,134,8
10482,2023-03-13 18:00:00,93,294,6,12,790,708,82,14
10483,2023-03-13 19:00:00,59,112,6,12,526,463,63,10
10484,2023-03-13 20:00:00,90,232,5,12,647,567,80,8
10485,2023-03-13 21:00:00,82,134,8,17,539,420,119,9
10486,2023-03-13 22:00:00,83,114,13,16,509,453,56,14
10487,2023-03-13 23:00:00,59,232,12,14,727,530,197,14
10488,2023-03-14 00:00:00,148,248,11,13,578,481,97,12
10489,2023-03-14 01:00:00,138,235,7,11,677,584,93,8
10490,2023-03-14 02:00:00,54,267,13,17,570,504,66,14
10491,2023-03-14 03:00:00,59,239,5,19,695,552,143,12
10492,2023-03-14 04:00:00,96,251,11,17,677,562,115,7
10493,2023-03-14 05:00:00,83,132,5,19,643,559,84,5
10494,2023-03-14 06:00:00,55,272,14,16,782,617,165,9
10495,2023-03-14 07:00:00,94,276,14,12,596,433,163,12
10496,2023-03-14 08:00:00,144,206,9,11,520,367,153,11
10497,2023-03-14 09:00:00,132,229,7,17,545,484,61,11
10498,2023-03-14 10:00:00,87,152,14,11,768,562,206,11
10499,2023-03-14 11:00:00,108,113,7,16,653,513,140,9
10500,2023-03-14 12:00:00,140,130,8,12,737,658,79,9
10501,2023-03-14 13:00:00,142,199,12,11,677,602,75,6
10502,2023-03-14 14:00:00,70,275,13,15,569,481,88,11
10503,2023-03-14 15:00:00,130,120,9,10,782,674,108,8
10504,2023-03-14 16:00:00,125,167,12,13,600,430,170,6
10505,2023-03-14 17:00:00,98,292,14,17,784,572,212,12
10506,2023-03-14 18:00:00,82,184,5,10,560,502,58,10
10507,2023-03-14 19:00:00,140,251,7,17,524,451,73,5
10508,2023-03-14 20:00:00,57,133,10,10,731,587,144,12
10509,2023-03-14 21:00:00,147,191,13,15,716,550,166,11
10510,2023-03-14 22:00:00,141,151,7,18,701,595,106,14
10511,2023-03-14 23:00:00,84,229,12,18,682,530,152,10
10512,2023-03-15 00:00:00,86,260,9,17,674,562,112,8
10513,2023-03-15 01:00:00,73,157,7,12,642,550,92,6
10514,2023-03-15 02:00:00,61,174,12,13,587,472,115,12
10515,2023-03-15 03:00:00,97,278,5,19,774,625,149,12
10516,2023-03-15 04:00:00,86,187,8,10,705,495,210,14
10517,2023-03-15 05:00:00,128,285,10,16,749,654,95,11
10518,2023-03-15 06:00:00,139,132,12,16,565,471,94,7
10519,2023-03-15 07:00:00,140,141,8,12,771,690,81,9
10520,2023-03-15 08:00:00,58,243,10,14,660,543,117,7
10521,2023-03-15 09:00:00,85,146,14,10,575,484,91,9
10522,2023-03-15 10:00:00,55,146,13,13,567,493,74,8
10523,2023-03-15 11:00:00,131,196,8,10,540,379,161,11
10524,2023-03-15 12:00:00,59,276,14,15,757,678,79,11
10525,2023-03-15 13:00:00,119,153,6,11,526,436,90,7
10526,2023-03-15 14:00:00,56,101,6,13,640,463,177,5
10527,2023-03-15 15:00:00,80,195,14,17,783,565,218,7
10528,2023-03-15 16:00:00,84,100,10,10,601,456,145,13
10529,2023-03-15 17:00:00,74,206,12,18,719,643,76,14
10530,2023-03-15 18:00:00,66,223,11,11,652,480,172,9
10531,2023-03-15 19:00:00,91,212,8,15,552,416,136,13
10532,2023-03-15 20:00:00,148,170,10,18,779,671,108,5
10533,2023-03-15 21:00:00,110,155,10,12,641,487,154,9
10534,2023-03-15 22:00:00,85,215,14,17,678,509,169,8
10535,2023-03-15 23:00:00,90,193,9,19,739,571,168,12
10536,2023-03-16 00:00:00,51,204,8,18,601,514,87,6
10537,2023-03-16 01:00:00,133,258,6,13,541,390,151,10
10538,2023-03-16 02:00:00,72,114,10,10,672,524,148,6
10539,2023-03-16 03:00:00,113,296,12,12,691,509,182,14
10540,2023-03-16 04:00:00,144,139,6,16,581,453,128,8
10541,2023-03-16 05:00:00,63,164,13,15,566,472,94,7
10542,2023-03-16 06:00:00,129,191,7,13,579,406,173,6
10543,2023-03-16 07:00:00,103,234,8,14,775,664,111,9
10544,2023-03-16 08:00:00,129,178,5,18,593,417,176,5
10545,2023-03-16 09:00:00,89,185,14,12,583,484,99,8
10546,2023-03-16 10:00:00,114,279,5,15,659,579,80,5
10547,2023-03-16 11:00:00,112,153,6,14,517,380,137,10
10548,2023-03-16 12:00:00,146,228,8,15,586,504,82,6
10549,2023-03-16 13:00:00,103,257,13,16,735,573,162,11
10550,2023-03-16 14:00:00,142,211,13,19,777,640,137,11
10551,2023-03-16 15:00:00,81,118,9,16,613,505,108,5
10552,2023-03-16 16:00:00,141,160,14,14,605,526,79,11
10553,2023-03-16 17:00:00,76,169,8,18,513,388,125,8
10554,2023-03-16 18:00:00,54,232,10,12,639,542,97,6
10555,2023-03-16 19:00:00,94,126,10,14,534,444,90,9
10556,2023-03-16 20:00:00,128,224,8,11,541,442,99,14
10557,2023-03-16 21:00:00,96,192,13,16,500,426,74,8
10558,2023-03-16 22:00:00,69,292,14,18,768,659,109,11
10559,2023-03-16 23:00:00,149,251,5,18,733,549,184,6
10560,2023-03-17 00:00:00,115,195,12,17,723,541,182,8
10561,2023-03-17 01:00:00,101,176,9,17,779,603,176,12
10562,2023-03-17 02:00:00,106,197,10,11,701,597,104,5
10563,2023-03-17 03:00:00,97,198,11,18,733,514,219,14
10564,2023-03-17 04:00:00,107,227,8,12,538,402,136,6
10565,2023-03-17 05:00:00,99,241,9,17,710,618,92,11
10566,2023-03-17 06:00:00,72,153,11,14,609,509,100,13
10567,2023-03-17 07:00:00,149,267,13,15,699,532,167,6
10568,2023-03-17 08:00:00,129,175,6,15,550,387,163,14
10569,2023-03-17 09:00:00,64,200,5,16,654,490,164,13
10570,2023-03-17 10:00:00,77,153,11,10,734,543,191,7
10571,2023-03-17 11:00:00,95,163,9,12,581,420,161,12
10572,2023-03-17 12:00:00,111,157,9,12,777,681,96,8
10573,2023-03-17 13:00:00,58,102,12,17,639,539,100,11
10574,2023-03-17 14:00:00,72,214,5,13,547,488,59,6
10575,2023-03-17 15:00:00,80,251,7,19,752,597,155,7
10576,2023-03-17 16:00:00,102,251,6,10,684,519,165,9
10577,2023-03-17 17:00:00,81,250,5,16,627,498,129,12
10578,2023-03-17 18:00:00,95,237,12,12,753,595,158,10
10579,2023-03-17 19:00:00,137,102,10,11,609,498,111,8
10580,2023-03-17 20:00:00,149,254,7,19,781,652,129,9
10581,2023-03-17 21:00:00,104,247,9,13,529,396,133,12
10582,2023-03-17 22:00:00,120,202,12,10,593,433,160,14
10583,2023-03-17 23:00:00,83,256,12,12,697,613,84,11
10584,2023-03-18 00:00:00,138,257,11,10,609,545,64,11
10585,2023-03-18 01:00:00,148,229,13,10,596,482,114,9
10586,2023-03-18 02:00:00,101,221,11,17,558,494,64,11
10587,2023-03-18 03:00:00,139,211,10,13,727,623,104,5
10588,2023-03-18 04:00:00,98,202,14,16,587,451,136,10
10589,2023-03-18 05:00:00,106,235,10,13,796,606,190,11
10590,2023-03-18 06:00:00,89,295,7,11,596,487,109,12
10591,2023-03-18 07:00:00,149,268,14,11,536,478,58,11
10592,2023-03-18 08:00:00,65,143,8,17,509,363,146,7
10593,2023-03-18 09:00:00,139,158,12,13,709,578,131,11
10594,2023-03-18 10:00:00,107,173,9,12,710,532,178,9
10595,2023-03-18 11:00:00,99,108,8,14,596,440,156,9
10596,2023-03-18 12:00:00,95,281,10,15,660,465,195,9
10597,2023-03-18 13:00:00,68,220,9,15,526,427,99,13
10598,2023-03-18 14:00:00,91,178,10,13,653,507,146,11
10599,2023-03-18 15:00:00,144,205,10,18,613,549,64,10
10600,2023-03-18 16:00:00,67,144,6,16,707,528,179,12
10601,2023-03-18 17:00:00,81,242,14,13,545,449,96,5
10602,2023-03-18 18:00:00,80,167,5,19,615,482,133,8
10603,2023-03-18 19:00:00,76,258,6,11,647,573,74,9
10604,2023-03-18 20:00:00,82,204,12,11,586,477,109,5
10605,2023-03-18 21:00:00,90,229,5,17,670,589,81,14
10606,2023-03-18 22:00:00,96,297,5,17,712,604,108,12
10607,2023-03-18 23:00:00,52,123,5,16,688,611,77,5
10608,2023-03-19 00:00:00,105,187,11,11,573,491,82,6
10609,2023-03-19 01:00:00,61,150,11,15,510,386,124,12
10610,2023-03-19 02:00:00,116,108,12,19,780,563,217,8
10611,2023-03-19 03:00:00,61,269,12,16,763,597,166,11
10612,2023-03-19 04:00:00,63,132,9,10,693,618,75,5
10613,2023-03-19 05:00:00,85,200,7,14,686,590,96,10
10614,2023-03-19 06:00:00,100,256,11,19,678,506,172,8
10615,2023-03-19 07:00:00,138,162,14,16,768,632,136,13
10616,2023-03-19 08:00:00,138,238,6,18,657,515,142,8
10617,2023-03-19 09:00:00,105,166,7,12,629,461,168,11
10618,2023-03-19 10:00:00,144,282,7,16,603,464,139,13
10619,2023-03-19 11:00:00,142,195,8,19,718,515,203,7
10620,2023-03-19 12:00:00,73,211,7,15,566,402,164,14
10621,2023-03-19 13:00:00,89,175,14,10,643,557,86,13
10622,2023-03-19 14:00:00,109,109,10,11,730,567,163,10
10623,2023-03-19 15:00:00,63,167,7,12,557,421,136,7
10624,2023-03-19 16:00:00,81,238,13,13,582,477,105,6
10625,2023-03-19 17:00:00,78,202,13,10,523,443,80,5
10626,2023-03-19 18:00:00,147,266,9,17,757,629,128,11
10627,2023-03-19 19:00:00,115,288,6,15,631,442,189,8
10628,2023-03-19 20:00:00,137,157,12,15,672,574,98,5
10629,2023-03-19 21:00:00,117,144,13,17,643,498,145,12
10630,2023-03-19 22:00:00,138,141,5,15,741,591,150,9
10631,2023-03-19 23:00:00,89,286,13,11,564,457,107,7
10632,2023-03-20 00:00:00,137,293,10,19,577,495,82,11
10633,2023-03-20 01:00:00,79,188,9,18,715,569,146,12
10634,2023-03-20 02:00:00,99,137,9,15,671,507,164,10
10635,2023-03-20 03:00:00,126,197,12,15,600,488,112,5
10636,2023-03-20 04:00:00,135,231,9,19,561,470,91,13
10637,2023-03-20 05:00:00,77,153,14,16,751,559,192,6
10638,2023-03-20 06:00:00,145,297,13,12,786,669,117,13
10639,2023-03-20 07:00:00,128,151,14,16,571,400,171,9
10640,2023-03-20 08:00:00,106,119,6,19,783,685,98,11
10641,2023-03-20 09:00:00,119,229,8,16,747,664,83,5
10642,2023-03-20 10:00:00,57,210,12,13,768,577,191,8
10643,2023-03-20 11:00:00,61,113,7,14,764,581,183,5
10644,2023-03-20 12:00:00,110,279,12,19,614,498,116,12
10645,2023-03-20 13:00:00,146,171,6,18,670,555,115,6
10646,2023-03-20 14:00:00,122,179,13,18,671,600,71,5
10647,2023-03-20 15:00:00,81,299,12,11,568,510,58,13
10648,2023-03-20 16:00:00,95,135,9,12,642,480,162,5
10649,2023-03-20 17:00:00,124,167,5,19,608,537,71,8
10650,2023-03-20 18:00:00,143,147,14,10,699,587,112,7
10651,2023-03-20 19:00:00,54,111,14,12,576,448,128,7
10652,2023-03-20 20:00:00,110,268,12,15,657,553,104,11
10653,2023-03-20 21:00:00,118,284,13,11,747,610,137,9
10654,2023-03-20 22:00:00,129,221,7,17,769,603,166,13
10655,2023-03-20 23:00:00,80,264,6,14,717,507,210,8
10656,2023-03-21 00:00:00,132,296,5,10,699,607,92,14
10657,2023-03-21 01:00:00,127,184,10,12,775,550,225,9
10658,2023-03-21 02:00:00,148,174,6,14,604,454,150,5
10659,2023-03-21 03:00:00,144,173,11,19,612,534,78,8
10660,2023-03-21 04:00:00,121,153,12,19,645,554,91,7
10661,2023-03-21 05:00:00,87,278,12,18,732,657,75,5
10662,2023-03-21 06:00:00,100,202,6,10,621,550,71,13
10663,2023-03-21 07:00:00,136,290,14,11,690,518,172,14
10664,2023-03-21 08:00:00,94,182,12,12,653,553,100,5
10665,2023-03-21 09:00:00,54,170,14,13,689,498,191,13
10666,2023-03-21 10:00:00,108,125,7,10,706,546,160,5
10667,2023-03-21 11:00:00,52,175,8,17,700,492,208,12
10668,2023-03-21 12:00:00,62,128,6,14,506,396,110,10
10669,2023-03-21 13:00:00,69,260,11,15,700,507,193,5
10670,2023-03-21 14:00:00,104,143,7,13,738,605,133,5
10671,2023-03-21 15:00:00,134,253,10,17,561,428,133,12
10672,2023-03-21 16:00:00,101,241,7,15,586,453,133,10
10673,2023-03-21 17:00:00,69,171,11,14,698,625,73,10
10674,2023-03-21 18:00:00,126,175,11,16,607,504,103,9
10675,2023-03-21 19:00:00,100,110,10,18,572,415,157,12
10676,2023-03-21 20:00:00,127,142,7,17,522,379,143,8
10677,2023-03-21 21:00:00,86,199,14,12,699,521,178,12
10678,2023-03-21 22:00:00,133,246,10,10,550,389,161,13
10679,2023-03-21 23:00:00,53,259,10,11,734,550,184,12
10680,2023-03-22 00:00:00,106,286,10,17,673,522,151,12
10681,2023-03-22 01:00:00,122,218,12,13,677,585,92,12
10682,2023-03-22 02:00:00,55,252,11,14,666,585,81,6
10683,2023-03-22 03:00:00,145,126,6,15,526,395,131,10
10684,2023-03-22 04:00:00,63,256,8,19,731,607,124,8
10685,2023-03-22 05:00:00,99,146,11,18,665,542,123,13
10686,2023-03-22 06:00:00,56,248,5,17,551,465,86,12
10687,2023-03-22 07:00:00,54,115,10,14,595,465,130,14
10688,2023-03-22 08:00:00,66,267,11,16,792,702,90,14
10689,2023-03-22 09:00:00,82,240,9,10,697,549,148,9
10690,2023-03-22 10:00:00,120,171,5,16,762,641,121,9
10691,2023-03-22 11:00:00,67,233,13,13,721,647,74,13
10692,2023-03-22 12:00:00,81,231,12,17,634,454,180,10
10693,2023-03-22 13:00:00,67,140,6,18,698,511,187,10
10694,2023-03-22 14:00:00,87,197,7,11,577,474,103,9
10695,2023-03-22 15:00:00,148,248,9,13,617,457,160,10
10696,2023-03-22 16:00:00,149,214,9,18,562,404,158,13
10697,2023-03-22 17:00:00,54,187,11,18,726,508,218,5
10698,2023-03-22 18:00:00,58,107,12,15,699,560,139,13
10699,2023-03-22 19:00:00,120,181,5,18,540,440,100,9
10700,2023-03-22 20:00:00,147,206,9,17,734,539,195,11
10701,2023-03-22 21:00:00,136,263,11,14,515,421,94,13
10702,2023-03-22 22:00:00,54,158,5,14,640,461,179,14
10703,2023-03-22 23:00:00,88,217,9,16,591,463,128,14
10704,2023-03-23 00:00:00,127,260,6,11,577,446,131,6
10705,2023-03-23 01:00:00,136,270,8,13,634,465,169,11
10706,2023-03-23 02:00:00,77,281,5,16,544,462,82,7
10707,2023-03-23 03:00:00,138,110,6,17,507,446,61,11
10708,2023-03-23 04:00:00,65,273,11,16,599,526,73,7
10709,2023-03-23 05:00:00,102,294,10,16,716,590,126,6
10710,2023-03-23 06:00:00,91,124,6,16,633,494,139,6
10711,2023-03-23 07:00:00,132,291,12,10,754,558,196,11
10712,2023-03-23 08:00:00,97,257,10,14,730,576,154,11
10713,2023-03-23 09:00:00,53,288,10,12,655,568,87,5
10714,2023-03-23 10:00:00,124,193,9,11,531,403,128,9
10715,2023-03-23 11:00:00,135,291,10,17,596,518,78,12
10716,2023-03-23 12:00:00,140,192,11,16,527,416,111,13
10717,2023-03-23 13:00:00,111,128,10,12,513,367,146,7
10718,2023-03-23 14:00:00,57,141,11,11,559,436,123,13
10719,2023-03-23 15:00:00,141,259,11,17,570,400,170,13
10720,2023-03-23 16:00:00,135,109,9,17,515,381,134,11
10721,2023-03-23 17:00:00,141,247,8,16,716,611,105,12
10722,2023-03-23 18:00:00,60,205,11,11,709,620,89,7
10723,2023-03-23 19:00:00,74,234,14,13,698,607,91,5
10724,2023-03-23 20:00:00,103,249,14,18,518,405,113,6
10725,2023-03-23 21:00:00,68,296,6,16,787,628,159,14
10726,2023-03-23 22:00:00,130,124,6,11,562,497,65,14
10727,2023-03-23 23:00:00,138,213,8,19,658,551,107,6
10728,2023-03-24 00:00:00,70,272,7,15,520,381,139,13
10729,2023-03-24 01:00:00,88,214,13,16,552,487,65,5
10730,2023-03-24 02:00:00,50,114,14,16,747,660,87,8
10731,2023-03-24 03:00:00,55,129,7,15,547,421,126,6
10732,2023-03-24 04:00:00,63,205,12,11,739,561,178,6
10733,2023-03-24 05:00:00,79,162,8,18,629,471,158,7
10734,2023-03-24 06:00:00,69,114,8,18,761,596,165,12
10735,2023-03-24 07:00:00,83,257,6,14,583,508,75,10
10736,2023-03-24 08:00:00,124,153,7,17,704,629,75,10
10737,2023-03-24 09:00:00,85,298,13,16,566,418,148,11
10738,2023-03-24 10:00:00,123,280,13,14,644,565,79,13
10739,2023-03-24 11:00:00,137,292,6,18,688,496,192,5
10740,2023-03-24 12:00:00,133,106,12,12,676,495,181,5
10741,2023-03-24 13:00:00,127,264,6,11,634,538,96,6
10742,2023-03-24 14:00:00,138,172,8,13,778,646,132,5
10743,2023-03-24 15:00:00,98,197,5,11,704,567,137,14
10744,2023-03-24 16:00:00,87,173,14,10,664,546,118,13
10745,2023-03-24 17:00:00,149,175,11,15,615,470,145,10
10746,2023-03-24 18:00:00,115,298,9,18,719,582,137,8
10747,2023-03-24 19:00:00,139,229,8,11,536,457,79,9
10748,2023-03-24 20:00:00,139,248,10,13,525,460,65,9
10749,2023-03-24 21:00:00,61,188,10,19,729,577,152,10
10750,2023-03-24 22:00:00,124,160,7,16,529,439,90,12
10751,2023-03-24 23:00:00,146,156,6,10,500,397,103,13
10752,2023-03-25 00:00:00,134,177,12,13,592,506,86,14
10753,2023-03-25 01:00:00,145,111,11,11,750,668,82,8
10754,2023-03-25 02:00:00,108,270,11,14,680,492,188,5
10755,2023-03-25 03:00:00,79,249,8,17,690,494,196,9
10756,2023-03-25 04:00:00,64,270,14,10,767,548,219,13
10757,2023-03-25 05:00:00,55,198,13,11,613,442,171,6
10758,2023-03-25 06:00:00,143,219,9,17,516,428,88,9
10759,2023-03-25 07:00:00,115,179,10,18,698,540,158,12
10760,2023-03-25 08:00:00,133,292,6,17,594,459,135,5
10761,2023-03-25 09:00:00,87,108,8,13,624,544,80,14
10762,2023-03-25 10:00:00,88,169,6,19,621,441,180,6
10763,2023-03-25 11:00:00,133,124,8,11,542,477,65,11
10764,2023-03-25 12:00:00,57,155,12,15,795,591,204,10
10765,2023-03-25 13:00:00,66,113,9,11,682,588,94,8
10766,2023-03-25 14:00:00,80,173,5,18,702,533,169,7
10767,2023-03-25 15:00:00,63,283,9,13,615,457,158,5
10768,2023-03-25 16:00:00,75,253,11,11,518,384,134,9
10769,2023-03-25 17:00:00,105,157,5,14,652,560,92,7
10770,2023-03-25 18:00:00,86,209,6,11,629,481,148,14
10771,2023-03-25 19:00:00,71,236,14,19,660,509,151,10
10772,2023-03-25 20:00:00,99,281,12,19,581,414,167,14
10773,2023-03-25 21:00:00,113,183,5,17,790,686,104,6
10774,2023-03-25 22:00:00,139,203,9,14,746,632,114,12
10775,2023-03-25 23:00:00,52,128,7,18,785,642,143,14
10776,2023-03-26 00:00:00,111,195,12,13,745,635,110,13
10777,2023-03-26 01:00:00,56,157,7,10,586,501,85,14
10778,2023-03-26 02:00:00,119,234,9,12,528,381,147,10
10779,2023-03-26 03:00:00,135,114,13,14,660,510,150,11
10780,2023-03-26 04:00:00,97,153,14,18,780,695,85,13
10781,2023-03-26 05:00:00,83,111,12,18,559,445,114,6
10782,2023-03-26 06:00:00,106,252,11,14,571,480,91,12
10783,2023-03-26 07:00:00,63,131,6,11,749,654,95,5
10784,2023-03-26 08:00:00,76,276,6,18,614,436,178,9
10785,2023-03-26 09:00:00,56,289,6,19,578,472,106,10
10786,2023-03-26 10:00:00,55,262,10,16,691,545,146,7
10787,2023-03-26 11:00:00,100,184,10,14,577,449,128,13
10788,2023-03-26 12:00:00,82,131,6,11,501,352,149,12
10789,2023-03-26 13:00:00,76,118,14,13,730,579,151,7
10790,2023-03-26 14:00:00,118,155,9,16,526,417,109,14
10791,2023-03-26 15:00:00,102,290,14,10,674,494,180,6
10792,2023-03-26 16:00:00,134,138,10,12,659,521,138,12
10793,2023-03-26 17:00:00,112,238,5,13,640,565,75,5
10794,2023-03-26 18:00:00,115,107,11,11,520,382,138,6
10795,2023-03-26 19:00:00,117,125,7,12,693,558,135,12
10796,2023-03-26 20:00:00,86,163,11,17,723,586,137,12
10797,2023-03-26 21:00:00,87,283,14,15,571,423,148,6
10798,2023-03-26 22:00:00,53,120,12,18,508,397,111,10
10799,2023-03-26 23:00:00,93,177,12,11,750,647,103,14
10800,2023-03-27 00:00:00,125,138,7,15,769,623,146,7
10801,2023-03-27 01:00:00,61,156,6,13,746,668,78,14
10802,2023-03-27 02:00:00,93,118,5,17,614,533,81,10
10803,2023-03-27 03:00:00,74,172,6,13,779,571,208,7
10804,2023-03-27 04:00:00,71,149,9,16,790,679,111,8
10805,2023-03-27 05:00:00,109,167,14,15,765,640,125,7
10806,2023-03-27 06:00:00,80,215,12,18,568,449,119,5
10807,2023-03-27 07:00:00,101,116,6,10,760,547,213,12
10808,2023-03-27 08:00:00,145,177,12,19,750,594,156,7
10809,2023-03-27 09:00:00,59,161,10,10,755,591,164,6
10810,2023-03-27 10:00:00,124,283,10,16,689,616,73,14
10811,2023-03-27 11:00:00,97,270,13,15,788,569,219,11
10812,2023-03-27 12:00:00,137,245,12,14,725,520,205,7
10813,2023-03-27 13:00:00,90,256,12,12,761,598,163,10
10814,2023-03-27 14:00:00,71,107,10,16,799,703,96,9
10815,2023-03-27 15:00:00,102,248,14,10,602,529,73,13
10816,2023-03-27 16:00:00,119,235,10,13,782,644,138,11
10817,2023-03-27 17:00:00,67,259,5,12,701,547,154,9
10818,2023-03-27 18:00:00,56,143,6,14,508,451,57,6
10819,2023-03-27 19:00:00,67,108,11,19,734,633,101,11
10820,2023-03-27 20:00:00,115,267,11,13,509,406,103,10
10821,2023-03-27 21:00:00,146,292,8,16,572,407,165,11
10822,2023-03-27 22:00:00,94,273,6,14,633,534,99,5
10823,2023-03-27 23:00:00,70,104,6,14,564,462,102,10
10824,2023-03-28 00:00:00,128,298,5,18,691,610,81,8
10825,2023-03-28 01:00:00,104,256,5,15,736,617,119,14
10826,2023-03-28 02:00:00,80,226,9,10,721,621,100,13
10827,2023-03-28 03:00:00,139,293,10,14,773,669,104,8
10828,2023-03-28 04:00:00,67,204,10,19,530,473,57,14
10829,2023-03-28 05:00:00,88,166,7,19,584,464,120,9
10830,2023-03-28 06:00:00,96,258,8,17,716,582,134,12
10831,2023-03-28 07:00:00,127,127,7,18,674,599,75,12
10832,2023-03-28 08:00:00,112,103,14,13,703,534,169,10
10833,2023-03-28 09:00:00,146,284,8,17,559,391,168,8
10834,2023-03-28 10:00:00,116,264,7,18,745,633,112,8
10835,2023-03-28 11:00:00,60,271,9,11,640,532,108,9
10836,2023-03-28 12:00:00,113,155,9,18,773,634,139,13
10837,2023-03-28 13:00:00,55,218,14,14,634,450,184,8
10838,2023-03-28 14:00:00,129,246,12,19,578,487,91,6
10839,2023-03-28 15:00:00,76,183,6,11,516,439,77,13
10840,2023-03-28 16:00:00,65,185,13,13,552,448,104,8
10841,2023-03-28 17:00:00,103,134,10,14,788,706,82,14
10842,2023-03-28 18:00:00,104,227,12,19,716,586,130,11
10843,2023-03-28 19:00:00,93,118,10,14,534,469,65,12
10844,2023-03-28 20:00:00,57,187,11,19,532,445,87,14
10845,2023-03-28 21:00:00,123,223,13,11,787,664,123,12
10846,2023-03-28 22:00:00,92,168,9,16,629,510,119,10
10847,2023-03-28 23:00:00,117,191,14,14,699,609,90,7
10848,2023-03-29 00:00:00,54,228,11,16,585,413,172,14
10849,2023-03-29 01:00:00,100,271,14,10,604,479,125,13
10850,2023-03-29 02:00:00,73,282,7,16,577,431,146,10
10851,2023-03-29 03:00:00,87,289,8,14,529,428,101,11
10852,2023-03-29 04:00:00,130,148,14,19,584,459,125,13
10853,2023-03-29 05:00:00,131,297,11,12,693,485,208,14
10854,2023-03-29 06:00:00,136,119,14,18,587,483,104,9
10855,2023-03-29 07:00:00,84,128,8,19,644,516,128,8
10856,2023-03-29 08:00:00,111,172,7,10,637,514,123,8
10857,2023-03-29 09:00:00,64,239,12,12,721,640,81,11
10858,2023-03-29 10:00:00,61,181,14,12,505,401,104,12
10859,2023-03-29 11:00:00,148,169,14,12,752,589,163,12
10860,2023-03-29 12:00:00,60,238,6,11,782,657,125,11
10861,2023-03-29 13:00:00,89,193,12,18,635,466,169,6
10862,2023-03-29 14:00:00,141,177,7,17,568,475,93,14
10863,2023-03-29 15:00:00,50,136,13,14,501,400,101,14
10864,2023-03-29 16:00:00,124,250,6,15,580,428,152,9
10865,2023-03-29 17:00:00,54,152,8,10,581,435,146,6
10866,2023-03-29 18:00:00,70,225,9,17,733,516,217,9
10867,2023-03-29 19:00:00,132,299,8,16,570,461,109,14
10868,2023-03-29 20:00:00,141,254,10,12,628,467,161,13
10869,2023-03-29 21:00:00,127,261,12,16,600,430,170,9
10870,2023-03-29 22:00:00,104,104,6,17,771,623,148,12
10871,2023-03-29 23:00:00,66,130,6,16,780,652,128,13
10872,2023-03-30 00:00:00,117,266,6,11,725,617,108,13
10873,2023-03-30 01:00:00,131,233,12,11,543,478,65,9
10874,2023-03-30 02:00:00,122,218,6,13,733,637,96,13
10875,2023-03-30 03:00:00,56,280,6,17,514,409,105,13
10876,2023-03-30 04:00:00,57,136,12,19,686,556,130,14
10877,2023-03-30 05:00:00,92,204,13,11,588,432,156,13
10878,2023-03-30 06:00:00,111,152,12,12,680,518,162,6
10879,2023-03-30 07:00:00,66,165,9,19,617,459,158,13
10880,2023-03-30 08:00:00,142,257,7,12,522,455,67,6
10881,2023-03-30 09:00:00,88,273,6,16,567,434,133,7
10882,2023-03-30 10:00:00,147,167,10,13,565,443,122,10
10883,2023-03-30 11:00:00,115,128,8,11,686,521,165,9
10884,2023-03-30 12:00:00,80,180,9,11,563,505,58,7
10885,2023-03-30 13:00:00,132,218,12,13,739,663,76,10
10886,2023-03-30 14:00:00,89,122,6,15,754,572,182,10
10887,2023-03-30 15:00:00,124,105,11,13,589,507,82,8
10888,2023-03-30 16:00:00,68,223,6,15,799,649,150,9
10889,2023-03-30 17:00:00,88,257,14,16,558,481,77,11
10890,2023-03-30 18:00:00,59,296,13,14,682,552,130,14
10891,2023-03-30 19:00:00,74,249,10,12,633,559,74,11
10892,2023-03-30 20:00:00,105,169,12,15,680,478,202,12
10893,2023-03-30 21:00:00,109,137,10,15,773,657,116,11
10894,2023-03-30 22:00:00,59,202,6,18,638,564,74,8
10895,2023-03-30 23:00:00,91,135,11,17,757,627,130,12
10896,2023-03-31 00:00:00,144,145,10,13,780,578,202,12
10897,2023-03-31 01:00:00,116,158,13,14,573,408,165,7
10898,2023-03-31 02:00:00,111,145,10,17,761,533,228,7
10899,2023-03-31 03:00:00,65,165,9,14,774,569,205,5
10900,2023-03-31 04:00:00,95,123,12,10,670,550,120,14
10901,2023-03-31 05:00:00,84,116,6,11,731,641,90,6
10902,2023-03-31 06:00:00,59,125,10,14,673,503,170,12
10903,2023-03-31 07:00:00,122,240,12,11,768,604,164,6
10904,2023-03-31 08:00:00,99,185,13,11,605,544,61,13
10905,2023-03-31 09:00:00,95,154,9,12,604,485,119,14
10906,2023-03-31 10:00:00,115,146,11,19,691,588,103,10
10907,2023-03-31 11:00:00,65,111,9,16,737,603,134,7
10908,2023-03-31 12:00:00,134,103,8,11,505,442,63,12
10909,2023-03-31 13:00:00,101,112,7,18,756,606,150,13
10910,2023-03-31 14:00:00,92,283,9,19,637,530,107,11
10911,2023-03-31 15:00:00,90,203,14,11,700,509,191,9
10912,2023-03-31 16:00:00,98,235,5,11,606,471,135,11
10913,2023-03-31 17:00:00,99,295,9,19,558,483,75,5
10914,2023-03-31 18:00:00,81,229,9,18,567,427,140,12
10915,2023-03-31 19:00:00,51,151,14,18,763,673,90,13
10916,2023-03-31 20:00:00,145,141,13,12,519,435,84,8
10917,2023-03-31 21:00:00,60,146,7,19,612,488,124,12
10918,2023-03-31 22:00:00,108,166,13,18,592,496,96,13
10919,2023-03-31 23:00:00,54,194,12,15,608,497,111,10
10920,2023-04-01 00:00:00,71,160,13,17,504,379,125,10
10921,2023-04-01 01:00:00,127,226,9,18,538,438,100,6
10922,2023-04-01 02:00:00,53,247,9,18,761,668,93,8
10923,2023-04-01 03:00:00,130,272,8,18,629,536,93,11
10924,2023-04-01 04:00:00,141,214,11,10,595,462,133,13
10925,2023-04-01 05:00:00,107,288,7,10,519,431,88,5
10926,2023-04-01 06:00:00,95,139,14,10,520,458,62,13
10927,2023-04-01 07:00:00,57,178,7,12,503,448,55,5
10928,2023-04-01 08:00:00,149,129,14,16,509,366,143,11
10929,2023-04-01 09:00:00,144,235,6,15,741,586,155,14
10930,2023-04-01 10:00:00,109,113,8,14,511,422,89,10
10931,2023-04-01 11:00:00,90,116,9,18,574,473,101,10
10932,2023-04-01 12:00:00,107,280,6,19,764,546,218,8
10933,2023-04-01 13:00:00,145,144,11,16,548,426,122,12
10934,2023-04-01 14:00:00,142,137,14,18,602,517,85,5
10935,2023-04-01 15:00:00,117,148,12,16,781,686,95,6
10936,2023-04-01 16:00:00,145,172,9,16,782,664,118,7
10937,2023-04-01 17:00:00,131,162,6,19,570,450,120,5
10938,2023-04-01 18:00:00,98,154,6,16,708,574,134,13
10939,2023-04-01 19:00:00,111,207,12,14,577,428,149,6
10940,2023-04-01 20:00:00,115,112,9,10,740,649,91,7
10941,2023-04-01 21:00:00,62,220,6,14,680,594,86,11
10942,2023-04-01 22:00:00,118,248,6,18,677,529,148,10
10943,2023-04-01 23:00:00,69,161,13,13,660,496,164,13
10944,2023-04-02 00:00:00,103,219,8,14,547,484,63,13
10945,2023-04-02 01:00:00,65,265,14,11,732,579,153,12
10946,2023-04-02 02:00:00,115,181,11,11,604,464,140,13
10947,2023-04-02 03:00:00,106,151,11,13,646,512,134,11
10948,2023-04-02 04:00:00,149,195,6,11,570,494,76,13
10949,2023-04-02 05:00:00,110,205,13,13,743,568,175,5
10950,2023-04-02 06:00:00,65,298,10,17,582,482,100,9
10951,2023-04-02 07:00:00,88,101,13,13,743,585,158,10
10952,2023-04-02 08:00:00,78,140,12,12,619,534,85,13
10953,2023-04-02 09:00:00,100,206,7,17,588,448,140,13
10954,2023-04-02 10:00:00,108,204,6,16,737,537,200,5
10955,2023-04-02 11:00:00,90,162,11,14,709,621,88,12
10956,2023-04-02 12:00:00,131,283,13,10,783,662,121,11
10957,2023-04-02 13:00:00,126,251,5,13,745,553,192,13
10958,2023-04-02 14:00:00,91,173,7,10,541,388,153,11
10959,2023-04-02 15:00:00,109,286,10,11,547,454,93,14
10960,2023-04-02 16:00:00,54,279,9,17,646,530,116,12
10961,2023-04-02 17:00:00,89,246,14,12,676,564,112,6
10962,2023-04-02 18:00:00,115,148,9,10,702,573,129,10
10963,2023-04-02 19:00:00,73,239,5,12,716,580,136,12
10964,2023-04-02 20:00:00,145,174,7,16,757,562,195,10
10965,2023-04-02 21:00:00,81,198,9,16,517,455,62,11
10966,2023-04-02 22:00:00,99,239,10,10,557,430,127,11
10967,2023-04-02 23:00:00,139,108,11,11,747,559,188,10
10968,2023-04-03 00:00:00,114,103,12,19,516,365,151,9
10969,2023-04-03 01:00:00,142,273,11,17,619,490,129,14
10970,2023-04-03 02:00:00,111,289,13,14,636,482,154,14
10971,2023-04-03 03:00:00,76,275,11,16,583,492,91,8
10972,2023-04-03 04:00:00,92,189,5,11,606,516,90,14
10973,2023-04-03 05:00:00,121,186,13,10,599,484,115,7
10974,2023-04-03 06:00:00,68,112,12,15,682,559,123,6
10975,2023-04-03 07:00:00,97,214,12,10,596,440,156,13
10976,2023-04-03 08:00:00,118,294,12,18,569,457,112,12
10977,2023-04-03 09:00:00,144,178,12,16,640,552,88,14
10978,2023-04-03 10:00:00,144,267,8,12,674,497,177,14
10979,2023-04-03 11:00:00,95,275,12,15,672,477,195,7
10980,2023-04-03 12:00:00,143,127,12,17,624,532,92,12
10981,2023-04-03 13:00:00,108,247,7,13,661,479,182,7
10982,2023-04-03 14:00:00,62,256,9,15,665,468,197,8
10983,2023-04-03 15:00:00,131,268,11,16,691,602,89,14
10984,2023-04-03 16:00:00,125,223,14,11,678,502,176,11
10985,2023-04-03 17:00:00,107,168,14,11,733,602,131,11
10986,2023-04-03 18:00:00,88,209,14,13,500,400,100,7
10987,2023-04-03 19:00:00,114,129,5,15,511,452,59,5
10988,2023-04-03 20:00:00,92,263,13,18,785,603,182,14
10989,2023-04-03 21:00:00,102,268,11,13,605,478,127,9
10990,2023-04-03 22:00:00,76,173,13,15,516,394,122,13
10991,2023-04-03 23:00:00,115,141,7,13,748,666,82,14
10992,2023-04-04 00:00:00,64,108,14,17,634,531,103,9
10993,2023-04-04 01:00:00,128,130,12,11,510,372,138,13
10994,2023-04-04 02:00:00,136,295,6,15,696,528,168,13
10995,2023-04-04 03:00:00,61,156,5,19,635,489,146,8
10996,2023-04-04 04:00:00,81,265,14,12,519,402,117,11
10997,2023-04-04 05:00:00,94,135,12,10,661,569,92,11
10998,2023-04-04 06:00:00,56,147,13,13,756,534,222,7
10999,2023-04-04 07:00:00,103,179,9,12,529,386,143,7
11000,2023-04-04 08:00:00,92,186,11,11,646,509,137,6
11001,2023-04-04 09:00:00,114,258,9,19,529,390,139,5
11002,2023-04-04 10:00:00,140,148,12,11,660,494,166,5
11003,2023-04-04 11:00:00,53,183,6,16,537,422,115,6
11004,2023-04-04 12:00:00,101,212,12,17,607,507,100,10
11005,2023-04-04 13:00:00,104,145,9,14,671,573,98,5
11006,2023-04-04 14:00:00,64,130,9,10,505,357,148,10
11007,2023-04-04 15:00:00,123,196,6,10,526,375,151,14
11008,2023-04-04 16:00:00,74,177,6,13,636,477,159,14
11009,2023-04-04 17:00:00,99,212,11,17,668,478,190,13
11010,2023-04-04 18:00:00,87,216,12,13,785,646,139,9
11011,2023-04-04 19:00:00,122,152,9,19,697,556,141,6
11012,2023-04-04 20:00:00,110,115,13,11,700,517,183,13
11013,2023-04-04 21:00:00,130,106,14,15,798,631,167,13
11014,2023-04-04 22:00:00,100,166,14,16,645,504,141,11
11015,2023-04-04 23:00:00,147,140,11,17,655,532,123,12
11016,2023-04-05 00:00:00,76,166,12,18,575,417,158,14
11017,2023-04-05 01:00:00,60,161,11,18,715,510,205,5
11018,2023-04-05 02:00:00,137,245,6,12,592,438,154,6
11019,2023-04-05 03:00:00,149,238,10,18,675,476,199,7
11020,2023-04-05 04:00:00,80,265,11,14,753,668,85,14
11021,2023-04-05 05:00:00,127,143,11,10,669,507,162,5
11022,2023-04-05 06:00:00,147,222,7,16,769,599,170,7
11023,2023-04-05 07:00:00,139,115,8,15,537,390,147,10
11024,2023-04-05 08:00:00,87,127,10,14,788,619,169,9
11025,2023-04-05 09:00:00,77,141,8,17,599,522,77,12
11026,2023-04-05 10:00:00,82,107,5,13,731,552,179,7
11027,2023-04-05 11:00:00,102,251,8,16,526,400,126,5
11028,2023-04-05 12:00:00,83,136,9,10,623,519,104,14
11029,2023-04-05 13:00:00,116,296,8,18,734,575,159,13
11030,2023-04-05 14:00:00,76,276,14,10,702,508,194,8
11031,2023-04-05 15:00:00,51,254,8,16,612,444,168,11
11032,2023-04-05 16:00:00,140,294,14,11,634,462,172,5
11033,2023-04-05 17:00:00,141,257,8,19,755,576,179,5
11034,2023-04-05 18:00:00,99,265,7,10,763,542,221,12
11035,2023-04-05 19:00:00,148,115,7,15,654,467,187,11
11036,2023-04-05 20:00:00,66,118,13,13,726,598,128,12
11037,2023-04-05 21:00:00,108,147,5,14,788,571,217,13
11038,2023-04-05 22:00:00,82,142,5,11,563,401,162,9
11039,2023-04-05 23:00:00,85,278,14,19,646,527,119,14
11040,2023-04-06 00:00:00,98,176,6,14,550,417,133,10
11041,2023-04-06 01:00:00,56,125,10,17,560,482,78,12
11042,2023-04-06 02:00:00,127,290,12,14,746,577,169,9
11043,2023-04-06 03:00:00,73,218,10,19,629,552,77,13
11044,2023-04-06 04:00:00,115,283,14,10,579,416,163,12
11045,2023-04-06 05:00:00,120,138,13,10,585,462,123,11
11046,2023-04-06 06:00:00,66,232,12,16,587,485,102,7
11047,2023-04-06 07:00:00,63,247,6,16,610,475,135,12
11048,2023-04-06 08:00:00,84,119,5,14,638,513,125,14
11049,2023-04-06 09:00:00,103,281,9,15,724,558,166,9
11050,2023-04-06 10:00:00,149,105,12,13,554,495,59,11
11051,2023-04-06 11:00:00,64,292,7,11,745,581,164,10
11052,2023-04-06 12:00:00,82,153,5,18,759,625,134,5
11053,2023-04-06 13:00:00,66,227,6,14,594,508,86,9
11054,2023-04-06 14:00:00,117,244,14,17,772,657,115,11
11055,2023-04-06 15:00:00,134,158,13,16,536,375,161,12
11056,2023-04-06 16:00:00,110,267,14,11,584,429,155,9
11057,2023-04-06 17:00:00,91,280,12,12,518,433,85,12
11058,2023-04-06 18:00:00,135,142,9,11,504,435,69,6
11059,2023-04-06 19:00:00,123,209,13,12,738,558,180,7
11060,2023-04-06 20:00:00,139,136,12,10,588,518,70,10
11061,2023-04-06 21:00:00,67,218,14,10,701,554,147,14
11062,2023-04-06 22:00:00,64,263,5,15,755,541,214,12
11063,2023-04-06 23:00:00,76,207,12,15,633,485,148,11
11064,2023-04-07 00:00:00,59,248,13,10,742,603,139,7
11065,2023-04-07 01:00:00,78,212,10,18,584,471,113,7
11066,2023-04-07 02:00:00,95,107,11,14,541,423,118,6
11067,2023-04-07 03:00:00,134,171,12,13,653,473,180,14
11068,2023-04-07 04:00:00,84,161,8,15,631,460,171,13
11069,2023-04-07 05:00:00,65,137,10,15,784,692,92,8
11070,2023-04-07 06:00:00,90,276,12,13,588,430,158,6
11071,2023-04-07 07:00:00,96,298,5,16,610,442,168,14
11072,2023-04-07 08:00:00,67,111,6,12,624,451,173,12
11073,2023-04-07 09:00:00,142,237,6,19,775,608,167,11
11074,2023-04-07 10:00:00,50,193,6,11,558,398,160,11
11075,2023-04-07 11:00:00,134,217,12,12,620,438,182,8
11076,2023-04-07 12:00:00,87,270,8,18,793,556,237,5
11077,2023-04-07 13:00:00,89,262,12,10,578,496,82,10
11078,2023-04-07 14:00:00,69,222,12,16,724,622,102,5
11079,2023-04-07 15:00:00,129,133,5,15,510,406,104,13
11080,2023-04-07 16:00:00,96,153,11,14,680,542,138,6
11081,2023-04-07 17:00:00,142,268,5,15,703,574,129,9
11082,2023-04-07 18:00:00,89,250,8,11,644,498,146,9
11083,2023-04-07 19:00:00,67,178,5,14,736,646,90,10
11084,2023-04-07 20:00:00,85,164,13,18,638,514,124,5
11085,2023-04-07 21:00:00,90,139,12,17,710,510,200,11
11086,2023-04-07 22:00:00,68,180,6,11,777,627,150,12
11087,2023-04-07 23:00:00,130,110,10,12,760,560,200,7
11088,2023-04-08 00:00:00,56,223,11,13,528,414,114,8
11089,2023-04-08 01:00:00,137,180,12,18,542,438,104,7
11090,2023-04-08 02:00:00,146,281,9,13,678,546,132,6
11091,2023-04-08 03:00:00,108,283,8,11,529,393,136,14
11092,2023-04-08 04:00:00,124,265,12,14,566,449,117,13
11093,2023-04-08 05:00:00,51,240,7,17,707,544,163,12
11094,2023-04-08 06:00:00,94,229,13,12,793,661,132,8
11095,2023-04-08 07:00:00,111,296,10,11,530,396,134,14
11096,2023-04-08 08:00:00,111,260,7,17,746,619,127,11
11097,2023-04-08 09:00:00,109,194,8,10,695,558,137,9
11098,2023-04-08 10:00:00,130,173,9,10,591,479,112,7
11099,2023-04-08 11:00:00,120,238,10,15,575,462,113,9
11100,2023-04-08 12:00:00,138,129,5,14,553,453,100,11
11101,2023-04-08 13:00:00,111,153,10,19,701,573,128,8
11102,2023-04-08 14:00:00,133,144,5,18,546,398,148,8
11103,2023-04-08 15:00:00,70,177,13,15,701,606,95,11
11104,2023-04-08 16:00:00,97,205,11,12,715,567,148,14
11105,2023-04-08 17:00:00,77,206,7,13,515,379,136,8
11106,2023-04-08 18:00:00,139,203,7,13,524,450,74,6
11107,2023-04-08 19:00:00,91,279,13,15,777,609,168,14
11108,2023-04-08 20:00:00,54,186,5,13,512,457,55,7
11109,2023-04-08 21:00:00,52,168,13,15,696,624,72,7
11110,2023-04-08 22:00:00,140,216,8,14,750,604,146,13
11111,2023-04-08 23:00:00,70,139,8,10,646,483,163,14
11112,2023-04-09 00:00:00,65,288,14,12,596,461,135,13
11113,2023-04-09 01:00:00,117,178,6,16,777,618,159,11
11114,2023-04-09 02:00:00,146,286,8,17,522,444,78,10
11115,2023-04-09 03:00:00,88,277,6,14,646,537,109,12
11116,2023-04-09 04:00:00,122,206,13,18,677,603,74,14
11117,2023-04-09 05:00:00,77,188,9,16,799,627,172,9
11118,2023-04-09 06:00:00,147,143,8,18,693,531,162,14
11119,2023-04-09 07:00:00,69,122,13,19,592,494,98,11
11120,2023-04-09 08:00:00,54,159,14,13,559,412,147,6
11121,2023-04-09 09:00:00,82,248,11,11,634,465,169,14
11122,2023-04-09 10:00:00,116,161,6,11,619,542,77,8
11123,2023-04-09 11:00:00,127,162,7,10,657,499,158,14
11124,2023-04-09 12:00:00,136,144,12,10,696,514,182,6
11125,2023-04-09 13:00:00,55,130,11,15,670,538,132,9
11126,2023-04-09 14:00:00,141,191,12,15,693,608,85,8
11127,2023-04-09 15:00:00,119,270,13,15,707,537,170,5
11128,2023-04-09 16:00:00,127,261,7,19,656,477,179,5
11129,2023-04-09 17:00:00,77,203,8,19,621,528,93,7
11130,2023-04-09 18:00:00,110,182,7,12,796,634,162,7
11131,2023-04-09 19:00:00,96,166,13,11,642,525,117,6
11132,2023-04-09 20:00:00,141,218,14,16,609,482,127,11
11133,2023-04-09 21:00:00,69,216,7,18,571,439,132,14
11134,2023-04-09 22:00:00,126,294,12,17,639,519,120,8
11135,2023-04-09 23:00:00,108,262,10,17,556,412,144,7
11136,2023-04-10 00:00:00,119,119,11,16,520,417,103,6
11137,2023-04-10 01:00:00,90,191,14,17,772,644,128,6
11138,2023-04-10 02:00:00,63,281,8,16,516,362,154,10
11139,2023-04-10 03:00:00,127,230,13,14,506,377,129,8
11140,2023-04-10 04:00:00,132,164,13,15,693,531,162,10
11141,2023-04-10 05:00:00,105,207,5,17,705,628,77,11
11142,2023-04-10 06:00:00,129,252,13,16,744,565,179,10
11143,2023-04-10 07:00:00,125,218,6,14,638,481,157,6
11144,2023-04-10 08:00:00,104,262,14,19,548,406,142,14
11145,2023-04-10 09:00:00,106,177,11,12,658,508,150,14
11146,2023-04-10 10:00:00,92,180,9,11,723,608,115,6
11147,2023-04-10 11:00:00,59,239,7,19,561,412,149,11
11148,2023-04-10 12:00:00,104,270,6,15,687,507,180,13
11149,2023-04-10 13:00:00,109,259,7,13,743,572,171,11
11150,2023-04-10 14:00:00,123,112,12,11,654,520,134,9
11151,2023-04-10 15:00:00,107,113,8,14,672,526,146,9
11152,2023-04-10 16:00:00,75,124,13,11,676,556,120,14
11153,2023-04-10 17:00:00,81,253,11,15,508,397,111,10
11154,2023-04-10 18:00:00,98,143,5,14,774,557,217,14
11155,2023-04-10 19:00:00,64,299,12,19,730,543,187,6
11156,2023-04-10 20:00:00,72,131,8,17,600,465,135,10
11157,2023-04-10 21:00:00,133,106,13,13,597,467,130,8
11158,2023-04-10 22:00:00,142,121,14,15,623,521,102,10
11159,2023-04-10 23:00:00,119,165,8,16,711,625,86,13
11160,2023-04-11 00:00:00,69,251,6,14,509,439,70,5
11161,2023-04-11 01:00:00,112,141,13,12,519,447,72,10
11162,2023-04-11 02:00:00,61,113,11,19,671,500,171,7
11163,2023-04-11 03:00:00,127,136,11,19,623,529,94,11
11164,2023-04-11 04:00:00,94,279,12,14,597,423,174,9
11165,2023-04-11 05:00:00,86,104,13,19,561,412,149,13
11166,2023-04-11 06:00:00,126,219,10,17,784,605,179,5
11167,2023-04-11 07:00:00,128,226,10,18,530,426,104,6
11168,2023-04-11 08:00:00,108,134,5,15,510,411,99,6
11169,2023-04-11 09:00:00,100,166,14,16,516,399,117,10
11170,2023-04-11 10:00:00,133,146,8,14,744,558,186,5
11171,2023-04-11 11:00:00,58,111,14,12,511,387,124,10
11172,2023-04-11 12:00:00,123,159,7,14,583,515,68,10
11173,2023-04-11 13:00:00,131,151,10,14,679,477,202,14
11174,2023-04-11 14:00:00,57,103,8,11,783,595,188,14
11175,2023-04-11 15:00:00,124,151,12,16,682,511,171,14
11176,2023-04-11 16:00:00,81,165,7,19,601,475,126,13
11177,2023-04-11 17:00:00,116,221,11,15,737,609,128,7
11178,2023-04-11 18:00:00,128,175,12,19,790,589,201,11
11179,2023-04-11 19:00:00,93,124,7,10,661,577,84,9
11180,2023-04-11 20:00:00,135,148,5,18,520,385,135,9
11181,2023-04-11 21:00:00,128,249,10,17,516,372,144,9
11182,2023-04-11 22:00:00,71,168,8,14,783,568,215,6
11183,2023-04-11 23:00:00,86,111,8,19,742,642,100,10
11184,2023-04-12 00:00:00,106,103,5,10,591,486,105,9
11185,2023-04-12 01:00:00,99,157,6,13,559,414,145,12
11186,2023-04-12 02:00:00,87,208,10,17,725,586,139,12
11187,2023-04-12 03:00:00,109,165,11,12,651,511,140,6
11188,2023-04-12 04:00:00,134,166,6,14,547,490,57,9
11189,2023-04-12 05:00:00,145,151,14,11,664,510,154,9
11190,2023-04-12 06:00:00,89,160,8,12,523,393,130,13
11191,2023-04-12 07:00:00,113,102,10,18,684,550,134,10
11192,2023-04-12 08:00:00,84,188,5,18,674,575,99,13
11193,2023-04-12 09:00:00,98,241,8,14,746,610,136,13
11194,2023-04-12 10:00:00,82,275,5,14,631,514,117,13
11195,2023-04-12 11:00:00,148,179,14,16,538,480,58,9
11196,2023-04-12 12:00:00,141,188,12,11,758,565,193,11
11197,2023-04-12 13:00:00,77,196,8,19,556,409,147,10
11198,2023-04-12 14:00:00,135,158,6,10,510,392,118,6
11199,2023-04-12 15:00:00,135,119,7,11,603,493,110,10
11200,2023-04-12 16:00:00,58,252,6,17,595,444,151,6
11201,2023-04-12 17:00:00,113,226,5,13,678,529,149,12
11202,2023-04-12 18:00:00,112,175,5,10,652,574,78,8
11203,2023-04-12 19:00:00,124,299,10,14,690,490,200,11
11204,2023-04-12 20:00:00,98,241,12,18,542,486,56,14
11205,2023-04-12 21:00:00,90,203,5,13,771,642,129,11
11206,2023-04-12 22:00:00,108,213,9,15,780,584,196,6
11207,2023-04-12 23:00:00,93,153,5,13,572,488,84,6
11208,2023-04-13 00:00:00,68,145,9,11,503,378,125,9
11209,2023-04-13 01:00:00,133,233,13,13,731,528,203,7
11210,2023-04-13 02:00:00,145,151,10,16,593,523,70,8
11211,2023-04-13 03:00:00,91,133,7,18,611,500,111,9
11212,2023-04-13 04:00:00,104,145,8,13,701,554,147,8
11213,2023-04-13 05:00:00,67,231,14,15,571,512,59,10
11214,2023-04-13 06:00:00,139,225,6,15,566,495,71,5
11215,2023-04-13 07:00:00,142,146,5,10,608,520,88,11
11216,2023-04-13 08:00:00,51,146,12,11,657,578,79,5
11217,2023-04-13 09:00:00,85,280,7,10,758,636,122,6
11218,2023-04-13 10:00:00,58,270,10,19,568,442,126,5
11219,2023-04-13 11:00:00,121,190,10,12,660,591,69,7
11220,2023-04-13 12:00:00,66,266,7,14,686,527,159,10
11221,2023-04-13 13:00:00,82,190,13,15,702,532,170,11
11222,2023-04-13 14:00:00,113,182,12,11,758,671,87,13
11223,2023-04-13 15:00:00,52,296,6,14,629,533,96,13
11224,2023-04-13 16:00:00,78,237,11,16,528,458,70,14
11225,2023-04-13 17:00:00,125,280,6,10,602,473,129,10
11226,2023-04-13 18:00:00,93,118,14,10,771,564,207,14
11227,2023-04-13 19:00:00,88,260,6,19,519,372,147,10
11228,2023-04-13 20:00:00,114,290,6,17,785,601,184,6
11229,2023-04-13 21:00:00,81,119,6,14,763,676,87,6
11230,2023-04-13 22:00:00,118,108,14,15,757,598,159,6
11231,2023-04-13 23:00:00,105,231,9,14,785,554,231,11
11232,2023-04-14 00:00:00,139,284,13,14,733,600,133,10
11233,2023-04-14 01:00:00,62,279,12,13,545,416,129,7
11234,2023-04-14 02:00:00,101,195,10,14,733,607,126,10
11235,2023-04-14 03:00:00,68,183,14,11,760,659,101,5
11236,2023-04-14 04:00:00,120,296,8,17,639,529,110,14
11237,2023-04-14 05:00:00,106,219,12,14,718,634,84,14
11238,2023-04-14 06:00:00,81,142,13,15,570,469,101,8
11239,2023-04-14 07:00:00,138,262,13,14,623,473,150,7
11240,2023-04-14 08:00:00,135,249,12,12,539,471,68,10
11241,2023-04-14 09:00:00,70,182,9,15,741,544,197,9
11242,2023-04-14 10:00:00,71,240,7,15,544,483,61,13
11243,2023-04-14 11:00:00,92,179,9,10,789,685,104,11
11244,2023-04-14 12:00:00,127,123,11,11,507,381,126,8
11245,2023-04-14 13:00:00,104,246,7,15,618,488,130,14
11246,2023-04-14 14:00:00,90,263,9,16,549,473,76,10
11247,2023-04-14 15:00:00,129,224,12,14,629,508,121,5
11248,2023-04-14 16:00:00,106,125,13,16,622,457,165,10
11249,2023-04-14 17:00:00,71,265,6,16,546,489,57,12
11250,2023-04-14 18:00:00,65,285,9,18,692,519,173,10
11251,2023-04-14 19:00:00,129,126,8,11,507,405,102,5
11252,2023-04-14 20:00:00,127,278,8,10,565,460,105,10
11253,2023-04-14 21:00:00,80,218,7,12,727,582,145,6
11254,2023-04-14 22:00:00,72,181,14,15,573,426,147,11
11255,2023-04-14 23:00:00,62,291,5,10,640,486,154,13
11256,2023-04-15 00:00:00,139,119,6,13,504,427,77,13
11257,2023-04-15 01:00:00,61,245,8,12,621,520,101,7
11258,2023-04-15 02:00:00,105,191,13,15,709,576,133,9
11259,2023-04-15 03:00:00,118,134,6,13,735,600,135,6
11260,2023-04-15 04:00:00,115,113,8,12,539,424,115,7
11261,2023-04-15 05:00:00,131,111,8,19,551,487,64,6
11262,2023-04-15 06:00:00,136,216,9,13,568,399,169,12
11263,2023-04-15 07:00:00,54,299,7,11,569,475,94,13
11264,2023-04-15 08:00:00,77,280,6,11,500,375,125,8
11265,2023-04-15 09:00:00,120,188,9,16,730,577,153,6
11266,2023-04-15 10:00:00,88,268,8,11,546,438,108,12
11267,2023-04-15 11:00:00,147,157,13,12,501,357,144,5
11268,2023-04-15 12:00:00,82,275,12,14,768,633,135,6
11269,2023-04-15 13:00:00,121,108,8,11,651,526,125,13
11270,2023-04-15 14:00:00,60,296,8,17,668,569,99,12
11271,2023-04-15 15:00:00,84,171,10,17,541,394,147,11
11272,2023-04-15 16:00:00,100,281,9,10,711,634,77,13
11273,2023-04-15 17:00:00,93,119,9,15,718,545,173,10
11274,2023-04-15 18:00:00,79,257,8,12,697,592,105,13
11275,2023-04-15 19:00:00,112,109,9,10,722,611,111,13
11276,2023-04-15 20:00:00,57,122,5,17,543,462,81,10
11277,2023-04-15 21:00:00,58,233,6,19,522,433,89,11
11278,2023-04-15 22:00:00,124,125,10,16,508,370,138,12
11279,2023-04-15 23:00:00,80,184,7,19,650,531,119,7
11280,2023-04-16 00:00:00,109,199,6,10,591,421,170,6
11281,2023-04-16 01:00:00,133,281,6,18,646,460,186,14
11282,2023-04-16 02:00:00,111,119,8,19,789,620,169,7
11283,2023-04-16 03:00:00,94,279,6,15,620,500,120,14
11284,2023-04-16 04:00:00,117,188,8,15,601,433,168,13
11285,2023-04-16 05:00:00,71,111,6,15,702,511,191,9
11286,2023-04-16 06:00:00,116,211,14,14,590,516,74,11
11287,2023-04-16 07:00:00,133,299,8,12,634,455,179,13
11288,2023-04-16 08:00:00,85,277,12,14,665,474,191,10
11289,2023-04-16 09:00:00,58,288,14,10,772,569,203,13
11290,2023-04-16 10:00:00,95,269,7,10,698,524,174,10
11291,2023-04-16 11:00:00,91,187,8,15,620,545,75,14
11292,2023-04-16 12:00:00,126,263,9,17,516,454,62,9
11293,2023-04-16 13:00:00,87,196,6,12,797,657,140,14
11294,2023-04-16 14:00:00,66,232,11,17,749,623,126,10
11295,2023-04-16 15:00:00,146,147,5,11,729,565,164,10
11296,2023-04-16 16:00:00,72,149,6,16,517,420,97,13
11297,2023-04-16 17:00:00,79,187,11,12,722,646,76,8
11298,2023-04-16 18:00:00,147,105,10,13,631,468,163,9
11299,2023-04-16 19:00:00,97,251,10,18,682,537,145,6
11300,2023-04-16 20:00:00,132,226,12,11,586,485,101,6
11301,2023-04-16 21:00:00,51,168,5,12,659,527,132,8
11302,2023-04-16 22:00:00,120,215,14,17,750,670,80,10
11303,2023-04-16 23:00:00,127,146,13,10,636,528,108,9
11304,2023-04-17 00:00:00,82,178,12,16,615,452,163,9
11305,2023-04-17 01:00:00,149,193,10,14,504,380,124,8
11306,2023-04-17 02:00:00,57,163,9,18,662,517,145,6
11307,2023-04-17 03:00:00,64,291,6,18,780,571,209,11
11308,2023-04-17 04:00:00,127,247,12,14,658,542,116,9
11309,2023-04-17 05:00:00,145,161,13,14,664,571,93,8
11310,2023-04-17 06:00:00,101,214,10,16,756,593,163,10
11311,2023-04-17 07:00:00,72,288,7,16,727,643,84,9
11312,2023-04-17 08:00:00,100,142,7,19,747,569,178,12
11313,2023-04-17 09:00:00,110,161,9,15,618,434,184,13
11314,2023-04-17 10:00:00,137,126,10,10,732,513,219,9
11315,2023-04-17 11:00:00,144,161,8,15,699,558,141,13
11316,2023-04-17 12:00:00,70,126,9,11,763,658,105,11
11317,2023-04-17 13:00:00,73,218,5,16,646,581,65,10
11318,2023-04-17 14:00:00,111,230,10,13,560,470,90,7
11319,2023-04-17 15:00:00,101,192,9,10,543,380,163,14
11320,2023-04-17 16:00:00,57,259,12,16,724,597,127,8
11321,2023-04-17 17:00:00,53,139,9,12,718,550,168,9
11322,2023-04-17 18:00:00,84,263,5,14,534,443,91,12
11323,2023-04-17 19:00:00,56,131,12,14,573,474,99,6
11324,2023-04-17 20:00:00,79,121,13,10,616,471,145,10
11325,2023-04-17 21:00:00,147,125,9,18,597,531,66,13
11326,2023-04-17 22:00:00,68,121,10,10,746,586,160,13
11327,2023-04-17 23:00:00,93,263,9,16,504,397,107,8
11328,2023-04-18 00:00:00,60,253,14,12,629,545,84,10
11329,2023-04-18 01:00:00,72,281,12,12,759,675,84,8
11330,2023-04-18 02:00:00,138,209,7,12,693,605,88,9
11331,2023-04-18 03:00:00,93,174,9,18,716,503,213,7
11332,2023-04-18 04:00:00,132,271,10,19,528,467,61,6
11333,2023-04-18 05:00:00,146,161,13,15,536,428,108,14
11334,2023-04-18 06:00:00,115,237,11,11,575,502,73,8
11335,2023-04-18 07:00:00,89,273,12,18,725,606,119,5
11336,2023-04-18 08:00:00,109,253,5,10,722,630,92,13
11337,2023-04-18 09:00:00,78,135,6,15,676,515,161,9
11338,2023-04-18 10:00:00,122,131,13,12,640,503,137,6
11339,2023-04-18 11:00:00,136,155,11,13,716,576,140,12
11340,2023-04-18 12:00:00,104,200,14,10,613,495,118,14
11341,2023-04-18 13:00:00,84,270,11,10,699,573,126,12
11342,2023-04-18 14:00:00,97,298,5,19,523,431,92,7
11343,2023-04-18 15:00:00,92,298,6,18,764,592,172,6
11344,2023-04-18 16:00:00,135,270,14,17,606,533,73,6
11345,2023-04-18 17:00:00,63,143,8,16,740,661,79,8
11346,2023-04-18 18:00:00,75,217,6,15,510,385,125,6
11347,2023-04-18 19:00:00,134,266,12,18,565,466,99,8
11348,2023-04-18 20:00:00,55,172,9,12,775,591,184,14
11349,2023-04-18 21:00:00,75,151,11,16,753,584,169,14
11350,2023-04-18 22:00:00,120,142,13,16,525,427,98,10
11351,2023-04-18 23:00:00,83,258,8,16,761,618,143,6
11352,2023-04-19 00:00:00,93,174,6,11,714,510,204,12
11353,2023-04-19 01:00:00,86,192,8,17,609,497,112,5
11354,2023-04-19 02:00:00,120,141,8,13,635,492,143,10
11355,2023-04-19 03:00:00,101,156,11,15,638,481,157,6
11356,2023-04-19 04:00:00,119,196,12,10,518,414,104,5
11357,2023-04-19 05:00:00,146,148,8,16,699,493,206,13
11358,2023-04-19 06:00:00,143,159,9,11,750,666,84,14
11359,2023-04-19 07:00:00,59,211,10,17,549,426,123,11
11360,2023-04-19 08:00:00,125,276,12,12,526,404,122,14
11361,2023-04-19 09:00:00,127,169,14,15,643,476,167,10
11362,2023-04-19 10:00:00,88,258,10,15,522,446,76,14
11363,2023-04-19 11:00:00,69,145,11,19,666,583,83,13
11364,2023-04-19 12:00:00,57,257,8,11,566,437,129,11
11365,2023-04-19 13:00:00,144,183,11,19,761,594,167,13
11366,2023-04-19 14:00:00,64,282,9,19,629,521,108,9
11367,2023-04-19 15:00:00,126,232,7,18,720,510,210,14
11368,2023-04-19 16:00:00,121,115,5,15,771,689,82,11
11369,2023-04-19 17:00:00,127,251,14,15,719,527,192,14
11370,2023-04-19 18:00:00,125,290,13,15,555,424,131,9
11371,2023-04-19 19:00:00,59,296,11,14,607,447,160,13
11372,2023-04-19 20:00:00,85,113,8,12,583,444,139,7
11373,2023-04-19 21:00:00,140,299,10,17,500,374,126,12
11374,2023-04-19 22:00:00,63,245,13,13,583,417,166,8
11375,2023-04-19 23:00:00,118,271,12,17,798,615,183,5
11376,2023-04-20 00:00:00,106,170,9,17,774,663,111,5
11377,2023-04-20 01:00:00,68,243,12,16,645,475,170,10
11378,2023-04-20 02:00:00,137,266,9,15,623,500,123,5
11379,2023-04-20 03:00:00,142,255,10,19,510,377,133,13
11380,2023-04-20 04:00:00,102,295,8,18,788,608,180,8
11381,2023-04-20 05:00:00,73,119,10,14,799,601,198,12
11382,2023-04-20 06:00:00,81,199,9,12,774,563,211,13
11383,2023-04-20 07:00:00,81,245,12,12,522,432,90,8
11384,2023-04-20 08:00:00,56,214,14,18,768,652,116,7
11385,2023-04-20 09:00:00,141,113,6,18,674,499,175,6
11386,2023-04-20 10:00:00,66,121,11,16,744,575,169,12
11387,2023-04-20 11:00:00,104,103,12,13,648,486,162,7
11388,2023-04-20 12:00:00,98,253,7,14,686,501,185,12
11389,2023-04-20 13:00:00,67,250,5,13,583,470,113,14
11390,2023-04-20 14:00:00,149,173,5,13,646,548,98,7
11391,2023-04-20 15:00:00,125,242,6,19,561,456,105,6
11392,2023-04-20 16:00:00,127,193,9,19,740,659,81,6
11393,2023-04-20 17:00:00,102,138,6,16,684,615,69,9
11394,2023-04-20 18:00:00,86,251,13,18,654,484,170,8
11395,2023-04-20 19:00:00,52,220,6,12,614,513,101,5
11396,2023-04-20 20:00:00,120,276,7,17,768,671,97,9
11397,2023-04-20 21:00:00,88,209,8,14,745,626,119,12
11398,2023-04-20 22:00:00,69,111,11,12,714,634,80,11
11399,2023-04-20 23:00:00,125,124,5,11,689,515,174,7
11400,2023-04-21 00:00:00,90,207,11,16,593,462,131,10
11401,2023-04-21 01:00:00,104,189,10,17,699,547,152,14
11402,2023-04-21 02:00:00,81,119,9,10,566,407,159,11
11403,2023-04-21 03:00:00,121,146,13,18,700,582,118,7
11404,2023-04-21 04:00:00,73,267,5,12,772,558,214,5
11405,2023-04-21 05:00:00,107,185,7,10,790,617,173,12
11406,2023-04-21 06:00:00,63,191,10,17,579,465,114,5
11407,2023-04-21 07:00:00,131,141,8,16,557,490,67,12
11408,2023-04-21 08:00:00,114,136,5,13,503,387,116,14
11409,2023-04-21 09:00:00,64,291,14,11,530,395,135,7
11410,2023-04-21 10:00:00,56,139,9,17,532,381,151,8
11411,2023-04-21 11:00:00,92,241,5,19,546,408,138,9
11412,2023-04-21 12:00:00,128,140,14,11,554,446,108,10
11413,2023-04-21 13:00:00,101,199,13,16,626,493,133,5
11414,2023-04-21 14:00:00,89,200,10,14,578,437,141,9
11415,2023-04-21 15:00:00,119,209,11,13,669,600,69,11
11416,2023-04-21 16:00:00,60,104,13,18,500,421,79,6
11417,2023-04-21 17:00:00,107,210,10,11,612,441,171,13
11418,2023-04-21 18:00:00,56,237,8,18,512,371,141,9
11419,2023-04-21 19:00:00,100,286,10,13,530,462,68,6
11420,2023-04-21 20:00:00,86,285,10,11,561,409,152,6
11421,2023-04-21 21:00:00,101,211,5,11,756,579,177,10
11422,2023-04-21 22:00:00,121,263,14,14,587,503,84,13
11423,2023-04-21 23:00:00,138,245,13,14,551,445,106,11
11424,2023-04-22 00:00:00,103,114,11,10,540,448,92,10
11425,2023-04-22 01:00:00,71,248,7,14,780,676,104,14
11426,2023-04-22 02:00:00,63,235,12,15,634,448,186,5
11427,2023-04-22 03:00:00,68,166,12,16,664,495,169,13
11428,2023-04-22 04:00:00,80,132,13,16,759,674,85,14
11429,2023-04-22 05:00:00,51,273,6,15,743,645,98,9
11430,2023-04-22 06:00:00,101,157,14,19,510,357,153,10
11431,2023-04-22 07:00:00,71,275,6,10,680,529,151,14
11432,2023-04-22 08:00:00,128,244,13,12,759,533,226,6
11433,2023-04-22 09:00:00,141,209,6,15,729,646,83,10
11434,2023-04-22 10:00:00,146,163,7,16,651,535,116,12
11435,2023-04-22 11:00:00,137,249,12,16,798,638,160,5
11436,2023-04-22 12:00:00,130,226,11,11,534,403,131,10
11437,2023-04-22 13:00:00,92,280,8,11,674,589,85,10
11438,2023-04-22 14:00:00,79,191,13,19,786,695,91,13
11439,2023-04-22 15:00:00,77,111,8,15,602,458,144,7
11440,2023-04-22 16:00:00,126,234,13,18,700,618,82,7
11441,2023-04-22 17:00:00,88,269,6,16,626,474,152,7
11442,2023-04-22 18:00:00,105,158,14,19,594,461,133,13
11443,2023-04-22 19:00:00,129,197,9,18,714,622,92,8
11444,2023-04-22 20:00:00,140,125,13,10,680,487,193,11
11445,2023-04-22 21:00:00,117,275,9,12,725,544,181,5
11446,2023-04-22 22:00:00,56,108,10,19,557,418,139,5
11447,2023-04-22 23:00:00,131,234,11,18,603,507,96,9
11448,2023-04-23 00:00:00,81,169,11,19,653,498,155,12
11449,2023-04-23 01:00:00,133,237,8,16,576,474,102,7
11450,2023-04-23 02:00:00,126,185,8,16,637,549,88,11
11451,2023-04-23 03:00:00,89,120,9,10,643,495,148,5
11452,2023-04-23 04:00:00,113,211,12,11,620,458,162,7
11453,2023-04-23 05:00:00,111,141,7,19,528,426,102,10
11454,2023-04-23 06:00:00,105,244,9,12,748,614,134,6
11455,2023-04-23 07:00:00,102,273,10,17,593,524,69,13
11456,2023-04-23 08:00:00,78,162,12,16,646,514,132,10
11457,2023-04-23 09:00:00,50,112,12,15,523,391,132,5
11458,2023-04-23 10:00:00,141,289,12,12,638,477,161,5
11459,2023-04-23 11:00:00,54,218,12,13,704,612,92,7
11460,2023-04-23 12:00:00,66,130,6,11,708,577,131,10
11461,2023-04-23 13:00:00,94,238,11,10,519,420,99,9
11462,2023-04-23 14:00:00,96,237,12,17,781,609,172,5
11463,2023-04-23 15:00:00,85,225,6,18,513,389,124,10
11464,2023-04-23 16:00:00,85,190,8,19,771,589,182,5
11465,2023-04-23 17:00:00,66,269,12,12,726,606,120,8
11466,2023-04-23 18:00:00,130,132,10,10,592,517,75,5
11467,2023-04-23 19:00:00,101,269,14,17,760,567,193,7
11468,2023-04-23 20:00:00,74,288,8,10,722,610,112,8
11469,2023-04-23 21:00:00,90,103,5,13,767,617,150,5
11470,2023-04-23 22:00:00,92,178,11,12,503,362,141,9
11471,2023-04-23 23:00:00,54,287,8,16,573,455,118,12
11472,2023-04-24 00:00:00,105,284,9,12,556,421,135,11
11473,2023-04-24 01:00:00,104,275,11,18,730,530,200,5
11474,2023-04-24 02:00:00,80,116,14,10,511,423,88,6
11475,2023-04-24 03:00:00,59,279,11,18,570,414,156,12
11476,2023-04-24 04:00:00,133,151,7,12,533,419,114,12
11477,2023-04-24 05:00:00,53,181,7,19,764,549,215,10
11478,2023-04-24 06:00:00,137,282,11,16,663,532,131,6
11479,2023-04-24 07:00:00,115,117,11,12,679,603,76,10
11480,2023-04-24 08:00:00,106,213,12,11,580,443,137,14
11481,2023-04-24 09:00:00,120,104,11,18,512,377,135,13
11482,2023-04-24 10:00:00,143,251,9,12,720,614,106,8
11483,2023-04-24 11:00:00,65,238,8,16,614,521,93,13
11484,2023-04-24 12:00:00,137,201,10,12,670,594,76,5
11485,2023-04-24 13:00:00,50,168,14,14,791,647,144,6
11486,2023-04-24 14:00:00,117,180,5,16,717,526,191,6
11487,2023-04-24 15:00:00,71,249,9,13,746,661,85,9
11488,2023-04-24 16:00:00,66,224,12,15,572,411,161,10
11489,2023-04-24 17:00:00,92,265,5,14,643,481,162,8
11490,2023-04-24 18:00:00,93,215,13,15,774,575,199,7
11491,2023-04-24 19:00:00,131,230,10,16,750,568,182,7
11492,2023-04-24 20:00:00,108,211,12,17,666,548,118,14
11493,2023-04-24 21:00:00,135,153,12,11,718,607,111,10
11494,2023-04-24 22:00:00,79,239,6,14,511,359,152,7
11495,2023-04-24 23:00:00,96,140,9,12,596,453,143,9
11496,2023-04-25 00:00:00,123,150,7,14,789,566,223,5
11497,2023-04-25 01:00:00,51,239,11,14,594,435,159,7
11498,2023-04-25 02:00:00,103,141,9,17,540,438,102,9
11499,2023-04-25 03:00:00,106,128,14,17,721,633,88,7
11500,2023-04-25 04:00:00,131,238,12,14,516,459,57,8
11501,2023-04-25 05:00:00,88,251,5,18,614,510,104,9
11502,2023-04-25 06:00:00,88,273,7,11,562,484,78,8
11503,2023-04-25 07:00:00,95,196,7,10,663,548,115,14
11504,2023-04-25 08:00:00,143,180,10,16,726,512,214,13
11505,2023-04-25 09:00:00,64,191,12,18,624,556,68,7
11506,2023-04-25 10:00:00,112,246,13,12,598,534,64,9
11507,2023-04-25 11:00:00,62,176,5,12,511,421,90,6
11508,2023-04-25 12:00:00,93,151,5,19,612,524,88,12
11509,2023-04-25 13:00:00,83,211,13,10,766,594,172,13
11510,2023-04-25 14:00:00,116,295,12,16,749,541,208,7
11511,2023-04-25 15:00:00,142,159,8,15,713,593,120,7
11512,2023-04-25 16:00:00,62,180,12,16,651,513,138,14
11513,2023-04-25 17:00:00,102,151,9,10,535,439,96,9
11514,2023-04-25 18:00:00,137,167,7,19,618,532,86,13
11515,2023-04-25 19:00:00,125,149,10,13,735,597,138,7
11516,2023-04-25 20:00:00,124,140,13,18,673,501,172,8
11517,2023-04-25 21:00:00,63,245,8,18,762,597,165,6
11518,2023-04-25 22:00:00,149,247,12,13,543,385,158,7
11519,2023-04-25 23:00:00,50,164,8,13,634,479,155,11
11520,2023-04-26 00:00:00,117,230,9,19,727,619,108,11
11521,2023-04-26 01:00:00,136,160,9,16,709,607,102,8
11522,2023-04-26 02:00:00,138,160,10,17,607,428,179,14
11523,2023-04-26 03:00:00,63,116,9,18,558,452,106,10
11524,2023-04-26 04:00:00,110,294,13,19,568,492,76,7
11525,2023-04-26 05:00:00,147,146,6,13,598,482,116,14
11526,2023-04-26 06:00:00,117,264,5,19,586,450,136,8
11527,2023-04-26 07:00:00,89,104,7,16,696,583,113,8
11528,2023-04-26 08:00:00,52,178,11,18,771,608,163,8
11529,2023-04-26 09:00:00,142,289,9,12,799,697,102,8
11530,2023-04-26 10:00:00,149,283,9,18,738,579,159,10
11531,2023-04-26 11:00:00,77,238,10,13,782,589,193,11
11532,2023-04-26 12:00:00,86,230,6,11,600,445,155,6
11533,2023-04-26 13:00:00,98,103,11,10,577,496,81,9
11534,2023-04-26 14:00:00,74,168,8,10,765,576,189,10
11535,2023-04-26 15:00:00,101,146,7,15,605,530,75,13
11536,2023-04-26 16:00:00,61,230,12,13,681,483,198,13
11537,2023-04-26 17:00:00,117,119,13,15,627,470,157,9
11538,2023-04-26 18:00:00,119,211,14,19,669,601,68,5
11539,2023-04-26 19:00:00,95,212,9,17,737,622,115,11
11540,2023-04-26 20:00:00,119,222,13,11,620,445,175,7
11541,2023-04-26 21:00:00,119,115,10,11,707,593,114,7
11542,2023-04-26 22:00:00,86,281,10,16,579,432,147,7
11543,2023-04-26 23:00:00,112,295,11,18,517,414,103,14
11544,2023-04-27 00:00:00,79,211,10,15,579,425,154,7
11545,2023-04-27 01:00:00,111,238,5,18,691,511,180,13
11546,2023-04-27 02:00:00,81,241,12,15,625,445,180,14
11547,2023-04-27 03:00:00,130,119,6,11,528,378,150,11
11548,2023-04-27 04:00:00,141,173,6,19,535,472,63,8
11549,2023-04-27 05:00:00,91,230,10,10,505,363,142,9
11550,2023-04-27 06:00:00,127,116,13,16,666,538,128,12
11551,2023-04-27 07:00:00,135,142,14,18,596,535,61,12
11552,2023-04-27 08:00:00,131,295,12,11,668,505,163,8
11553,2023-04-27 09:00:00,91,160,5,13,783,667,116,6
11554,2023-04-27 10:00:00,131,179,5,17,544,386,158,8
11555,2023-04-27 11:00:00,79,191,11,16,659,542,117,11
11556,2023-04-27 12:00:00,66,207,5,18,554,478,76,14
11557,2023-04-27 13:00:00,124,137,11,15,537,416,121,13
11558,2023-04-27 14:00:00,104,146,10,15,774,582,192,8
11559,2023-04-27 15:00:00,86,287,11,18,642,511,131,9
11560,2023-04-27 16:00:00,86,224,13,19,743,624,119,14
11561,2023-04-27 17:00:00,147,119,12,17,529,408,121,8
11562,2023-04-27 18:00:00,53,134,10,14,645,535,110,14
11563,2023-04-27 19:00:00,114,225,8,19,718,548,170,10
11564,2023-04-27 20:00:00,60,251,14,18,787,669,118,9
11565,2023-04-27 21:00:00,148,283,11,13,785,689,96,10
11566,2023-04-27 22:00:00,116,276,8,13,781,577,204,9
11567,2023-04-27 23:00:00,87,283,11,14,772,635,137,8
11568,2023-04-28 00:00:00,86,108,14,19,710,572,138,7
11569,2023-04-28 01:00:00,125,265,8,18,548,397,151,7
11570,2023-04-28 02:00:00,123,146,9,14,776,634,142,8
11571,2023-04-28 03:00:00,51,165,11,19,518,384,134,11
11572,2023-04-28 04:00:00,122,212,8,19,717,632,85,11
11573,2023-04-28 05:00:00,143,125,5,17,615,526,89,14
11574,2023-04-28 06:00:00,123,131,7,10,627,464,163,7
11575,2023-04-28 07:00:00,131,279,13,15,553,392,161,12
11576,2023-04-28 08:00:00,122,172,10,13,505,368,137,6
11577,2023-04-28 09:00:00,54,139,11,18,714,517,197,14
11578,2023-04-28 10:00:00,99,246,14,13,737,652,85,8
11579,2023-04-28 11:00:00,55,256,5,10,589,512,77,10
11580,2023-04-28 12:00:00,143,186,12,19,795,663,132,9
11581,2023-04-28 13:00:00,73,239,12,13,693,537,156,12
11582,2023-04-28 14:00:00,76,237,14,14,524,425,99,13
11583,2023-04-28 15:00:00,134,143,13,18,516,411,105,14
11584,2023-04-28 16:00:00,88,226,13,13,752,580,172,6
11585,2023-04-28 17:00:00,90,103,7,13,534,377,157,7
11586,2023-04-28 18:00:00,147,154,5,10,593,456,137,6
11587,2023-04-28 19:00:00,68,141,8,14,698,588,110,5
11588,2023-04-28 20:00:00,111,200,14,16,595,425,170,9
11589,2023-04-28 21:00:00,56,218,11,12,710,530,180,13
11590,2023-04-28 22:00:00,86,271,5,14,651,562,89,12
11591,2023-04-28 23:00:00,72,210,8,17,558,462,96,14
11592,2023-04-29 00:00:00,103,110,14,11,718,562,156,9
11593,2023-04-29 01:00:00,103,222,10,17,687,616,71,9
11594,2023-04-29 02:00:00,128,180,14,14,633,566,67,10
11595,2023-04-29 03:00:00,129,190,5,17,500,394,106,13
11596,2023-04-29 04:00:00,138,164,7,11,748,568,180,12
11597,2023-04-29 05:00:00,137,158,13,13,530,446,84,10
11598,2023-04-29 06:00:00,135,197,10,11,714,638,76,9
11599,2023-04-29 07:00:00,148,226,6,19,776,675,101,9
11600,2023-04-29 08:00:00,135,206,13,14,687,533,154,5
11601,2023-04-29 09:00:00,146,100,9,10,662,563,99,8
11602,2023-04-29 10:00:00,66,229,13,11,662,594,68,5
11603,2023-04-29 11:00:00,108,206,9,16,676,513,163,6
11604,2023-04-29 12:00:00,73,254,5,10,586,425,161,5
11605,2023-04-29 13:00:00,80,135,11,11,681,549,132,5
11606,2023-04-29 14:00:00,149,269,14,11,571,402,169,8
11607,2023-04-29 15:00:00,137,224,6,19,660,544,116,6
11608,2023-04-29 16:00:00,78,201,13,11,570,428,142,7
11609,2023-04-29 17:00:00,90,257,5,11,794,671,123,8
11610,2023-04-29 18:00:00,118,210,9,19,752,574,178,14
11611,2023-04-29 19:00:00,130,104,14,17,599,483,116,6
11612,2023-04-29 20:00:00,51,255,14,18,745,534,211,13
11613,2023-04-29 21:00:00,136,163,6,19,687,609,78,6
11614,2023-04-29 22:00:00,55,173,14,14,515,415,100,11
11615,2023-04-29 23:00:00,88,173,6,12,723,619,104,11
11616,2023-04-30 00:00:00,113,161,11,19,525,399,126,9
11617,2023-04-30 01:00:00,107,178,12,11,590,448,142,7
11618,2023-04-30 02:00:00,64,106,8,12,562,458,104,12
11619,2023-04-30 03:00:00,64,113,9,11,749,644,105,9
11620,2023-04-30 04:00:00,106,295,7,11,778,623,155,14
11621,2023-04-30 05:00:00,89,202,8,14,730,549,181,10
11622,2023-04-30 06:00:00,53,268,5,10,734,583,151,5
11623,2023-04-30 07:00:00,71,191,12,13,548,397,151,6
11624,2023-04-30 08:00:00,91,232,9,14,679,585,94,5
11625,2023-04-30 09:00:00,118,191,13,11,635,528,107,9
11626,2023-04-30 10:00:00,128,284,12,18,641,532,109,14
11627,2023-04-30 11:00:00,88,103,5,17,697,488,209,8
11628,2023-04-30 12:00:00,81,235,12,18,764,603,161,10
11629,2023-04-30 13:00:00,84,118,8,14,710,614,96,8
11630,2023-04-30 14:00:00,138,219,7,12,687,534,153,7
11631,2023-04-30 15:00:00,106,123,7,16,661,578,83,13
11632,2023-04-30 16:00:00,59,240,12,15,797,694,103,11
11633,2023-04-30 17:00:00,83,133,11,14,731,604,127,5
11634,2023-04-30 18:00:00,120,207,7,15,676,534,142,12
11635,2023-04-30 19:00:00,77,271,12,13,729,648,81,14
11636,2023-04-30 20:00:00,117,283,8,13,558,445,113,12
11637,2023-04-30 21:00:00,120,199,10,10,544,383,161,7
11638,2023-04-30 22:00:00,83,138,13,15,670,542,128,11
11639,2023-04-30 23:00:00,75,225,9,11,629,559,70,13
11640,2023-05-01 00:00:00,130,284,9,11,646,509,137,13
11641,2023-05-01 01:00:00,100,284,11,11,739,534,205,14
11642,2023-05-01 02:00:00,105,156,11,15,572,424,148,14
11643,2023-05-01 03:00:00,118,261,14,10,777,591,186,10
11644,2023-05-01 04:00:00,127,102,10,12,652,564,88,9
11645,2023-05-01 05:00:00,121,165,10,18,726,533,193,9
11646,2023-05-01 06:00:00,130,113,7,11,792,632,160,8
11647,2023-05-01 07:00:00,67,210,7,12,700,521,179,5
11648,2023-05-01 08:00:00,65,168,13,11,712,601,111,6
11649,2023-05-01 09:00:00,86,268,12,16,520,384,136,8
11650,2023-05-01 10:00:00,52,248,7,12,532,376,156,6
11651,2023-05-01 11:00:00,58,141,11,18,503,354,149,11
11652,2023-05-01 12:00:00,114,111,10,14,719,509,210,9
11653,2023-05-01 13:00:00,128,124,5,18,602,458,144,8
11654,2023-05-01 14:00:00,145,160,6,18,587,416,171,9
11655,2023-05-01 15:00:00,53,210,14,11,757,657,100,10
11656,2023-05-01 16:00:00,71,158,7,13,795,570,225,12
11657,2023-05-01 17:00:00,55,258,12,19,699,616,83,9
11658,2023-05-01 18:00:00,100,225,6,18,585,522,63,13
11659,2023-05-01 19:00:00,142,225,7,13,508,407,101,9
11660,2023-05-01 20:00:00,146,116,11,10,587,500,87,7
11661,2023-05-01 21:00:00,65,151,9,19,620,532,88,5
11662,2023-05-01 22:00:00,126,186,7,16,740,549,191,6
11663,2023-05-01 23:00:00,92,119,6,16,724,603,121,8
11664,2023-05-02 00:00:00,66,103,13,19,685,516,169,8
11665,2023-05-02 01:00:00,131,171,14,12,725,545,180,5
11666,2023-05-02 02:00:00,63,193,14,10,547,459,88,12
11667,2023-05-02 03:00:00,75,102,12,10,616,443,173,10
11668,2023-05-02 04:00:00,136,266,14,14,634,556,78,9
11669,2023-05-02 05:00:00,149,273,5,12,537,474,63,6
11670,2023-05-02 06:00:00,102,105,10,17,694,543,151,14
11671,2023-05-02 07:00:00,68,134,5,12,683,505,178,9
11672,2023-05-02 08:00:00,94,130,12,17,575,473,102,5
11673,2023-05-02 09:00:00,56,223,11,10,697,492,205,14
11674,2023-05-02 10:00:00,89,285,6,18,671,505,166,8
11675,2023-05-02 11:00:00,109,102,10,12,564,403,161,12
11676,2023-05-02 12:00:00,131,195,5,11,775,607,168,8
11677,2023-05-02 13:00:00,95,253,14,19,769,580,189,9
11678,2023-05-02 14:00:00,68,186,14,13,537,381,156,13
11679,2023-05-02 15:00:00,118,249,13,17,618,506,112,10
11680,2023-05-02 16:00:00,145,135,8,11,506,396,110,5
11681,2023-05-02 17:00:00,56,123,11,10,602,508,94,11
11682,2023-05-02 18:00:00,90,232,7,18,540,430,110,13
11683,2023-05-02 19:00:00,86,243,11,16,653,472,181,11
11684,2023-05-02 20:00:00,134,167,11,17,653,479,174,5
11685,2023-05-02 21:00:00,145,273,9,11,569,489,80,9
11686,2023-05-02 22:00:00,146,145,13,11,679,478,201,6
11687,2023-05-02 23:00:00,89,208,10,16,591,421,170,13
11688,2023-05-03 00:00:00,62,220,8,16,765,549,216,7
11689,2023-05-03 01:00:00,140,251,11,16,772,607,165,12
11690,2023-05-03 02:00:00,120,261,11,15,785,671,114,10
11691,2023-05-03 03:00:00,63,272,8,19,789,552,237,9
11692,2023-05-03 04:00:00,82,114,8,16,538,431,107,14
11693,2023-05-03 05:00:00,148,101,13,15,706,616,90,7
11694,2023-05-03 06:00:00,142,264,12,13,500,418,82,10
11695,2023-05-03 07:00:00,58,140,5,14,628,444,184,11
11696,2023-05-03 08:00:00,113,129,7,18,675,545,130,9
11697,2023-05-03 09:00:00,138,160,13,14,695,620,75,13
11698,2023-05-03 10:00:00,68,256,8,18,667,467,200,5
11699,2023-05-03 11:00:00,88,132,12,13,593,495,98,5
11700,2023-05-03 12:00:00,79,249,11,18,544,390,154,14
11701,2023-05-03 13:00:00,145,103,11,17,600,484,116,14
11702,2023-05-03 14:00:00,103,122,14,11,622,473,149,8
11703,2023-05-03 15:00:00,88,110,14,10,795,685,110,12
11704,2023-05-03 16:00:00,104,142,11,10,534,401,133,7
11705,2023-05-03 17:00:00,68,207,5,13,709,603,106,10
11706,2023-05-03 18:00:00,64,294,10,15,565,456,109,13
11707,2023-05-03 19:00:00,57,228,10,12,638,527,111,10
11708,2023-05-03 20:00:00,83,289,14,16,633,475,158,6
11709,2023-05-03 21:00:00,81,216,14,16,745,655,90,11
11710,2023-05-03 22:00:00,61,184,10,17,718,537,181,13
11711,2023-05-03 23:00:00,76,128,7,19,520,394,126,5
11712,2023-05-04 00:00:00,55,123,12,14,515,373,142,11
11713,2023-05-04 01:00:00,50,206,10,11,524,447,77,6
11714,2023-05-04 02:00:00,71,165,14,18,673,598,75,6
11715,2023-05-04 03:00:00,124,224,5,12,666,552,114,7
11716,2023-05-04 04:00:00,63,101,8,11,732,575,157,10
11717,2023-05-04 05:00:00,94,140,6,14,541,393,148,7
11718,2023-05-04 06:00:00,95,138,14,17,747,592,155,7
11719,2023-05-04 07:00:00,125,191,9,10,590,425,165,5
11720,2023-05-04 08:00:00,123,145,9,15,773,594,179,10
11721,2023-05-04 09:00:00,122,231,9,14,705,530,175,7
11722,2023-05-04 10:00:00,87,162,9,15,791,647,144,14
11723,2023-05-04 11:00:00,68,275,7,16,713,567,146,9
11724,2023-05-04 12:00:00,130,275,14,13,699,557,142,5
11725,2023-05-04 13:00:00,73,274,13,17,670,545,125,7
11726,2023-05-04 14:00:00,149,248,8,13,703,632,71,7
11727,2023-05-04 15:00:00,113,169,11,13,792,642,150,12
11728,2023-05-04 16:00:00,95,172,14,10,675,536,139,5
11729,2023-05-04 17:00:00,55,270,5,18,597,484,113,6
11730,2023-05-04 18:00:00,65,198,9,14,664,592,72,10
11731,2023-05-04 19:00:00,73,270,13,19,797,602,195,8
11732,2023-05-04 20:00:00,52,156,13,12,599,423,176,6
11733,2023-05-04 21:00:00,139,297,5,15,616,484,132,9
11734,2023-05-04 22:00:00,146,158,14,16,659,585,74,13
11735,2023-05-04 23:00:00,101,122,12,14,608,477,131,10
11736,2023-05-05 00:00:00,117,116,6,16,539,456,83,14
11737,2023-05-05 01:00:00,78,267,12,19,622,469,153,13
11738,2023-05-05 02:00:00,139,223,6,19,709,584,125,6
11739,2023-05-05 03:00:00,138,236,9,15,617,527,90,9
11740,2023-05-05 04:00:00,90,267,8,19,783,566,217,6
11741,2023-05-05 05:00:00,63,117,14,15,650,461,189,12
11742,2023-05-05 06:00:00,92,120,6,13,648,530,118,6
11743,2023-05-05 07:00:00,96,181,11,11,780,688,92,13
11744,2023-05-05 08:00:00,76,272,9,18,600,498,102,11
11745,2023-05-05 09:00:00,114,264,14,10,707,538,169,7
11746,2023-05-05 10:00:00,134,141,7,13,625,556,69,5
11747,2023-05-05 11:00:00,65,218,12,17,758,609,149,6
11748,2023-05-05 12:00:00,118,206,8,17,505,366,139,9
11749,2023-05-05 13:00:00,97,292,6,17,579,465,114,9
11750,2023-05-05 14:00:00,92,297,13,17,624,496,128,14
11751,2023-05-05 15:00:00,91,143,8,10,667,579,88,13
11752,2023-05-05 16:00:00,74,216,10,13,718,544,174,5
11753,2023-05-05 17:00:00,54,262,8,15,785,673,112,10
11754,2023-05-05 18:00:00,140,194,10,13,569,443,126,8
11755,2023-05-05 19:00:00,133,205,9,17,566,489,77,8
11756,2023-05-05 20:00:00,139,244,12,18,685,526,159,13
11757,2023-05-05 21:00:00,65,249,6,13,759,593,166,6
11758,2023-05-05 22:00:00,97,282,7,19,515,428,87,14
11759,2023-05-05 23:00:00,129,105,12,10,653,500,153,12
11760,2023-05-06 00:00:00,118,114,9,11,519,439,80,5
11761,2023-05-06 01:00:00,126,216,9,11,713,588,125,7
11762,2023-05-06 02:00:00,94,277,11,15,502,378,124,7
11763,2023-05-06 03:00:00,67,241,9,17,658,561,97,8
11764,2023-05-06 04:00:00,92,213,9,15,657,477,180,6
11765,2023-05-06 05:00:00,123,285,8,16,715,539,176,7
11766,2023-05-06 06:00:00,110,210,7,19,726,562,164,7
11767,2023-05-06 07:00:00,91,239,8,12,758,544,214,10
11768,2023-05-06 08:00:00,70,118,10,10,628,448,180,13
11769,2023-05-06 09:00:00,126,296,11,16,611,509,102,6
11770,2023-05-06 10:00:00,131,113,12,12,620,443,177,6
11771,2023-05-06 11:00:00,65,154,8,17,646,464,182,14
11772,2023-05-06 12:00:00,93,164,13,10,604,516,88,10
11773,2023-05-06 13:00:00,92,180,9,16,649,501,148,8
11774,2023-05-06 14:00:00,56,164,9,16,748,608,140,14
11775,2023-05-06 15:00:00,95,231,5,10,763,603,160,13
11776,2023-05-06 16:00:00,116,161,13,17,708,623,85,7
11777,2023-05-06 17:00:00,144,124,11,16,740,531,209,12
11778,2023-05-06 18:00:00,128,234,13,15,675,598,77,11
11779,2023-05-06 19:00:00,131,214,12,16,798,588,210,11
11780,2023-05-06 20:00:00,91,204,5,16,707,571,136,14
11781,2023-05-06 21:00:00,105,186,11,16,757,579,178,14
11782,2023-05-06 22:00:00,55,283,11,14,768,669,99,9
11783,2023-05-06 23:00:00,52,171,10,13,718,636,82,13
11784,2023-05-07 00:00:00,83,255,14,12,569,492,77,10
11785,2023-05-07 01:00:00,65,107,5,13,794,563,231,8
11786,2023-05-07 02:00:00,71,201,8,16,733,578,155,14
11787,2023-05-07 03:00:00,137,287,14,16,750,558,192,14
11788,2023-05-07 04:00:00,81,155,11,17,611,480,131,11
11789,2023-05-07 05:00:00,86,282,9,13,766,632,134,11
11790,2023-05-07 06:00:00,55,237,12,13,797,629,168,14
11791,2023-05-07 07:00:00,99,293,14,11,672,553,119,14
11792,2023-05-07 08:00:00,89,178,14,10,691,594,97,12
11793,2023-05-07 09:00:00,144,248,5,14,502,353,149,13
11794,2023-05-07 10:00:00,124,257,6,16,591,524,67,8
11795,2023-05-07 11:00:00,112,118,9,13,534,472,62,10
11796,2023-05-07 12:00:00,120,223,10,18,720,527,193,11
11797,2023-05-07 13:00:00,88,282,6,16,785,630,155,11
11798,2023-05-07 14:00:00,58,169,9,10,569,477,92,12
11799,2023-05-07 15:00:00,87,181,9,16,721,632,89,9
11800,2023-05-07 16:00:00,137,195,9,19,798,647,151,13
11801,2023-05-07 17:00:00,146,213,13,17,584,436,148,9
11802,2023-05-07 18:00:00,134,137,10,12,786,576,210,11
11803,2023-05-07 19:00:00,140,188,14,19,673,571,102,5
11804,2023-05-07 20:00:00,96,104,13,10,749,563,186,8
11805,2023-05-07 21:00:00,95,224,13,16,599,454,145,12
11806,2023-05-07 22:00:00,57,127,8,11,750,555,195,8
11807,2023-05-07 23:00:00,77,229,5,11,648,543,105,14
11808,2023-05-08 00:00:00,119,141,11,10,789,679,110,10
11809,2023-05-08 01:00:00,149,203,12,16,620,449,171,12
11810,2023-05-08 02:00:00,65,221,7,19,528,448,80,5
11811,2023-05-08 03:00:00,54,225,10,11,645,512,133,14
11812,2023-05-08 04:00:00,134,171,7,15,784,635,149,8
11813,2023-05-08 05:00:00,109,212,5,14,793,616,177,6
11814,2023-05-08 06:00:00,125,103,9,14,588,476,112,7
11815,2023-05-08 07:00:00,105,112,8,19,761,574,187,13
11816,2023-05-08 08:00:00,78,162,8,11,757,622,135,13
11817,2023-05-08 09:00:00,53,241,12,17,513,459,54,9
11818,2023-05-08 10:00:00,118,195,5,10,586,484,102,12
11819,2023-05-08 11:00:00,85,234,7,16,708,506,202,5
11820,2023-05-08 12:00:00,118,201,7,17,503,429,74,10
11821,2023-05-08 13:00:00,124,279,9,15,560,394,166,7
11822,2023-05-08 14:00:00,57,201,5,17,628,464,164,5
11823,2023-05-08 15:00:00,112,168,9,14,541,471,70,11
11824,2023-05-08 16:00:00,86,154,11,19,510,425,85,12
11825,2023-05-08 17:00:00,84,247,8,17,790,607,183,6
11826,2023-05-08 18:00:00,63,284,7,13,622,506,116,7
11827,2023-05-08 19:00:00,72,102,13,17,797,564,233,8
11828,2023-05-08 20:00:00,108,154,8,17,795,605,190,13
11829,2023-05-08 21:00:00,102,230,11,19,643,573,70,5
11830,2023-05-08 22:00:00,83,239,9,17,530,376,154,10
11831,2023-05-08 23:00:00,100,205,9,13,757,668,89,13
11832,2023-05-09 00:00:00,99,158,11,14,600,492,108,14
11833,2023-05-09 01:00:00,110,240,10,17,711,526,185,6
11834,2023-05-09 02:00:00,139,121,12,12,525,451,74,7
11835,2023-05-09 03:00:00,147,139,14,15,543,425,118,10
11836,2023-05-09 04:00:00,120,156,10,14,505,423,82,6
11837,2023-05-09 05:00:00,142,190,7,11,672,573,99,10
11838,2023-05-09 06:00:00,50,275,13,13,761,606,155,12
11839,2023-05-09 07:00:00,127,113,9,13,680,504,176,8
11840,2023-05-09 08:00:00,143,289,7,18,583,507,76,13
11841,2023-05-09 09:00:00,85,293,7,17,551,439,112,5
11842,2023-05-09 10:00:00,144,298,12,19,703,607,96,14
11843,2023-05-09 11:00:00,105,234,11,14,695,531,164,7
11844,2023-05-09 12:00:00,92,212,7,14,707,590,117,13
11845,2023-05-09 13:00:00,70,191,13,17,726,524,202,9
11846,2023-05-09 14:00:00,68,152,10,10,599,429,170,12
11847,2023-05-09 15:00:00,79,204,13,14,577,412,165,8
11848,2023-05-09 16:00:00,51,182,11,15,704,517,187,9
11849,2023-05-09 17:00:00,91,229,10,13,610,469,141,12
11850,2023-05-09 18:00:00,53,254,11,18,707,625,82,6
11851,2023-05-09 19:00:00,113,106,6,18,518,455,63,6
11852,2023-05-09 20:00:00,104,169,8,12,606,516,90,9
11853,2023-05-09 21:00:00,108,124,9,10,546,474,72,9
11854,2023-05-09 22:00:00,130,276,8,13,669,509,160,12
11855,2023-05-09 23:00:00,89,189,12,10,733,598,135,12
11856,2023-05-10 00:00:00,82,295,5,10,620,503,117,8
11857,2023-05-10 01:00:00,139,181,9,14,744,623,121,8
11858,2023-05-10 02:00:00,80,288,12,13,766,544,222,6
11859,2023-05-10 03:00:00,143,213,10,13,534,374,160,10
11860,2023-05-10 04:00:00,144,272,6,17,632,460,172,13
11861,2023-05-10 05:00:00,109,119,9,16,719,577,142,11
11862,2023-05-10 06:00:00,54,135,7,10,535,423,112,11
11863,2023-05-10 07:00:00,125,228,5,11,788,605,183,10
11864,2023-05-10 08:00:00,55,219,7,11,647,462,185,5
11865,2023-05-10 09:00:00,149,290,10,11,523,440,83,5
11866,2023-05-10 10:00:00,61,102,9,12,723,574,149,14
11867,2023-05-10 11:00:00,134,105,7,15,763,654,109,10
11868,2023-05-10 12:00:00,114,170,7,10,563,489,74,13
11869,2023-05-10 13:00:00,108,250,8,19,690,615,75,9
11870,2023-05-10 14:00:00,105,186,8,19,676,560,116,12
11871,2023-05-10 15:00:00,103,153,10,14,744,546,198,13
11872,2023-05-10 16:00:00,112,299,11,12,544,388,156,8
11873,2023-05-10 17:00:00,61,189,7,15,548,410,138,9
11874,2023-05-10 18:00:00,138,153,12,19,703,623,80,10
11875,2023-05-10 19:00:00,81,212,10,14,643,518,125,6
11876,2023-05-10 20:00:00,70,210,5,17,683,493,190,6
11877,2023-05-10 21:00:00,128,188,7,12,609,478,131,6
11878,2023-05-10 22:00:00,137,131,12,14,778,692,86,13
11879,2023-05-10 23:00:00,63,222,10,13,658,491,167,12
11880,2023-05-11 00:00:00,77,204,14,10,645,540,105,8
11881,2023-05-11 01:00:00,119,190,8,15,608,511,97,11
11882,2023-05-11 02:00:00,131,262,10,12,740,526,214,11
11883,2023-05-11 03:00:00,63,125,11,18,515,378,137,10
11884,2023-05-11 04:00:00,122,279,12,14,589,461,128,10
11885,2023-05-11 05:00:00,126,281,8,12,551,412,139,13
11886,2023-05-11 06:00:00,109,191,5,14,648,469,179,14
11887,2023-05-11 07:00:00,64,152,13,18,655,569,86,9
11888,2023-05-11 08:00:00,135,169,10,11,615,482,133,12
11889,2023-05-11 09:00:00,120,192,13,12,787,683,104,7
11890,2023-05-11 10:00:00,124,112,9,14,649,529,120,12
11891,2023-05-11 11:00:00,126,296,6,15,641,502,139,12
11892,2023-05-11 12:00:00,140,263,12,14,710,622,88,14
11893,2023-05-11 13:00:00,113,257,13,12,707,597,110,8
11894,2023-05-11 14:00:00,53,111,7,15,733,599,134,13
11895,2023-05-11 15:00:00,53,112,11,19,757,582,175,6
11896,2023-05-11 16:00:00,51,152,11,15,503,356,147,13
11897,2023-05-11 17:00:00,99,110,11,15,702,496,206,14
11898,2023-05-11 18:00:00,124,220,14,15,785,680,105,11
11899,2023-05-11 19:00:00,135,168,6,16,771,616,155,11
11900,2023-05-11 20:00:00,81,106,10,10,578,478,100,6
11901,2023-05-11 21:00:00,109,220,8,12,764,564,200,9
11902,2023-05-11 22:00:00,147,113,10,14,671,571,100,7
11903,2023-05-11 23:00:00,124,236,9,11,795,605,190,12
11904,2023-05-12 00:00:00,109,114,11,18,625,501,124,5
11905,2023-05-12 01:00:00,113,133,11,17,796,677,119,12
11906,2023-05-12 02:00:00,130,110,13,15,777,678,99,10
11907,2023-05-12 03:00:00,129,165,7,15,761,671,90,5
11908,2023-05-12 04:00:00,122,290,12,11,558,485,73,13
11909,2023-05-12 05:00:00,135,126,10,10,684,482,202,11
11910,2023-05-12 06:00:00,51,264,9,19,526,416,110,8
11911,2023-05-12 07:00:00,119,129,5,18,515,379,136,14
11912,2023-05-12 08:00:00,128,269,13,10,705,552,153,9
11913,2023-05-12 09:00:00,103,129,7,19,785,635,150,10
11914,2023-05-12 10:00:00,113,169,14,10,576,409,167,7
11915,2023-05-12 11:00:00,119,276,5,12,753,597,156,14
11916,2023-05-12 12:00:00,92,131,14,13,576,473,103,13
11917,2023-05-12 13:00:00,60,273,10,15,686,579,107,7
11918,2023-05-12 14:00:00,140,207,7,14,677,488,189,5
11919,2023-05-12 15:00:00,77,159,5,16,641,572,69,10
11920,2023-05-12 16:00:00,94,190,13,17,751,631,120,14
11921,2023-05-12 17:00:00,148,291,7,11,783,550,233,14
11922,2023-05-12 18:00:00,134,225,14,13,541,458,83,13
11923,2023-05-12 19:00:00,91,218,13,14,655,514,141,10
11924,2023-05-12 20:00:00,136,175,13,17,533,390,143,13
11925,2023-05-12 21:00:00,56,242,14,10,527,445,82,6
11926,2023-05-12 22:00:00,146,247,9,18,588,473,115,12
11927,2023-05-12 23:00:00,55,164,13,16,743,554,189,13
11928,2023-05-13 00:00:00,101,214,9,13,792,568,224,12
11929,2023-05-13 01:00:00,118,208,9,16,754,573,181,5
11930,2023-05-13 02:00:00,52,116,13,16,675,532,143,13
11931,2023-05-13 03:00:00,75,206,8,13,627,456,171,9
11932,2023-05-13 04:00:00,61,174,11,11,644,488,156,12
11933,2023-05-13 05:00:00,58,197,9,13,680,481,199,5
11934,2023-05-13 06:00:00,130,246,8,14,671,496,175,8
11935,2023-05-13 07:00:00,140,217,9,19,604,500,104,5
11936,2023-05-13 08:00:00,57,154,7,17,707,533,174,7
11937,2023-05-13 09:00:00,125,171,10,19,520,394,126,14
11938,2023-05-13 10:00:00,139,183,13,15,556,427,129,9
11939,2023-05-13 11:00:00,97,279,7,11,646,580,66,9
11940,2023-05-13 12:00:00,75,108,9,19,783,592,191,8
11941,2023-05-13 13:00:00,66,245,13,12,671,555,116,7
11942,2023-05-13 14:00:00,107,254,11,12,502,435,67,11
11943,2023-05-13 15:00:00,139,258,5,18,542,385,157,11
11944,2023-05-13 16:00:00,99,260,13,16,737,636,101,13
11945,2023-05-13 17:00:00,146,116,12,11,672,545,127,12
11946,2023-05-13 18:00:00,64,122,13,14,529,407,122,6
11947,2023-05-13 19:00:00,83,133,6,19,615,517,98,13
11948,2023-05-13 20:00:00,129,248,6,12,775,621,154,5
11949,2023-05-13 21:00:00,114,113,12,16,510,375,135,14
11950,2023-05-13 22:00:00,107,241,5,12,795,687,108,14
11951,2023-05-13 23:00:00,128,132,12,11,752,621,131,13
11952,2023-05-14 00:00:00,129,249,13,12,735,605,130,8
11953,2023-05-14 01:00:00,126,194,5,18,506,358,148,9
11954,2023-05-14 02:00:00,70,235,8,19,749,601,148,8
11955,2023-05-14 03:00:00,94,202,10,16,561,411,150,12
11956,2023-05-14 04:00:00,64,174,9,10,533,418,115,7
11957,2023-05-14 05:00:00,132,163,11,18,622,550,72,14
11958,2023-05-14 06:00:00,79,100,14,18,617,521,96,8
11959,2023-05-14 07:00:00,134,153,6,16,791,579,212,5
11960,2023-05-14 08:00:00,85,274,6,15,683,507,176,5
11961,2023-05-14 09:00:00,92,141,6,18,632,504,128,9
11962,2023-05-14 10:00:00,87,219,7,11,544,386,158,5
11963,2023-05-14 11:00:00,118,214,10,19,589,433,156,8
11964,2023-05-14 12:00:00,65,171,6,11,713,613,100,10
11965,2023-05-14 13:00:00,96,117,8,15,574,428,146,12
11966,2023-05-14 14:00:00,100,209,8,17,738,619,119,14
11967,2023-05-14 15:00:00,130,174,13,17,667,524,143,13
11968,2023-05-14 16:00:00,146,155,10,16,545,452,93,9
11969,2023-05-14 17:00:00,121,125,6,10,503,367,136,5
11970,2023-05-14 18:00:00,65,122,8,13,756,637,119,13
11971,2023-05-14 19:00:00,141,161,8,13,772,558,214,14
11972,2023-05-14 20:00:00,109,122,11,17,659,515,144,6
11973,2023-05-14 21:00:00,142,217,12,13,654,494,160,5
11974,2023-05-14 22:00:00,82,255,11,17,610,484,126,11
11975,2023-05-14 23:00:00,65,224,12,16,737,521,216,6
11976,2023-05-15 00:00:00,118,176,14,13,756,555,201,6
11977,2023-05-15 01:00:00,80,250,5,18,753,595,158,14
11978,2023-05-15 02:00:00,57,282,7,19,773,663,110,8
11979,2023-05-15 03:00:00,126,210,7,12,545,417,128,14
11980,2023-05-15 04:00:00,56,299,10,18,659,473,186,8
11981,2023-05-15 05:00:00,62,101,13,16,798,682,116,11
11982,2023-05-15 06:00:00,96,158,8,10,615,435,180,13
11983,2023-05-15 07:00:00,147,288,5,15,532,464,68,7
11984,2023-05-15 08:00:00,66,270,6,10,671,475,196,12
11985,2023-05-15 09:00:00,86,225,6,13,743,578,165,8
11986,2023-05-15 10:00:00,115,269,9,14,799,601,198,6
11987,2023-05-15 11:00:00,142,190,12,15,544,390,154,5
11988,2023-05-15 12:00:00,80,165,12,13,735,625,110,12
11989,2023-05-15 13:00:00,59,251,13,16,617,472,145,13
11990,2023-05-15 14:00:00,50,124,11,18,605,497,108,6
11991,2023-05-15 15:00:00,121,176,6,13,591,490,101,11
11992,2023-05-15 16:00:00,100,158,8,10,693,523,170,8
11993,2023-05-15 17:00:00,95,278,10,15,640,492,148,8
11994,2023-05-15 18:00:00,132,275,8,18,649,543,106,8
11995,2023-05-15 19:00:00,92,183,6,14,512,431,81,6
11996,2023-05-15 20:00:00,124,161,5,15,795,621,174,10
11997,2023-05-15 21:00:00,87,191,11,16,586,423,163,14
11998,2023-05-15 22:00:00,114,289,8,16,735,643,92,13
11999,2023-05-15 23:00:00,116,225,8,14,706,525,181,14
12000,2023-05-16 00:00:00,52,156,11,12,603,463,140,6
12001,2023-05-16 01:00:00,103,101,8,14,618,434,184,8
12002,2023-05-16 02:00:00,126,136,9,10,795,594,201,12
12003,2023-05-16 03:00:00,140,240,5,18,629,460,169,14
12004,2023-05-16 04:00:00,82,104,8,17,705,630,75,12
12005,2023-05-16 05:00:00,51,190,6,14,534,389,145,6
12006,2023-05-16 06:00:00,148,127,11,19,641,569,72,8
12007,2023-05-16 07:00:00,61,227,9,13,613,526,87,6
12008,2023-05-16 08:00:00,82,249,10,19,666,536,130,6
12009,2023-05-16 09:00:00,114,199,9,10,508,437,71,11
12010,2023-05-16 10:00:00,123,207,13,14,791,612,179,8
12011,2023-05-16 11:00:00,104,293,11,14,775,585,190,11
12012,2023-05-16 12:00:00,80,157,11,10,783,636,147,7
12013,2023-05-16 13:00:00,81,123,14,11,660,587,73,6
12014,2023-05-16 14:00:00,125,273,14,14,657,586,71,10
12015,2023-05-16 15:00:00,76,267,13,18,616,475,141,13
12016,2023-05-16 16:00:00,80,207,5,15,786,562,224,6
12017,2023-05-16 17:00:00,57,123,11,10,513,408,105,5
12018,2023-05-16 18:00:00,120,245,10,16,779,699,80,6
12019,2023-05-16 19:00:00,117,175,14,19,650,542,108,12
12020,2023-05-16 20:00:00,84,174,8,10,772,668,104,6
12021,2023-05-16 21:00:00,62,146,14,16,582,465,117,10
12022,2023-05-16 22:00:00,64,151,7,11,528,425,103,9
12023,2023-05-16 23:00:00,134,246,5,10,647,489,158,12
12024,2023-05-17 00:00:00,143,202,8,11,756,600,156,10
12025,2023-05-17 01:00:00,125,256,7,15,750,606,144,14
12026,2023-05-17 02:00:00,94,156,8,12,579,422,157,8
12027,2023-05-17 03:00:00,69,131,6,15,737,548,189,6
12028,2023-05-17 04:00:00,71,160,11,10,528,475,53,10
12029,2023-05-17 05:00:00,68,164,12,18,726,515,211,6
12030,2023-05-17 06:00:00,59,284,9,18,676,583,93,6
12031,2023-05-17 07:00:00,115,114,9,11,740,530,210,7
12032,2023-05-17 08:00:00,93,180,11,17,634,515,119,6
12033,2023-05-17 09:00:00,80,214,8,14,578,440,138,14
12034,2023-05-17 10:00:00,56,111,11,13,759,546,213,14
12035,2023-05-17 11:00:00,124,255,11,11,671,493,178,8
12036,2023-05-17 12:00:00,67,114,6,19,516,400,116,10
12037,2023-05-17 13:00:00,95,201,7,11,748,546,202,7
12038,2023-05-17 14:00:00,98,252,5,18,663,515,148,10
12039,2023-05-17 15:00:00,143,106,8,16,719,631,88,10
12040,2023-05-17 16:00:00,105,177,10,13,599,470,129,13
12041,2023-05-17 17:00:00,133,128,5,16,796,582,214,9
12042,2023-05-17 18:00:00,88,100,7,19,553,426,127,9
12043,2023-05-17 19:00:00,60,161,7,10,570,505,65,10
12044,2023-05-17 20:00:00,116,128,10,19,593,425,168,9
12045,2023-05-17 21:00:00,70,100,7,13,717,574,143,8
12046,2023-05-17 22:00:00,147,151,13,12,742,658,84,7
12047,2023-05-17 23:00:00,128,183,12,14,653,531,122,13
12048,2023-05-18 00:00:00,119,140,10,19,694,568,126,12
12049,2023-05-18 01:00:00,131,204,5,15,643,520,123,5
12050,2023-05-18 02:00:00,53,103,14,11,763,585,178,9
12051,2023-05-18 03:00:00,107,202,7,19,524,367,157,12
12052,2023-05-18 04:00:00,101,268,7,19,633,532,101,12
12053,2023-05-18 05:00:00,103,155,11,18,669,515,154,10
12054,2023-05-18 06:00:00,134,120,12,12,531,464,67,5
12055,2023-05-18 07:00:00,69,219,12,14,725,548,177,14
12056,2023-05-18 08:00:00,77,146,11,12,724,625,99,11
12057,2023-05-18 09:00:00,62,138,8,15,561,446,115,9
12058,2023-05-18 10:00:00,71,154,14,11,787,599,188,13
12059,2023-05-18 11:00:00,132,264,5,14,703,614,89,6
12060,2023-05-18 12:00:00,148,180,11,13,727,517,210,5
12061,2023-05-18 13:00:00,130,262,14,14,533,430,103,8
12062,2023-05-18 14:00:00,71,176,6,16,674,558,116,11
12063,2023-05-18 15:00:00,137,298,13,18,623,437,186,13
12064,2023-05-18 16:00:00,148,130,13,16,541,423,118,7
12065,2023-05-18 17:00:00,66,112,6,18,693,529,164,6
12066,2023-05-18 18:00:00,75,272,6,14,543,431,112,7
12067,2023-05-18 19:00:00,113,135,12,11,628,564,64,7
12068,2023-05-18 20:00:00,65,186,13,11,665,571,94,7
12069,2023-05-18 21:00:00,118,273,8,18,516,461,55,5
12070,2023-05-18 22:00:00,140,170,7,16,623,488,135,10
12071,2023-05-18 23:00:00,147,127,10,19,651,545,106,8
12072,2023-05-19 00:00:00,80,226,11,18,610,511,99,13
12073,2023-05-19 01:00:00,87,184,12,19,568,482,86,7
12074,2023-05-19 02:00:00,102,113,14,18,644,561,83,10
12075,2023-05-19 03:00:00,50,110,9,15,652,558,94,8
12076,2023-05-19 04:00:00,119,199,5,19,558,430,128,9
12077,2023-05-19 05:00:00,116,244,8,10,690,536,154,14
12078,2023-05-19 06:00:00,128,270,12,11,668,471,197,11
12079,2023-05-19 07:00:00,62,101,14,16,517,398,119,8
12080,2023-05-19 08:00:00,87,102,13,16,554,445,109,6
12081,2023-05-19 09:00:00,74,219,9,10,669,563,106,8
12082,2023-05-19 10:00:00,127,220,8,15,610,494,116,6
12083,2023-05-19 11:00:00,123,183,7,15,564,428,136,6
12084,2023-05-19 12:00:00,124,279,10,14,556,495,61,8
12085,2023-05-19 13:00:00,53,105,12,18,714,559,155,7
12086,2023-05-19 14:00:00,119,251,11,18,511,434,77,7
12087,2023-05-19 15:00:00,78,287,14,14,645,517,128,7
12088,2023-05-19 16:00:00,104,140,12,15,614,549,65,7
12089,2023-05-19 17:00:00,119,224,9,16,619,442,177,9
12090,2023-05-19 18:00:00,117,188,12,14,609,525,84,7
12091,2023-05-19 19:00:00,73,191,6,11,556,479,77,9
12092,2023-05-19 20:00:00,59,185,7,11,602,450,152,14
12093,2023-05-19 21:00:00,60,175,8,16,640,498,142,11
12094,2023-05-19 22:00:00,146,109,7,14,650,465,185,6
12095,2023-05-19 23:00:00,113,160,14,19,531,447,84,6
12096,2023-05-20 00:00:00,76,128,5,13,553,410,143,5
12097,2023-05-20 01:00:00,76,117,9,17,688,492,196,14
12098,2023-05-20 02:00:00,69,276,12,11,689,522,167,12
12099,2023-05-20 03:00:00,87,105,10,15,685,481,204,10
12100,2023-05-20 04:00:00,134,290,10,11,736,648,88,9
12101,2023-05-20 05:00:00,67,193,14,13,564,505,59,13
12102,2023-05-20 06:00:00,105,166,9,11,507,365,142,6
12103,2023-05-20 07:00:00,99,131,6,14,664,587,77,14
12104,2023-05-20 08:00:00,148,256,10,19,693,603,90,13
12105,2023-05-20 09:00:00,55,228,10,14,717,546,171,13
12106,2023-05-20 10:00:00,72,123,11,14,625,500,125,14
12107,2023-05-20 11:00:00,92,137,10,12,600,503,97,14
12108,2023-05-20 12:00:00,119,219,13,12,673,535,138,9
12109,2023-05-20 13:00:00,119,164,13,13,788,657,131,8
12110,2023-05-20 14:00:00,146,238,12,12,773,591,182,14
12111,2023-05-20 15:00:00,66,271,7,16,501,366,135,10
12112,2023-05-20 16:00:00,85,147,9,19,580,411,169,13
12113,2023-05-20 17:00:00,143,134,8,15,631,485,146,9
12114,2023-05-20 18:00:00,61,259,13,13,581,443,138,11
12115,2023-05-20 19:00:00,79,125,12,17,517,465,52,8
12116,2023-05-20 20:00:00,143,214,13,18,691,612,79,5
12117,2023-05-20 21:00:00,87,231,10,17,735,542,193,8
12118,2023-05-20 22:00:00,77,270,14,15,718,542,176,5
12119,2023-05-20 23:00:00,111,143,6,18,639,527,112,12
12120,2023-05-21 00:00:00,84,270,7,18,549,482,67,6
12121,2023-05-21 01:00:00,148,265,8,17,645,550,95,6
12122,2023-05-21 02:00:00,127,199,14,10,564,401,163,6
12123,2023-05-21 03:00:00,106,294,11,12,719,643,76,12
12124,2023-05-21 04:00:00,116,112,11,14,543,424,119,7
12125,2023-05-21 05:00:00,85,256,11,17,620,462,158,6
12126,2023-05-21 06:00:00,102,117,13,12,542,478,64,6
12127,2023-05-21 07:00:00,113,110,12,19,678,555,123,8
12128,2023-05-21 08:00:00,124,278,14,12,761,540,221,5
12129,2023-05-21 09:00:00,126,180,12,12,554,473,81,7
12130,2023-05-21 10:00:00,116,297,11,19,583,501,82,6
12131,2023-05-21 11:00:00,50,212,8,14,678,505,173,11
12132,2023-05-21 12:00:00,124,186,7,11,655,524,131,12
12133,2023-05-21 13:00:00,100,131,5,18,638,491,147,9
12134,2023-05-21 14:00:00,105,136,13,15,662,566,96,12
12135,2023-05-21 15:00:00,110,280,10,10,581,466,115,13
12136,2023-05-21 16:00:00,133,160,12,10,507,397,110,14
12137,2023-05-21 17:00:00,50,162,7,13,512,418,94,13
12138,2023-05-21 18:00:00,106,228,10,19,697,520,177,10
12139,2023-05-21 19:00:00,117,272,13,10,740,539,201,12
12140,2023-05-21 20:00:00,54,198,6,19,675,550,125,5
12141,2023-05-21 21:00:00,66,224,8,19,502,366,136,6
12142,2023-05-21 22:00:00,114,248,13,10,502,422,80,9
12143,2023-05-21 23:00:00,89,238,11,16,538,391,147,13
12144,2023-05-22 00:00:00,141,235,13,17,500,449,51,8
12145,2023-05-22 01:00:00,107,286,5,17,720,594,126,5
12146,2023-05-22 02:00:00,84,218,9,14,752,643,109,7
12147,2023-05-22 03:00:00,123,128,13,12,649,549,100,12
12148,2023-05-22 04:00:00,64,195,8,16,681,517,164,5
12149,2023-05-22 05:00:00,131,205,7,11,674,491,183,10
12150,2023-05-22 06:00:00,99,298,14,10,774,659,115,14
12151,2023-05-22 07:00:00,138,106,9,13,586,486,100,12
12152,2023-05-22 08:00:00,84,217,8,17,647,456,191,8
12153,2023-05-22 09:00:00,98,115,14,17,790,630,160,8
12154,2023-05-22 10:00:00,121,151,9,15,685,517,168,7
12155,2023-05-22 11:00:00,95,232,6,12,608,481,127,13
12156,2023-05-22 12:00:00,127,227,13,15,781,622,159,5
12157,2023-05-22 13:00:00,147,208,5,13,562,469,93,7
12158,2023-05-22 14:00:00,120,128,7,15,604,532,72,13
12159,2023-05-22 15:00:00,55,204,12,10,690,563,127,8
12160,2023-05-22 16:00:00,132,183,7,16,735,639,96,8
12161,2023-05-22 17:00:00,131,198,5,11,794,680,114,7
12162,2023-05-22 18:00:00,103,279,8,13,616,520,96,8
12163,2023-05-22 19:00:00,108,125,13,16,551,439,112,14
12164,2023-05-22 20:00:00,95,290,7,18,532,406,126,11
12165,2023-05-22 21:00:00,129,231,8,16,566,495,71,7
12166,2023-05-22 22:00:00,138,120,8,13,599,515,84,7
12167,2023-05-22 23:00:00,144,192,6,17,631,495,136,6
12168,2023-05-23 00:00:00,95,113,11,18,788,586,202,14
12169,2023-05-23 01:00:00,127,120,14,15,548,418,130,14
12170,2023-05-23 02:00:00,135,212,9,11,601,494,107,6
12171,2023-05-23 03:00:00,143,108,6,16,655,565,90,12
12172,2023-05-23 04:00:00,119,125,9,11,585,425,160,5
12173,2023-05-23 05:00:00,78,147,14,12,701,585,116,13
12174,2023-05-23 06:00:00,142,206,11,13,505,440,65,7
12175,2023-05-23 07:00:00,52,155,5,19,525,369,156,12
12176,2023-05-23 08:00:00,143,175,13,19,798,708,90,6
12177,2023-05-23 09:00:00,91,161,6,12,541,389,152,12
12178,2023-05-23 10:00:00,92,280,9,15,594,491,103,12
12179,2023-05-23 11:00:00,118,210,8,12,538,383,155,10
12180,2023-05-23 12:00:00,102,159,9,15,606,539,67,6
12181,2023-05-23 13:00:00,108,172,6,17,751,608,143,14
12182,2023-05-23 14:00:00,116,258,12,16,742,525,217,14
12183,2023-05-23 15:00:00,56,281,8,17,788,675,113,8
12184,2023-05-23 16:00:00,102,262,5,14,739,535,204,8
12185,2023-05-23 17:00:00,125,264,12,15,759,656,103,6
12186,2023-05-23 18:00:00,130,277,5,18,551,423,128,12
12187,2023-05-23 19:00:00,69,269,8,18,506,435,71,5
12188,2023-05-23 20:00:00,113,235,10,19,653,553,100,11
12189,2023-05-23 21:00:00,111,177,6,18,714,589,125,9
12190,2023-05-23 22:00:00,62,180,5,17,582,488,94,5
12191,2023-05-23 23:00:00,67,172,13,18,744,525,219,12
12192,2023-05-24 00:00:00,70,159,14,19,705,499,206,7
12193,2023-05-24 01:00:00,115,284,14,12,537,438,99,6
12194,2023-05-24 02:00:00,146,276,14,15,604,541,63,11
12195,2023-05-24 03:00:00,149,127,9,17,671,538,133,13
12196,2023-05-24 04:00:00,102,121,10,16,688,512,176,11
12197,2023-05-24 05:00:00,69,266,7,16,750,568,182,8
12198,2023-05-24 06:00:00,91,243,10,12,627,486,141,9
12199,2023-05-24 07:00:00,107,169,7,11,515,380,135,8
12200,2023-05-24 08:00:00,118,131,14,10,774,657,117,6
12201,2023-05-24 09:00:00,128,158,6,19,520,457,63,5
12202,2023-05-24 10:00:00,61,200,11,10,685,497,188,6
12203,2023-05-24 11:00:00,83,209,10,15,590,470,120,6
12204,2023-05-24 12:00:00,114,105,13,16,556,451,105,7
12205,2023-05-24 13:00:00,109,252,12,10,587,495,92,7
12206,2023-05-24 14:00:00,108,190,8,11,555,476,79,8
12207,2023-05-24 15:00:00,140,245,10,15,743,595,148,13
12208,2023-05-24 16:00:00,140,173,9,13,698,509,189,14
12209,2023-05-24 17:00:00,61,163,12,11,713,520,193,8
12210,2023-05-24 18:00:00,76,101,13,17,652,535,117,12
12211,2023-05-24 19:00:00,129,148,13,17,793,631,162,7
12212,2023-05-24 20:00:00,69,167,6,11,657,590,67,5
12213,2023-05-24 21:00:00,79,128,5,10,654,544,110,5
12214,2023-05-24 22:00:00,100,135,8,19,657,576,81,10
12215,2023-05-24 23:00:00,65,155,12,17,669,559,110,13
12216,2023-05-25 00:00:00,102,118,11,12,714,630,84,12
12217,2023-05-25 01:00:00,140,171,7,16,572,424,148,9
12218,2023-05-25 02:00:00,103,227,8,14,516,423,93,9
12219,2023-05-25 03:00:00,75,225,13,14,704,495,209,9
12220,2023-05-25 04:00:00,63,190,8,13,777,613,164,10
12221,2023-05-25 05:00:00,56,241,6,12,721,561,160,7
12222,2023-05-25 06:00:00,110,143,9,15,585,442,143,10
12223,2023-05-25 07:00:00,110,240,12,18,541,458,83,14
12224,2023-05-25 08:00:00,57,243,7,14,566,397,169,6
12225,2023-05-25 09:00:00,56,274,14,19,575,417,158,13
12226,2023-05-25 10:00:00,87,214,9,10,518,445,73,5
12227,2023-05-25 11:00:00,117,196,5,19,605,520,85,14
12228,2023-05-25 12:00:00,104,156,5,18,519,414,105,6
12229,2023-05-25 13:00:00,105,153,11,19,585,488,97,5
12230,2023-05-25 14:00:00,90,185,9,10,531,463,68,12
12231,2023-05-25 15:00:00,104,290,9,10,729,578,151,6
12232,2023-05-25 16:00:00,76,284,6,19,658,489,169,13
12233,2023-05-25 17:00:00,98,178,5,13,721,551,170,6
12234,2023-05-25 18:00:00,109,195,10,15,735,569,166,9
12235,2023-05-25 19:00:00,127,195,9,14,772,682,90,6
12236,2023-05-25 20:00:00,79,108,5,13,761,544,217,8
12237,2023-05-25 21:00:00,149,263,12,13,518,443,75,10
12238,2023-05-25 22:00:00,97,121,14,15,572,412,160,8
12239,2023-05-25 23:00:00,57,229,11,15,676,540,136,12
12240,2023-05-26 00:00:00,119,142,6,18,566,445,121,9
12241,2023-05-26 01:00:00,134,156,12,12,505,447,58,9
12242,2023-05-26 02:00:00,81,135,6,15,670,490,180,11
12243,2023-05-26 03:00:00,68,127,6,13,789,640,149,6
12244,2023-05-26 04:00:00,87,188,8,17,760,577,183,5
12245,2023-05-26 05:00:00,72,122,10,16,729,613,116,14
12246,2023-05-26 06:00:00,112,240,10,12,655,478,177,14
12247,2023-05-26 07:00:00,108,279,13,14,543,395,148,8
12248,2023-05-26 08:00:00,62,293,12,10,761,598,163,7
12249,2023-05-26 09:00:00,107,198,9,11,506,380,126,6
12250,2023-05-26 10:00:00,76,104,12,10,753,531,222,9
12251,2023-05-26 11:00:00,50,203,9,12,600,524,76,7
12252,2023-05-26 12:00:00,59,244,14,10,534,469,65,13
12253,2023-05-26 13:00:00,65,282,12,19,602,531,71,11
12254,2023-05-26 14:00:00,125,234,10,17,540,409,131,6
12255,2023-05-26 15:00:00,99,108,7,14,758,642,116,6
12256,2023-05-26 16:00:00,108,186,10,15,664,523,141,13
12257,2023-05-26 17:00:00,98,185,10,13,502,418,84,7
12258,2023-05-26 18:00:00,90,147,14,17,608,488,120,12
12259,2023-05-26 19:00:00,132,115,7,11,531,379,152,12
12260,2023-05-26 20:00:00,136,171,7,19,660,562,98,12
12261,2023-05-26 21:00:00,97,243,8,15,579,497,82,8
12262,2023-05-26 22:00:00,69,222,9,14,685,587,98,5
12263,2023-05-26 23:00:00,62,285,8,12,707,533,174,13
12264,2023-05-27 00:00:00,56,129,5,19,625,447,178,8
12265,2023-05-27 01:00:00,96,197,12,12,514,369,145,11
12266,2023-05-27 02:00:00,123,104,11,17,715,523,192,8
12267,2023-05-27 03:00:00,67,160,8,14,572,429,143,14
12268,2023-05-27 04:00:00,110,141,11,14,714,550,164,11
12269,2023-05-27 05:00:00,132,259,14,11,590,466,124,6
12270,2023-05-27 06:00:00,55,167,6,19,658,468,190,13
12271,2023-05-27 07:00:00,80,210,11,14,584,460,124,7
12272,2023-05-27 08:00:00,111,177,5,11,740,611,129,10
12273,2023-05-27 09:00:00,98,244,8,14,787,664,123,14
12274,2023-05-27 10:00:00,72,106,5,17,590,525,65,8
12275,2023-05-27 11:00:00,147,165,7,17,604,482,122,11
12276,2023-05-27 12:00:00,110,139,12,15,703,575,128,5
12277,2023-05-27 13:00:00,89,266,7,14,725,609,116,5
12278,2023-05-27 14:00:00,136,295,14,17,572,448,124,6
12279,2023-05-27 15:00:00,76,194,6,17,749,629,120,13
12280,2023-05-27 16:00:00,148,216,11,19,551,389,162,8
12281,2023-05-27 17:00:00,106,139,6,10,738,652,86,11
12282,2023-05-27 18:00:00,86,247,9,18,785,629,156,11
12283,2023-05-27 19:00:00,86,128,13,17,785,688,97,7
12284,2023-05-27 20:00:00,76,252,8,17,554,434,120,10
12285,2023-05-27 21:00:00,52,165,11,17,531,425,106,14
12286,2023-05-27 22:00:00,120,229,6,15,612,527,85,13
12287,2023-05-27 23:00:00,70,162,10,17,502,440,62,10
12288,2023-05-28 00:00:00,84,141,7,12,601,447,154,10
12289,2023-05-28 01:00:00,149,208,8,15,557,456,101,9
12290,2023-05-28 02:00:00,86,278,6,10,543,382,161,6
12291,2023-05-28 03:00:00,72,129,8,12,735,659,76,9
12292,2023-05-28 04:00:00,147,214,11,16,674,520,154,11
12293,2023-05-28 05:00:00,126,150,13,17,566,433,133,9
12294,2023-05-28 06:00:00,106,181,7,18,570,466,104,9
12295,2023-05-28 07:00:00,92,221,11,13,783,596,187,6
12296,2023-05-28 08:00:00,61,278,7,16,665,573,92,10
12297,2023-05-28 09:00:00,83,291,14,16,584,424,160,9
12298,2023-05-28 10:00:00,148,284,9,18,638,501,137,8
12299,2023-05-28 11:00:00,149,112,10,17,532,383,149,11
12300,2023-05-28 12:00:00,123,246,5,13,798,681,117,14
12301,2023-05-28 13:00:00,52,280,6,10,798,666,132,12
12302,2023-05-28 14:00:00,69,283,13,18,607,463,144,8
12303,2023-05-28 15:00:00,117,202,8,11,700,614,86,10
12304,2023-05-28 16:00:00,115,173,9,10,674,519,155,10
12305,2023-05-28 17:00:00,145,162,10,15,771,614,157,13
12306,2023-05-28 18:00:00,142,269,10,15,624,453,171,6
12307,2023-05-28 19:00:00,60,252,10,11,706,511,195,11
12308,2023-05-28 20:00:00,104,136,14,11,796,713,83,7
12309,2023-05-28 21:00:00,145,200,14,15,701,544,157,13
12310,2023-05-28 22:00:00,113,131,13,17,504,412,92,9
12311,2023-05-28 23:00:00,117,177,9,16,761,583,178,7
12312,2023-05-29 00:00:00,112,139,12,15,744,572,172,13
12313,2023-05-29 01:00:00,112,195,11,11,596,516,80,5
12314,2023-05-29 02:00:00,68,157,6,15,545,489,56,5
12315,2023-05-29 03:00:00,124,193,14,12,585,424,161,6
12316,2023-05-29 04:00:00,121,245,11,16,634,548,86,5
12317,2023-05-29 05:00:00,104,189,10,14,735,569,166,9
12318,2023-05-29 06:00:00,64,229,10,10,579,405,174,12
12319,2023-05-29 07:00:00,139,109,7,14,721,605,116,9
12320,2023-05-29 08:00:00,94,117,12,10,545,420,125,9
12321,2023-05-29 09:00:00,96,114,13,13,740,566,174,5
12322,2023-05-29 10:00:00,66,113,13,14,514,441,73,13
12323,2023-05-29 11:00:00,111,283,13,19,520,392,128,9
12324,2023-05-29 12:00:00,147,240,10,19,758,648,110,12
12325,2023-05-29 13:00:00,65,202,9,12,506,420,86,12
12326,2023-05-29 14:00:00,117,217,12,11,528,462,66,11
12327,2023-05-29 15:00:00,118,197,5,13,696,526,170,14
12328,2023-05-29 16:00:00,67,142,6,17,522,371,151,13
12329,2023-05-29 17:00:00,144,135,14,14,781,626,155,13
12330,2023-05-29 18:00:00,146,251,12,10,617,536,81,13
12331,2023-05-29 19:00:00,60,154,6,12,620,438,182,12
12332,2023-05-29 20:00:00,95,178,5,16,662,512,150,8
12333,2023-05-29 21:00:00,60,190,9,19,556,430,126,14
12334,2023-05-29 22:00:00,124,235,9,15,668,519,149,8
12335,2023-05-29 23:00:00,133,225,9,10,603,524,79,6
12336,2023-05-30 00:00:00,82,189,12,14,687,502,185,13
12337,2023-05-30 01:00:00,65,205,11,11,733,607,126,8
12338,2023-05-30 02:00:00,130,178,6,18,778,626,152,7
12339,2023-05-30 03:00:00,84,167,10,10,547,479,68,7
12340,2023-05-30 04:00:00,109,249,10,15,542,424,118,10
12341,2023-05-30 05:00:00,118,163,11,18,734,656,78,9
12342,2023-05-30 06:00:00,109,288,5,11,750,609,141,13
12343,2023-05-30 07:00:00,129,105,8,15,631,525,106,7
12344,2023-05-30 08:00:00,78,166,6,17,694,580,114,13
12345,2023-05-30 09:00:00,102,234,13,10,679,525,154,6
12346,2023-05-30 10:00:00,58,270,11,12,630,540,90,5
12347,2023-05-30 11:00:00,97,224,7,19,695,554,141,5
12348,2023-05-30 12:00:00,54,295,6,11,607,481,126,13
12349,2023-05-30 13:00:00,135,155,8,14,659,584,75,8
12350,2023-05-30 14:00:00,67,119,14,16,764,610,154,7
12351,2023-05-30 15:00:00,69,274,8,17,715,621,94,7
12352,2023-05-30 16:00:00,123,162,9,12,720,572,148,13
12353,2023-05-30 17:00:00,121,161,13,17,629,467,162,8
12354,2023-05-30 18:00:00,123,200,12,16,716,613,103,11
12355,2023-05-30 19:00:00,130,206,14,13,509,366,143,13
12356,2023-05-30 20:00:00,119,158,5,10,739,557,182,10
12357,2023-05-30 21:00:00,115,249,5,17,550,410,140,13
12358,2023-05-30 22:00:00,141,126,9,13,617,480,137,9
12359,2023-05-30 23:00:00,148,210,7,19,629,520,109,13
12360,2023-05-31 00:00:00,70,183,14,14,612,537,75,12
12361,2023-05-31 01:00:00,64,129,14,16,586,507,79,8
12362,2023-05-31 02:00:00,141,212,6,14,764,560,204,5
12363,2023-05-31 03:00:00,92,278,8,19,527,425,102,9
12364,2023-05-31 04:00:00,81,190,7,18,606,471,135,8
12365,2023-05-31 05:00:00,146,201,13,18,741,659,82,11
12366,2023-05-31 06:00:00,83,120,7,12,730,511,219,12
12367,2023-05-31 07:00:00,51,105,10,16,519,441,78,13
12368,2023-05-31 08:00:00,97,107,13,16,606,430,176,6
12369,2023-05-31 09:00:00,80,249,6,17,525,461,64,8
12370,2023-05-31 10:00:00,136,120,9,17,657,476,181,7
12371,2023-05-31 11:00:00,57,252,5,10,783,550,233,6
12372,2023-05-31 12:00:00,94,270,10,15,515,407,108,11
12373,2023-05-31 13:00:00,98,235,12,14,753,562,191,6
12374,2023-05-31 14:00:00,116,125,7,18,624,521,103,14
12375,2023-05-31 15:00:00,137,253,14,14,782,569,213,10
12376,2023-05-31 16:00:00,133,275,8,16,691,535,156,14
12377,2023-05-31 17:00:00,66,234,12,17,723,594,129,10
12378,2023-05-31 18:00:00,89,207,9,15,506,357,149,6
12379,2023-05-31 19:00:00,107,102,7,10,561,404,157,10
12380,2023-05-31 20:00:00,130,226,11,16,574,420,154,14
12381,2023-05-31 21:00:00,60,246,14,18,510,424,86,10
12382,2023-05-31 22:00:00,125,185,10,12,658,547,111,5
12383,2023-05-31 23:00:00,52,228,12,11,747,610,137,5
12384,2023-06-01 00:00:00,55,272,12,14,553,408,145,10
12385,2023-06-01 01:00:00,90,158,8,11,504,437,67,7
12386,2023-06-01 02:00:00,97,136,7,13,540,429,111,11
12387,2023-06-01 03:00:00,127,129,10,19,502,393,109,10
12388,2023-06-01 04:00:00,100,116,6,14,589,468,121,8
12389,2023-06-01 05:00:00,142,172,8,12,614,454,160,7
12390,2023-06-01 06:00:00,134,199,6,19,554,489,65,7
12391,2023-06-01 07:00:00,64,250,6,18,771,631,140,8
12392,2023-06-01 08:00:00,51,232,11,17,747,563,184,10
12393,2023-06-01 09:00:00,62,292,10,19,586,485,101,12
12394,2023-06-01 10:00:00,139,182,14,19,514,363,151,13
12395,2023-06-01 11:00:00,123,176,11,18,715,633,82,7
12396,2023-06-01 12:00:00,120,263,5,19,638,464,174,14
12397,2023-06-01 13:00:00,66,233,9,14,586,473,113,13
12398,2023-06-01 14:00:00,79,156,6,14,556,498,58,5
12399,2023-06-01 15:00:00,95,221,14,16,742,526,216,8
12400,2023-06-01 16:00:00,84,211,9,15,550,429,121,13
12401,2023-06-01 17:00:00,131,266,11,12,680,586,94,13
12402,2023-06-01 18:00:00,114,146,6,19,655,583,72,5
12403,2023-06-01 19:00:00,88,293,9,13,703,632,71,5
12404,2023-06-01 20:00:00,93,244,11,17,687,526,161,5
12405,2023-06-01 21:00:00,139,256,13,12,711,633,78,8
12406,2023-06-01 22:00:00,65,235,11,19,551,455,96,8
12407,2023-06-01 23:00:00,64,251,6,15,591,422,169,5
12408,2023-06-02 00:00:00,58,277,12,18,731,629,102,9
12409,2023-06-02 01:00:00,149,231,12,11,655,481,174,8
12410,2023-06-02 02:00:00,57,202,9,19,508,362,146,13
12411,2023-06-02 03:00:00,57,130,5,15,779,560,219,14
12412,2023-06-02 04:00:00,91,233,5,17,584,443,141,11
12413,2023-06-02 05:00:00,129,134,8,14,587,515,72,9
12414,2023-06-02 06:00:00,124,253,10,19,582,522,60,5
12415,2023-06-02 07:00:00,88,113,7,10,723,580,143,6
12416,2023-06-02 08:00:00,112,186,7,12,524,425,99,9
12417,2023-06-02 09:00:00,117,243,8,10,579,428,151,9
12418,2023-06-02 10:00:00,69,226,11,10,551,458,93,7
12419,2023-06-02 11:00:00,140,215,6,17,701,522,179,10
12420,2023-06-02 12:00:00,113,291,7,12,795,699,96,5
12421,2023-06-02 13:00:00,139,258,12,11,691,495,196,12
12422,2023-06-02 14:00:00,148,214,12,14,614,467,147,14
12423,2023-06-02 15:00:00,121,184,6,13,609,445,164,10
12424,2023-06-02 16:00:00,116,296,5,16,745,599,146,5
12425,2023-06-02 17:00:00,88,213,5,10,747,652,95,14
12426,2023-06-02 18:00:00,128,259,10,19,558,472,86,6
12427,2023-06-02 19:00:00,69,298,11,18,576,467,109,5
12428,2023-06-02 20:00:00,84,121,8,17,595,515,80,10
12429,2023-06-02 21:00:00,148,185,14,19,603,427,176,8
12430,2023-06-02 22:00:00,105,191,14,15,787,649,138,9
12431,2023-06-02 23:00:00,93,169,5,14,624,485,139,7
12432,2023-06-03 00:00:00,52,147,10,14,581,473,108,11
12433,2023-06-03 01:00:00,104,121,11,10,594,478,116,12
12434,2023-06-03 02:00:00,90,105,10,11,769,659,110,11
12435,2023-06-03 03:00:00,71,282,9,13,614,468,146,7
12436,2023-06-03 04:00:00,73,255,11,10,520,462,58,7
12437,2023-06-03 05:00:00,57,133,6,13,785,687,98,7
12438,2023-06-03 06:00:00,92,202,13,17,650,577,73,12
12439,2023-06-03 07:00:00,60,206,14,10,508,399,109,8
12440,2023-06-03 08:00:00,124,208,13,14,562,495,67,6
12441,2023-06-03 09:00:00,149,150,8,13,725,514,211,5
12442,2023-06-03 10:00:00,88,118,5,11,624,486,138,6
12443,2023-06-03 11:00:00,145,202,8,15,586,448,138,10
12444,2023-06-03 12:00:00,71,104,13,12,631,501,130,7
12445,2023-06-03 13:00:00,118,255,8,19,585,427,158,5
12446,2023-06-03 14:00:00,72,167,7,18,621,533,88,7
12447,2023-06-03 15:00:00,147,104,6,16,583,448,135,5
12448,2023-06-03 16:00:00,136,276,14,15,652,561,91,8
12449,2023-06-03 17:00:00,68,152,6,18,665,497,168,5
12450,2023-06-03 18:00:00,64,248,9,14,698,559,139,7
12451,2023-06-03 19:00:00,106,178,6,19,788,590,198,6
12452,2023-06-03 20:00:00,65,109,10,10,775,614,161,7
12453,2023-06-03 21:00:00,78,213,12,14,697,600,97,9
12454,2023-06-03 22:00:00,72,198,11,14,710,555,155,9
12455,2023-06-03 23:00:00,58,277,7,10,638,530,108,7
12456,2023-06-04 00:00:00,83,278,8,12,616,552,64,6
12457,2023-06-04 01:00:00,97,194,13,15,767,675,92,14
12458,2023-06-04 02:00:00,111,171,7,10,705,530,175,7
12459,2023-06-04 03:00:00,77,299,7,10,568,467,101,5
12460,2023-06-04 04:00:00,117,161,6,16,742,666,76,5
12461,2023-06-04 05:00:00,54,182,7,14,615,473,142,9
12462,2023-06-04 06:00:00,124,105,9,14,791,683,108,13
12463,2023-06-04 07:00:00,143,259,13,10,528,430,98,11
12464,2023-06-04 08:00:00,73,170,10,11,697,541,156,5
12465,2023-06-04 09:00:00,91,289,12,10,638,465,173,14
12466,2023-06-04 10:00:00,87,206,9,14,680,512,168,14
12467,2023-06-04 11:00:00,115,256,13,10,764,553,211,12
12468,2023-06-04 12:00:00,86,190,8,17,510,405,105,7
12469,2023-06-04 13:00:00,74,209,7,12,563,398,165,14
12470,2023-06-04 14:00:00,81,123,7,12,725,529,196,7
12471,2023-06-04 15:00:00,130,234,7,14,652,572,80,12
12472,2023-06-04 16:00:00,143,290,13,18,729,511,218,8
12473,2023-06-04 17:00:00,134,214,6,10,546,479,67,10
12474,2023-06-04 18:00:00,57,172,6,14,502,408,94,6
12475,2023-06-04 19:00:00,92,177,7,18,513,376,137,5
12476,2023-06-04 20:00:00,127,245,9,13,528,401,127,12
12477,2023-06-04 21:00:00,149,238,11,13,681,483,198,14
12478,2023-06-04 22:00:00,143,103,5,15,717,586,131,6
12479,2023-06-04 23:00:00,136,204,11,13,629,490,139,14
12480,2023-06-05 00:00:00,138,195,14,11,750,563,187,11
12481,2023-06-05 01:00:00,149,229,11,18,760,599,161,11
12482,2023-06-05 02:00:00,63,235,7,19,540,480,60,6
12483,2023-06-05 03:00:00,111,108,6,13,557,447,110,13
12484,2023-06-05 04:00:00,119,109,12,15,718,547,171,6
12485,2023-06-05 05:00:00,54,123,10,12,609,501,108,5
12486,2023-06-05 06:00:00,109,299,11,10,701,597,104,8
12487,2023-06-05 07:00:00,127,169,13,10,785,552,233,12
12488,2023-06-05 08:00:00,79,128,11,11,602,442,160,11
12489,2023-06-05 09:00:00,100,126,12,13,602,482,120,8
12490,2023-06-05 10:00:00,95,221,10,18,596,516,80,6
12491,2023-06-05 11:00:00,104,129,14,10,562,403,159,14
12492,2023-06-05 12:00:00,125,146,10,10,577,462,115,7
12493,2023-06-05 13:00:00,53,163,13,13,615,432,183,5
12494,2023-06-05 14:00:00,63,192,7,14,632,502,130,7
12495,2023-06-05 15:00:00,56,179,10,19,547,401,146,11
12496,2023-06-05 16:00:00,120,172,6,15,708,515,193,13
12497,2023-06-05 17:00:00,60,101,7,14,711,531,180,8
12498,2023-06-05 18:00:00,55,203,8,13,633,525,108,6
12499,2023-06-05 19:00:00,145,174,12,14,640,520,120,9
12500,2023-06-05 20:00:00,73,106,10,12,797,698,99,13
12501,2023-06-05 21:00:00,50,102,7,14,766,626,140,5
12502,2023-06-05 22:00:00,107,138,8,12,682,569,113,5
12503,2023-06-05 23:00:00,119,293,7,12,795,647,148,13
12504,2023-06-06 00:00:00,142,168,6,18,672,535,137,13
12505,2023-06-06 01:00:00,84,220,7,18,588,463,125,11
12506,2023-06-06 02:00:00,85,115,13,18,609,477,132,13
12507,2023-06-06 03:00:00,115,101,5,16,514,442,72,6
12508,2023-06-06 04:00:00,61,278,13,19,658,582,76,13
12509,2023-06-06 05:00:00,145,290,9,12,740,653,87,10
12510,2023-06-06 06:00:00,138,206,5,11,580,420,160,10
12511,2023-06-06 07:00:00,100,248,8,14,553,439,114,9
12512,2023-06-06 08:00:00,145,239,6,17,692,509,183,5
12513,2023-06-06 09:00:00,58,225,5,19,540,389,151,6
12514,2023-06-06 10:00:00,71,178,14,16,582,444,138,5
12515,2023-06-06 11:00:00,147,109,8,10,515,397,118,9
12516,2023-06-06 12:00:00,139,255,6,15,534,388,146,9
12517,2023-06-06 13:00:00,124,219,7,11,702,560,142,10
12518,2023-06-06 14:00:00,93,216,13,14,562,484,78,13
12519,2023-06-06 15:00:00,140,191,14,18,697,495,202,11
12520,2023-06-06 16:00:00,92,225,9,16,550,487,63,10
12521,2023-06-06 17:00:00,85,197,7,17,757,551,206,7
12522,2023-06-06 18:00:00,58,111,8,19,655,490,165,13
12523,2023-06-06 19:00:00,79,268,5,14,610,464,146,11
12524,2023-06-06 20:00:00,79,238,5,16,503,439,64,10
12525,2023-06-06 21:00:00,123,299,9,15,595,497,98,8
12526,2023-06-06 22:00:00,72,197,13,19,661,593,68,11
12527,2023-06-06 23:00:00,58,200,11,10,602,421,181,9
12528,2023-06-07 00:00:00,106,177,12,14,627,539,88,13
12529,2023-06-07 01:00:00,95,282,8,19,701,593,108,7
12530,2023-06-07 02:00:00,132,206,12,19,793,588,205,14
12531,2023-06-07 03:00:00,121,101,14,13,589,469,120,13
12532,2023-06-07 04:00:00,144,148,10,14,789,572,217,13
12533,2023-06-07 05:00:00,110,223,8,12,790,626,164,9
12534,2023-06-07 06:00:00,94,131,6,19,591,520,71,9
12535,2023-06-07 07:00:00,64,119,7,10,783,578,205,12
12536,2023-06-07 08:00:00,71,187,9,17,712,526,186,12
12537,2023-06-07 09:00:00,144,233,9,19,662,579,83,13
12538,2023-06-07 10:00:00,132,202,5,10,741,653,88,8
12539,2023-06-07 11:00:00,87,200,6,15,525,418,107,5
12540,2023-06-07 12:00:00,80,142,10,13,705,599,106,8
12541,2023-06-07 13:00:00,61,268,13,15,662,551,111,7
12542,2023-06-07 14:00:00,102,291,14,10,645,577,68,8
12543,2023-06-07 15:00:00,116,239,11,17,701,599,102,7
12544,2023-06-07 16:00:00,138,118,14,18,503,411,92,10
12545,2023-06-07 17:00:00,124,275,13,10,548,461,87,9
12546,2023-06-07 18:00:00,109,244,9,19,562,486,76,13
12547,2023-06-07 19:00:00,140,275,6,10,767,615,152,7
12548,2023-06-07 20:00:00,139,143,14,15,503,380,123,7
12549,2023-06-07 21:00:00,98,139,10,16,669,599,70,5
12550,2023-06-07 22:00:00,110,111,14,16,672,499,173,14
12551,2023-06-07 23:00:00,60,282,14,11,694,614,80,10
12552,2023-06-08 00:00:00,86,189,13,16,564,406,158,11
12553,2023-06-08 01:00:00,112,250,10,18,524,374,150,13
12554,2023-06-08 02:00:00,53,214,11,12,788,618,170,6
12555,2023-06-08 03:00:00,73,286,8,19,532,407,125,10
12556,2023-06-08 04:00:00,148,112,9,14,623,455,168,11
12557,2023-06-08 05:00:00,53,140,14,18,534,426,108,6
12558,2023-06-08 06:00:00,63,131,6,15,566,425,141,12
12559,2023-06-08 07:00:00,100,289,12,10,557,487,70,12
12560,2023-06-08 08:00:00,61,109,11,17,506,408,98,8
12561,2023-06-08 09:00:00,136,134,14,13,556,390,166,5
12562,2023-06-08 10:00:00,86,191,12,13,699,493,206,11
12563,2023-06-08 11:00:00,99,128,6,15,678,599,79,13
12564,2023-06-08 12:00:00,110,136,10,15,610,488,122,6
12565,2023-06-08 13:00:00,70,130,8,13,643,473,170,7
12566,2023-06-08 14:00:00,106,160,11,16,634,482,152,7
12567,2023-06-08 15:00:00,147,132,7,17,668,564,104,11
12568,2023-06-08 16:00:00,145,294,8,14,776,590,186,12
12569,2023-06-08 17:00:00,109,249,10,13,782,644,138,10
12570,2023-06-08 18:00:00,116,106,6,16,648,574,74,9
12571,2023-06-08 19:00:00,105,135,6,15,628,460,168,5
12572,2023-06-08 20:00:00,79,191,10,10,543,433,110,14
12573,2023-06-08 21:00:00,67,147,14,14,775,614,161,12
12574,2023-06-08 22:00:00,69,114,10,10,727,598,129,6
12575,2023-06-08 23:00:00,137,248,12,16,733,520,213,6
12576,2023-06-09 00:00:00,139,184,8,10,786,702,84,11
12577,2023-06-09 01:00:00,122,213,6,12,530,386,144,13
12578,2023-06-09 02:00:00,147,160,5,15,609,530,79,12
12579,2023-06-09 03:00:00,93,195,10,18,624,488,136,12
12580,2023-06-09 04:00:00,56,180,14,10,502,390,112,12
12581,2023-06-09 05:00:00,54,112,6,16,542,462,80,11
12582,2023-06-09 06:00:00,95,250,10,16,552,473,79,12
12583,2023-06-09 07:00:00,94,114,11,13,738,574,164,13
12584,2023-06-09 08:00:00,144,185,12,13,716,501,215,5
12585,2023-06-09 09:00:00,61,144,11,13,527,452,75,6
12586,2023-06-09 10:00:00,130,173,12,16,651,545,106,13
12587,2023-06-09 11:00:00,135,287,8,11,764,594,170,11
12588,2023-06-09 12:00:00,59,255,9,16,772,656,116,6
12589,2023-06-09 13:00:00,60,279,10,12,610,545,65,12
12590,2023-06-09 14:00:00,75,141,11,11,503,388,115,12
12591,2023-06-09 15:00:00,56,171,9,19,673,589,84,14
12592,2023-06-09 16:00:00,85,209,5,17,793,563,230,11
12593,2023-06-09 17:00:00,68,271,13,12,657,560,97,14
12594,2023-06-09 18:00:00,79,215,12,16,734,527,207,13
12595,2023-06-09 19:00:00,144,116,7,15,746,592,154,7
12596,2023-06-09 20:00:00,96,279,12,12,582,435,147,7
12597,2023-06-09 21:00:00,73,255,14,13,796,679,117,14
12598,2023-06-09 22:00:00,74,215,10,18,589,529,60,7
12599,2023-06-09 23:00:00,102,122,11,12,760,649,111,9
12600,2023-06-10 00:00:00,101,150,12,16,593,489,104,13
12601,2023-06-10 01:00:00,83,129,9,19,550,416,134,10
12602,2023-06-10 02:00:00,98,172,12,15,773,694,79,9
12603,2023-06-10 03:00:00,52,154,12,17,541,389,152,6
12604,2023-06-10 04:00:00,88,136,6,18,780,563,217,7
12605,2023-06-10 05:00:00,101,290,14,15,508,383,125,9
12606,2023-06-10 06:00:00,98,236,6,16,795,630,165,10
12607,2023-06-10 07:00:00,79,274,7,17,511,414,97,12
12608,2023-06-10 08:00:00,56,216,9,14,645,493,152,9
12609,2023-06-10 09:00:00,129,220,10,18,758,621,137,12
12610,2023-06-10 10:00:00,99,177,12,16,734,633,101,6
12611,2023-06-10 11:00:00,127,222,8,15,754,556,198,5
12612,2023-06-10 12:00:00,126,225,7,10,523,428,95,10
12613,2023-06-10 13:00:00,96,208,9,19,507,360,147,9
12614,2023-06-10 14:00:00,102,136,8,11,682,576,106,14
12615,2023-06-10 15:00:00,67,228,9,10,783,563,220,5
12616,2023-06-10 16:00:00,95,233,9,11,554,497,57,13
12617,2023-06-10 17:00:00,51,155,7,15,623,448,175,12
12618,2023-06-10 18:00:00,126,110,12,15,669,491,178,6
12619,2023-06-10 19:00:00,66,204,13,14,703,615,88,5
12620,2023-06-10 20:00:00,130,294,13,18,513,461,52,11
12621,2023-06-10 21:00:00,56,140,6,15,664,590,74,5
12622,2023-06-10 22:00:00,76,232,14,17,609,436,173,5
12623,2023-06-10 23:00:00,104,210,11,16,739,628,111,5
12624,2023-06-11 00:00:00,104,250,7,15,796,663,133,13
12625,2023-06-11 01:00:00,98,275,12,13,548,474,74,12
12626,2023-06-11 02:00:00,90,223,11,15,766,569,197,9
12627,2023-06-11 03:00:00,74,235,5,11,603,537,66,13
12628,2023-06-11 04:00:00,61,107,10,10,744,615,129,9
12629,2023-06-11 05:00:00,111,291,6,19,508,374,134,6
12630,2023-06-11 06:00:00,56,263,5,19,531,425,106,7
12631,2023-06-11 07:00:00,112,177,9,16,700,622,78,6
12632,2023-06-11 08:00:00,95,280,5,12,673,603,70,12
12633,2023-06-11 09:00:00,117,127,14,16,566,442,124,13
12634,2023-06-11 10:00:00,81,296,11,17,541,385,156,9
12635,2023-06-11 11:00:00,57,242,7,12,569,423,146,12
12636,2023-06-11 12:00:00,51,182,8,18,595,503,92,10
12637,2023-06-11 13:00:00,145,292,11,14,511,437,74,7
12638,2023-06-11 14:00:00,124,196,5,19,715,504,211,7
12639,2023-06-11 15:00:00,141,146,7,14,644,528,116,10
12640,2023-06-11 16:00:00,137,287,8,10,734,608,126,12
12641,2023-06-11 17:00:00,136,132,10,17,710,619,91,14
12642,2023-06-11 18:00:00,75,142,12,16,648,503,145,7
12643,2023-06-11 19:00:00,90,229,8,11,684,522,162,8
12644,2023-06-11 20:00:00,139,228,11,14,542,442,100,10
12645,2023-06-11 21:00:00,117,239,11,18,798,660,138,13
12646,2023-06-11 22:00:00,109,246,9,14,725,618,107,7
12647,2023-06-11 23:00:00,104,223,14,12,635,557,78,14
12648,2023-06-12 00:00:00,92,200,6,14,604,493,111,14
12649,2023-06-12 01:00:00,117,185,12,18,718,581,137,10
12650,2023-06-12 02:00:00,69,265,5,14,611,536,75,6
12651,2023-06-12 03:00:00,108,192,7,11,510,393,117,5
12652,2023-06-12 04:00:00,148,276,13,15,584,452,132,5
12653,2023-06-12 05:00:00,101,210,14,19,533,407,126,11
12654,2023-06-12 06:00:00,133,246,10,13,561,433,128,8
12655,2023-06-12 07:00:00,116,260,11,13,528,455,73,13
12656,2023-06-12 08:00:00,68,218,8,14,575,411,164,7
12657,2023-06-12 09:00:00,86,129,13,18,799,646,153,9
12658,2023-06-12 10:00:00,94,123,11,17,606,510,96,7
12659,2023-06-12 11:00:00,103,297,7,17,504,369,135,8
12660,2023-06-12 12:00:00,116,243,14,19,748,672,76,5
12661,2023-06-12 13:00:00,50,235,13,15,523,397,126,9
12662,2023-06-12 14:00:00,64,150,7,10,740,525,215,6
12663,2023-06-12 15:00:00,84,247,7,14,599,527,72,10
12664,2023-06-12 16:00:00,55,243,9,11,551,407,144,13
12665,2023-06-12 17:00:00,78,277,12,19,750,527,223,7
12666,2023-06-12 18:00:00,84,244,6,15,728,575,153,8
12667,2023-06-12 19:00:00,88,227,11,15,748,666,82,7
12668,2023-06-12 20:00:00,148,111,5,12,533,406,127,6
12669,2023-06-12 21:00:00,133,131,6,13,756,575,181,12
12670,2023-06-12 22:00:00,51,248,14,10,744,605,139,12
12671,2023-06-12 23:00:00,69,111,6,11,717,517,200,14
12672,2023-06-13 00:00:00,115,138,11,14,697,564,133,10
12673,2023-06-13 01:00:00,109,231,7,11,661,593,68,5
12674,2023-06-13 02:00:00,133,269,6,17,621,499,122,13
12675,2023-06-13 03:00:00,133,218,11,19,758,643,115,6
12676,2023-06-13 04:00:00,75,201,6,14,733,592,141,5
12677,2023-06-13 05:00:00,147,203,7,11,650,531,119,5
12678,2023-06-13 06:00:00,61,196,14,16,793,683,110,5
12679,2023-06-13 07:00:00,50,141,6,18,633,523,110,10
12680,2023-06-13 08:00:00,123,235,12,10,656,544,112,11
12681,2023-06-13 09:00:00,89,248,8,12,764,540,224,5
12682,2023-06-13 10:00:00,142,163,9,15,713,615,98,13
12683,2023-06-13 11:00:00,120,239,5,18,743,649,94,11
12684,2023-06-13 12:00:00,50,157,10,11,661,583,78,10
12685,2023-06-13 13:00:00,136,120,6,16,592,504,88,14
12686,2023-06-13 14:00:00,96,255,8,10,537,382,155,14
12687,2023-06-13 15:00:00,95,117,12,13,777,603,174,8
12688,2023-06-13 16:00:00,61,120,11,11,528,440,88,10
12689,2023-06-13 17:00:00,126,245,13,19,704,611,93,12
12690,2023-06-13 18:00:00,93,166,9,16,525,392,133,12
12691,2023-06-13 19:00:00,76,204,10,19,649,511,138,6
12692,2023-06-13 20:00:00,50,257,9,18,713,576,137,14
12693,2023-06-13 21:00:00,87,262,6,19,671,597,74,10
12694,2023-06-13 22:00:00,89,119,13,11,784,573,211,5
12695,2023-06-13 23:00:00,63,209,6,10,777,694,83,10
12696,2023-06-14 00:00:00,142,272,11,19,707,496,211,13
12697,2023-06-14 01:00:00,54,268,9,10,580,429,151,12
12698,2023-06-14 02:00:00,128,207,12,12,529,439,90,12
12699,2023-06-14 03:00:00,142,161,11,14,749,563,186,6
12700,2023-06-14 04:00:00,117,143,7,11,680,586,94,6
12701,2023-06-14 05:00:00,82,265,10,13,553,435,118,12
12702,2023-06-14 06:00:00,102,258,6,18,726,604,122,5
12703,2023-06-14 07:00:00,100,107,6,14,727,540,187,8
12704,2023-06-14 08:00:00,59,295,13,10,656,544,112,12
12705,2023-06-14 09:00:00,71,233,13,12,522,408,114,11
12706,2023-06-14 10:00:00,55,246,9,11,545,395,150,8
12707,2023-06-14 11:00:00,108,189,8,12,508,359,149,11
12708,2023-06-14 12:00:00,117,201,11,19,668,564,104,12
12709,2023-06-14 13:00:00,120,254,5,17,573,404,169,5
12710,2023-06-14 14:00:00,98,134,7,15,664,566,98,12
12711,2023-06-14 15:00:00,99,210,12,15,573,473,100,12
12712,2023-06-14 16:00:00,81,108,9,19,738,641,97,6
12713,2023-06-14 17:00:00,148,130,7,12,725,648,77,11
12714,2023-06-14 18:00:00,73,185,13,16,722,625,97,9
12715,2023-06-14 19:00:00,143,135,5,12,526,396,130,12
12716,2023-06-14 20:00:00,80,147,11,13,644,578,66,13
12717,2023-06-14 21:00:00,131,237,14,11,627,548,79,5
12718,2023-06-14 22:00:00,113,274,12,19,590,525,65,10
12719,2023-06-14 23:00:00,118,192,12,15,758,644,114,8
12720,2023-06-15 00:00:00,79,249,5,18,511,392,119,9
12721,2023-06-15 01:00:00,103,100,13,11,704,613,91,9
12722,2023-06-15 02:00:00,131,181,7,11,608,454,154,5
12723,2023-06-15 03:00:00,92,259,5,12,635,554,81,12
12724,2023-06-15 04:00:00,142,138,11,18,711,586,125,14
12725,2023-06-15 05:00:00,87,294,9,14,697,524,173,11
12726,2023-06-15 06:00:00,94,249,6,15,504,389,115,10
12727,2023-06-15 07:00:00,67,102,9,15,760,634,126,14
12728,2023-06-15 08:00:00,136,285,6,11,657,472,185,9
12729,2023-06-15 09:00:00,91,182,13,11,638,472,166,5
12730,2023-06-15 10:00:00,80,120,12,14,771,689,82,5
12731,2023-06-15 11:00:00,78,291,5,12,529,413,116,9
12732,2023-06-15 12:00:00,125,270,13,15,594,470,124,7
12733,2023-06-15 13:00:00,138,205,9,12,686,489,197,6
12734,2023-06-15 14:00:00,74,269,13,13,737,572,165,5
12735,2023-06-15 15:00:00,123,253,5,10,668,548,120,14
12736,2023-06-15 16:00:00,65,252,9,19,766,580,186,10
12737,2023-06-15 17:00:00,89,228,7,15,689,495,194,8
12738,2023-06-15 18:00:00,84,236,10,19,769,542,227,14
12739,2023-06-15 19:00:00,76,199,5,19,699,623,76,13
12740,2023-06-15 20:00:00,51,284,10,13,616,444,172,14
12741,2023-06-15 21:00:00,125,109,13,19,566,461,105,14
12742,2023-06-15 22:00:00,142,221,6,12,625,490,135,8
12743,2023-06-15 23:00:00,54,142,10,17,575,505,70,6
12744,2023-06-16 00:00:00,97,282,14,10,505,425,80,7
12745,2023-06-16 01:00:00,91,141,9,16,710,579,131,12
12746,2023-06-16 02:00:00,127,296,5,18,703,534,169,10
12747,2023-06-16 03:00:00,106,200,14,14,707,537,170,12
12748,2023-06-16 04:00:00,84,115,9,19,665,547,118,8
12749,2023-06-16 05:00:00,141,280,6,15,628,504,124,6
12750,2023-06-16 06:00:00,95,219,10,19,584,479,105,14
12751,2023-06-16 07:00:00,63,127,6,14,621,501,120,7
12752,2023-06-16 08:00:00,86,149,12,17,606,438,168,10
12753,2023-06-16 09:00:00,127,112,10,10,520,461,59,13
12754,2023-06-16 10:00:00,88,244,12,16,700,524,176,11
12755,2023-06-16 11:00:00,96,135,6,12,668,527,141,6
12756,2023-06-16 12:00:00,67,279,7,10,527,457,70,7
12757,2023-06-16 13:00:00,56,229,10,11,737,653,84,8
12758,2023-06-16 14:00:00,120,101,12,15,638,531,107,6
12759,2023-06-16 15:00:00,68,246,6,13,795,698,97,11
12760,2023-06-16 16:00:00,108,251,6,14,517,425,92,11
12761,2023-06-16 17:00:00,86,215,10,13,674,513,161,11
12762,2023-06-16 18:00:00,61,231,9,14,791,661,130,7
12763,2023-06-16 19:00:00,50,135,9,13,768,661,107,8
12764,2023-06-16 20:00:00,145,251,14,10,709,636,73,12
12765,2023-06-16 21:00:00,109,285,6,19,710,522,188,9
12766,2023-06-16 22:00:00,105,147,9,16,533,412,121,14
12767,2023-06-16 23:00:00,76,250,13,14,752,574,178,7
12768,2023-06-17 00:00:00,136,214,11,16,591,482,109,5
12769,2023-06-17 01:00:00,132,212,10,13,713,610,103,11
12770,2023-06-17 02:00:00,141,150,9,13,682,568,114,13
12771,2023-06-17 03:00:00,126,279,9,12,751,649,102,13
12772,2023-06-17 04:00:00,71,164,7,13,728,580,148,10
12773,2023-06-17 05:00:00,56,276,12,15,547,441,106,14
12774,2023-06-17 06:00:00,149,189,10,10,516,394,122,5
12775,2023-06-17 07:00:00,78,175,10,17,673,549,124,14
12776,2023-06-17 08:00:00,58,156,7,12,626,450,176,9
12777,2023-06-17 09:00:00,131,263,13,11,530,419,111,13
12778,2023-06-17 10:00:00,129,292,7,12,593,436,157,14
12779,2023-06-17 11:00:00,134,122,14,15,745,613,132,10
12780,2023-06-17 12:00:00,107,144,10,14,600,521,79,12
12781,2023-06-17 13:00:00,69,270,5,19,733,567,166,8
12782,2023-06-17 14:00:00,93,234,13,18,799,651,148,12
12783,2023-06-17 15:00:00,84,213,8,11,615,551,64,5
12784,2023-06-17 16:00:00,102,169,10,13,754,672,82,8
12785,2023-06-17 17:00:00,50,139,13,14,747,572,175,10
12786,2023-06-17 18:00:00,106,212,7,12,780,687,93,9
12787,2023-06-17 19:00:00,68,111,7,11,730,611,119,7
12788,2023-06-17 20:00:00,146,215,12,13,655,570,85,10
12789,2023-06-17 21:00:00,133,260,12,18,714,607,107,9
12790,2023-06-17 22:00:00,133,263,13,11,768,673,95,11
12791,2023-06-17 23:00:00,91,233,14,16,574,460,114,8
12792,2023-06-18 00:00:00,91,204,6,15,535,455,80,5
12793,2023-06-18 01:00:00,141,112,5,16,644,455,189,9
12794,2023-06-18 02:00:00,68,116,6,10,631,513,118,5
12795,2023-06-18 03:00:00,53,171,10,12,681,553,128,12
12796,2023-06-18 04:00:00,51,280,12,19,757,574,183,14
12797,2023-06-18 05:00:00,69,242,12,17,785,606,179,6
12798,2023-06-18 06:00:00,120,142,13,11,767,687,80,13
12799,2023-06-18 07:00:00,101,177,5,14,503,373,130,13
12800,2023-06-18 08:00:00,76,297,13,18,730,538,192,6
12801,2023-06-18 09:00:00,67,218,8,16,664,481,183,7
12802,2023-06-18 10:00:00,133,138,6,11,567,413,154,8
12803,2023-06-18 11:00:00,93,252,11,19,593,498,95,14
12804,2023-06-18 12:00:00,93,168,8,10,535,379,156,10
12805,2023-06-18 13:00:00,144,239,9,17,669,526,143,9
12806,2023-06-18 14:00:00,127,271,10,18,587,430,157,12
12807,2023-06-18 15:00:00,130,238,10,12,518,463,55,7
12808,2023-06-18 16:00:00,82,181,7,12,776,685,91,13
12809,2023-06-18 17:00:00,77,177,8,12,709,603,106,7
12810,2023-06-18 18:00:00,54,235,5,17,737,534,203,10
12811,2023-06-18 19:00:00,85,208,7,19,707,619,88,13
12812,2023-06-18 20:00:00,75,258,8,10,793,653,140,14
12813,2023-06-18 21:00:00,120,240,8,16,575,471,104,8
12814,2023-06-18 22:00:00,99,271,6,14,696,550,146,8
12815,2023-06-18 23:00:00,132,147,6,10,516,404,112,14
12816,2023-06-19 00:00:00,145,194,11,13,742,554,188,6
12817,2023-06-19 01:00:00,144,220,8,12,699,511,188,11
12818,2023-06-19 02:00:00,53,156,10,12,599,490,109,14
12819,2023-06-19 03:00:00,68,144,10,16,572,419,153,6
12820,2023-06-19 04:00:00,119,138,11,15,665,466,199,5
12821,2023-06-19 05:00:00,141,174,12,17,690,535,155,12
12822,2023-06-19 06:00:00,121,187,11,11,562,403,159,11
12823,2023-06-19 07:00:00,70,191,14,12,775,633,142,11
12824,2023-06-19 08:00:00,54,113,8,19,730,521,209,9
12825,2023-06-19 09:00:00,64,141,6,13,657,496,161,9
12826,2023-06-19 10:00:00,60,175,8,19,655,550,105,13
12827,2023-06-19 11:00:00,64,142,10,15,542,426,116,14
12828,2023-06-19 12:00:00,104,148,7,11,551,389,162,8
12829,2023-06-19 13:00:00,148,270,10,10,532,383,149,5
12830,2023-06-19 14:00:00,104,233,5,13,781,577,204,11
12831,2023-06-19 15:00:00,140,169,13,10,593,511,82,14
12832,2023-06-19 16:00:00,72,199,12,15,742,643,99,10
12833,2023-06-19 17:00:00,89,282,6,12,790,622,168,6
12834,2023-06-19 18:00:00,131,139,11,16,712,614,98,14
12835,2023-06-19 19:00:00,122,211,7,19,566,421,145,6
12836,2023-06-19 20:00:00,123,169,9,19,743,577,166,11
12837,2023-06-19 21:00:00,55,283,9,13,546,412,134,6
12838,2023-06-19 22:00:00,62,148,13,14,656,551,105,5
12839,2023-06-19 23:00:00,59,243,11,11,635,507,128,8
12840,2023-06-20 00:00:00,57,103,13,18,740,543,197,9
12841,2023-06-20 01:00:00,115,155,10,14,532,385,147,5
12842,2023-06-20 02:00:00,112,256,11,17,768,680,88,5
12843,2023-06-20 03:00:00,122,259,9,16,630,443,187,8
12844,2023-06-20 04:00:00,57,143,6,16,701,610,91,13
12845,2023-06-20 05:00:00,76,225,13,18,545,465,80,9
12846,2023-06-20 06:00:00,64,148,13,17,777,640,137,5
12847,2023-06-20 07:00:00,91,273,11,15,569,447,122,11
12848,2023-06-20 08:00:00,103,188,8,10,790,591,199,6
12849,2023-06-20 09:00:00,100,130,14,19,501,385,116,5
12850,2023-06-20 10:00:00,109,107,5,15,588,444,144,11
12851,2023-06-20 11:00:00,128,147,6,10,646,468,178,9
12852,2023-06-20 12:00:00,137,182,11,19,706,568,138,10
12853,2023-06-20 13:00:00,117,247,13,17,745,653,92,5
12854,2023-06-20 14:00:00,136,122,5,18,761,669,92,14
12855,2023-06-20 15:00:00,121,207,7,14,508,404,104,11
12856,2023-06-20 16:00:00,145,195,9,11,798,637,161,5
12857,2023-06-20 17:00:00,78,166,7,19,650,543,107,11
12858,2023-06-20 18:00:00,120,294,13,18,781,696,85,9
12859,2023-06-20 19:00:00,75,155,8,11,703,575,128,10
12860,2023-06-20 20:00:00,109,247,9,17,767,647,120,7
12861,2023-06-20 21:00:00,59,285,11,10,561,397,164,14
12862,2023-06-20 22:00:00,100,211,9,12,768,576,192,5
12863,2023-06-20 23:00:00,103,108,14,14,548,456,92,12
12864,2023-06-21 00:00:00,147,180,10,12,554,406,148,8
12865,2023-06-21 01:00:00,145,296,13,18,557,454,103,5
12866,2023-06-21 02:00:00,95,279,7,11,738,606,132,5
12867,2023-06-21 03:00:00,117,114,12,16,548,387,161,8
12868,2023-06-21 04:00:00,86,214,14,10,786,597,189,13
12869,2023-06-21 05:00:00,127,176,11,12,646,463,183,8
12870,2023-06-21 06:00:00,147,129,10,19,732,591,141,13
12871,2023-06-21 07:00:00,67,145,5,13,795,557,238,10
12872,2023-06-21 08:00:00,50,147,8,14,647,476,171,5
12873,2023-06-21 09:00:00,75,162,14,12,571,410,161,11
12874,2023-06-21 10:00:00,87,106,7,16,701,548,153,9
12875,2023-06-21 11:00:00,66,189,10,13,541,406,135,10
12876,2023-06-21 12:00:00,50,265,11,14,796,664,132,12
12877,2023-06-21 13:00:00,142,162,8,10,726,532,194,10
12878,2023-06-21 14:00:00,76,165,6,11,596,438,158,14
12879,2023-06-21 15:00:00,63,236,7,12,688,523,165,6
12880,2023-06-21 16:00:00,105,258,13,17,620,475,145,9
12881,2023-06-21 17:00:00,56,294,8,10,652,458,194,12
12882,2023-06-21 18:00:00,64,181,14,17,557,445,112,6
12883,2023-06-21 19:00:00,82,189,14,12,526,374,152,7
12884,2023-06-21 20:00:00,119,175,11,15,752,667,85,9
12885,2023-06-21 21:00:00,88,247,6,19,797,694,103,7
12886,2023-06-21 22:00:00,58,151,9,12,747,526,221,12
12887,2023-06-21 23:00:00,101,191,14,12,763,617,146,9
12888,2023-06-22 00:00:00,55,207,8,13,730,552,178,11
12889,2023-06-22 01:00:00,142,131,8,13,724,650,74,14
12890,2023-06-22 02:00:00,83,125,7,12,542,380,162,9
12891,2023-06-22 03:00:00,67,165,10,14,744,562,182,9
12892,2023-06-22 04:00:00,81,126,6,13,536,444,92,12
12893,2023-06-22 05:00:00,130,203,7,18,567,456,111,8
12894,2023-06-22 06:00:00,74,167,14,15,627,443,184,13
12895,2023-06-22 07:00:00,128,204,6,10,726,593,133,6
12896,2023-06-22 08:00:00,107,283,5,15,641,496,145,9
12897,2023-06-22 09:00:00,88,235,8,14,757,628,129,6
12898,2023-06-22 10:00:00,122,240,5,10,729,630,99,7
12899,2023-06-22 11:00:00,54,165,5,15,595,525,70,6
12900,2023-06-22 12:00:00,73,245,5,14,618,540,78,14
12901,2023-06-22 13:00:00,84,224,5,10,667,493,174,5
12902,2023-06-22 14:00:00,66,105,12,15,561,471,90,13
12903,2023-06-22 15:00:00,123,299,11,13,758,578,180,11
12904,2023-06-22 16:00:00,68,254,8,13,755,587,168,9
12905,2023-06-22 17:00:00,57,211,6,14,700,576,124,12
12906,2023-06-22 18:00:00,148,154,5,15,741,531,210,7
12907,2023-06-22 19:00:00,93,190,13,17,633,484,149,12
12908,2023-06-22 20:00:00,94,117,5,15,633,552,81,13
12909,2023-06-22 21:00:00,101,233,8,17,546,469,77,11
12910,2023-06-22 22:00:00,98,230,14,13,603,474,129,8
12911,2023-06-22 23:00:00,119,254,5,18,748,547,201,9
12912,2023-06-23 00:00:00,108,273,9,17,683,479,204,9
12913,2023-06-23 01:00:00,65,177,9,15,733,623,110,8
12914,2023-06-23 02:00:00,59,224,6,12,769,552,217,10
12915,2023-06-23 03:00:00,89,276,8,10,766,560,206,7
12916,2023-06-23 04:00:00,144,234,5,16,781,684,97,10
12917,2023-06-23 05:00:00,63,117,7,11,780,586,194,11
12918,2023-06-23 06:00:00,92,284,9,13,567,501,66,13
12919,2023-06-23 07:00:00,129,204,13,13,636,501,135,6
12920,2023-06-23 08:00:00,124,237,14,16,719,516,203,13
12921,2023-06-23 09:00:00,81,246,8,10,648,457,191,7
12922,2023-06-23 10:00:00,102,123,7,11,612,504,108,9
12923,2023-06-23 11:00:00,130,196,13,15,751,652,99,13
12924,2023-06-23 12:00:00,121,285,5,11,565,432,133,5
12925,2023-06-23 13:00:00,129,124,11,13,579,492,87,12
12926,2023-06-23 14:00:00,113,164,11,17,740,628,112,10
12927,2023-06-23 15:00:00,106,281,9,10,675,483,192,10
12928,2023-06-23 16:00:00,87,102,14,16,795,593,202,13
12929,2023-06-23 17:00:00,136,126,11,11,594,467,127,10
12930,2023-06-23 18:00:00,146,197,9,16,515,394,121,8
12931,2023-06-23 19:00:00,140,223,10,10,743,635,108,10
12932,2023-06-23 20:00:00,61,289,5,12,600,428,172,12
12933,2023-06-23 21:00:00,127,103,8,16,734,647,87,14
12934,2023-06-23 22:00:00,120,146,8,14,560,461,99,11
12935,2023-06-23 23:00:00,140,247,9,15,701,575,126,13
12936,2023-06-24 00:00:00,131,136,10,14,775,634,141,8
12937,2023-06-24 01:00:00,116,118,7,11,794,711,83,12
12938,2023-06-24 02:00:00,97,251,13,18,635,534,101,9
12939,2023-06-24 03:00:00,142,247,13,14,640,528,112,9
12940,2023-06-24 04:00:00,117,299,6,13,668,545,123,6
12941,2023-06-24 05:00:00,62,245,14,11,780,647,133,12
12942,2023-06-24 06:00:00,86,195,7,18,766,646,120,12
12943,2023-06-24 07:00:00,55,105,11,11,797,648,149,10
12944,2023-06-24 08:00:00,137,184,8,11,530,389,141,12
12945,2023-06-24 09:00:00,73,178,8,18,576,455,121,5
12946,2023-06-24 10:00:00,123,256,8,19,777,563,214,13
12947,2023-06-24 11:00:00,137,150,8,15,587,436,151,5
12948,2023-06-24 12:00:00,59,135,11,10,671,603,68,13
12949,2023-06-24 13:00:00,86,100,12,16,656,501,155,14
12950,2023-06-24 14:00:00,115,134,8,18,749,555,194,10
12951,2023-06-24 15:00:00,113,167,7,13,582,434,148,11
12952,2023-06-24 16:00:00,60,110,13,19,614,521,93,7
12953,2023-06-24 17:00:00,122,127,10,15,700,554,146,8
12954,2023-06-24 18:00:00,69,202,13,10,634,536,98,14
12955,2023-06-24 19:00:00,51,219,9,18,707,575,132,7
12956,2023-06-24 20:00:00,114,283,8,13,638,524,114,14
12957,2023-06-24 21:00:00,79,150,8,11,511,372,139,14
12958,2023-06-24 22:00:00,129,105,8,12,633,510,123,7
12959,2023-06-24 23:00:00,136,257,11,10,590,485,105,14
12960,2023-06-25 00:00:00,106,269,14,14,677,552,125,14
12961,2023-06-25 01:00:00,102,209,6,10,628,445,183,8
12962,2023-06-25 02:00:00,63,178,7,14,607,517,90,7
12963,2023-06-25 03:00:00,50,279,10,14,543,452,91,5
12964,2023-06-25 04:00:00,106,173,11,17,531,411,120,5
12965,2023-06-25 05:00:00,55,194,8,16,539,432,107,5
12966,2023-06-25 06:00:00,85,104,9,11,539,428,111,7
12967,2023-06-25 07:00:00,103,115,14,16,527,395,132,14
12968,2023-06-25 08:00:00,103,162,7,13,781,570,211,6
12969,2023-06-25 09:00:00,67,169,11,11,682,556,126,8
12970,2023-06-25 10:00:00,106,101,8,17,543,422,121,8
12971,2023-06-25 11:00:00,112,112,14,17,718,640,78,8
12972,2023-06-25 12:00:00,136,234,8,13,509,399,110,6
12973,2023-06-25 13:00:00,133,232,6,14,534,393,141,7
12974,2023-06-25 14:00:00,126,189,6,19,700,622,78,5
12975,2023-06-25 15:00:00,74,123,13,10,770,587,183,5
12976,2023-06-25 16:00:00,127,106,10,11,770,561,209,10
12977,2023-06-25 17:00:00,125,259,6,12,616,482,134,7
12978,2023-06-25 18:00:00,64,176,14,15,601,441,160,9
12979,2023-06-25 19:00:00,122,262,9,11,684,531,153,7
12980,2023-06-25 20:00:00,148,255,10,13,550,471,79,10
12981,2023-06-25 21:00:00,77,204,9,17,730,656,74,13
12982,2023-06-25 22:00:00,67,122,9,12,765,658,107,12
12983,2023-06-25 23:00:00,51,169,9,13,740,557,183,10
12984,2023-06-26 00:00:00,64,245,12,13,733,528,205,13
12985,2023-06-26 01:00:00,83,248,8,14,517,376,141,12
12986,2023-06-26 02:00:00,65,213,6,17,626,466,160,10
12987,2023-06-26 03:00:00,148,122,11,18,667,512,155,13
12988,2023-06-26 04:00:00,146,185,12,18,576,472,104,14
12989,2023-06-26 05:00:00,128,147,14,14,594,482,112,9
12990,2023-06-26 06:00:00,109,288,13,17,534,396,138,12
12991,2023-06-26 07:00:00,71,197,8,16,744,637,107,10
12992,2023-06-26 08:00:00,78,204,13,17,688,549,139,5
12993,2023-06-26 09:00:00,116,299,10,14,527,445,82,14
12994,2023-06-26 10:00:00,54,283,5,16,762,661,101,10
12995,2023-06-26 11:00:00,116,115,12,10,757,588,169,8
12996,2023-06-26 12:00:00,89,135,5,16,701,618,83,10
12997,2023-06-26 13:00:00,75,202,12,12,533,479,54,7
12998,2023-06-26 14:00:00,68,110,14,12,671,557,114,14
12999,2023-06-26 15:00:00,111,201,13,15,526,410,116,11
13000,2023-06-26 16:00:00,88,296,14,18,513,449,64,9
13001,2023-06-26 17:00:00,61,176,5,18,786,576,210,6
13002,2023-06-26 18:00:00,128,298,6,15,603,422,181,5
13003,2023-06-26 19:00:00,64,281,11,17,557,490,67,7
13004,2023-06-26 20:00:00,55,212,5,15,685,514,171,7
13005,2023-06-26 21:00:00,88,263,14,17,763,620,143,6
13006,2023-06-26 22:00:00,75,291,9,12,524,407,117,9
13007,2023-06-26 23:00:00,87,294,11,18,796,609,187,12
13008,2023-06-27 00:00:00,136,178,12,11,533,428,105,8
13009,2023-06-27 01:00:00,116,219,12,15,515,398,117,13
13010,2023-06-27 02:00:00,121,242,10,17,612,483,129,6
13011,2023-06-27 03:00:00,83,279,12,17,777,619,158,13
13012,2023-06-27 04:00:00,125,238,8,11,511,397,114,7
13013,2023-06-27 05:00:00,114,256,13,18,703,540,163,14
13014,2023-06-27 06:00:00,147,262,9,15,744,535,209,14
13015,2023-06-27 07:00:00,108,293,8,15,546,485,61,7
13016,2023-06-27 08:00:00,86,233,6,14,580,412,168,7
13017,2023-06-27 09:00:00,50,198,10,18,556,466,90,12
13018,2023-06-27 10:00:00,109,213,12,19,623,486,137,11
13019,2023-06-27 11:00:00,66,232,9,18,567,470,97,12
13020,2023-06-27 12:00:00,109,236,12,11,546,417,129,11
13021,2023-06-27 13:00:00,131,234,7,14,573,515,58,9
13022,2023-06-27 14:00:00,98,126,10,11,574,430,144,14
13023,2023-06-27 15:00:00,70,202,8,10,694,598,96,10
13024,2023-06-27 16:00:00,128,264,7,10,696,530,166,13
13025,2023-06-27 17:00:00,122,121,7,15,526,410,116,12
13026,2023-06-27 18:00:00,126,120,12,12,519,386,133,11
13027,2023-06-27 19:00:00,51,102,11,16,549,472,77,11
13028,2023-06-27 20:00:00,92,168,12,15,619,486,133,12
13029,2023-06-27 21:00:00,117,134,6,10,637,563,74,10
13030,2023-06-27 22:00:00,50,114,12,11,539,401,138,11
13031,2023-06-27 23:00:00,71,160,13,12,781,605,176,6
13032,2023-06-28 00:00:00,82,178,5,12,623,496,127,13
13033,2023-06-28 01:00:00,62,192,13,19,747,566,181,11
13034,2023-06-28 02:00:00,119,271,8,10,588,441,147,7
13035,2023-06-28 03:00:00,103,220,14,14,785,627,158,6
13036,2023-06-28 04:00:00,130,267,12,12,505,388,117,8
13037,2023-06-28 05:00:00,138,263,12,10,797,686,111,14
13038,2023-06-28 06:00:00,72,200,6,14,674,582,92,14
13039,2023-06-28 07:00:00,53,112,12,10,529,395,134,5
13040,2023-06-28 08:00:00,100,118,8,16,734,599,135,10
13041,2023-06-28 09:00:00,58,218,11,15,770,576,194,7
13042,2023-06-28 10:00:00,149,158,10,14,531,390,141,9
13043,2023-06-28 11:00:00,126,102,10,11,776,623,153,7
13044,2023-06-28 12:00:00,69,155,7,12,741,582,159,5
13045,2023-06-28 13:00:00,62,234,8,19,598,510,88,13
13046,2023-06-28 14:00:00,80,222,10,18,708,554,154,8
13047,2023-06-28 15:00:00,147,194,8,11,553,423,130,12
13048,2023-06-28 16:00:00,66,138,12,13,693,538,155,5
13049,2023-06-28 17:00:00,78,287,14,19,606,442,164,6
13050,2023-06-28 18:00:00,132,147,8,12,542,380,162,5
13051,2023-06-28 19:00:00,56,129,11,12,796,637,159,6
13052,2023-06-28 20:00:00,84,189,10,17,763,568,195,8
13053,2023-06-28 21:00:00,116,152,7,13,783,616,167,11
13054,2023-06-28 22:00:00,135,290,8,13,590,415,175,13
13055,2023-06-28 23:00:00,98,172,14,18,523,409,114,5
13056,2023-06-29 00:00:00,125,196,13,12,575,485,90,12
13057,2023-06-29 01:00:00,143,186,13,16,682,479,203,10
13058,2023-06-29 02:00:00,137,173,8,11,560,498,62,5
13059,2023-06-29 03:00:00,103,141,7,10,781,578,203,14
13060,2023-06-29 04:00:00,92,135,14,15,566,489,77,11
13061,2023-06-29 05:00:00,102,286,10,11,545,440,105,8
13062,2023-06-29 06:00:00,113,135,10,14,777,604,173,9
13063,2023-06-29 07:00:00,84,224,11,18,655,485,170,12
13064,2023-06-29 08:00:00,125,289,8,16,635,539,96,5
13065,2023-06-29 09:00:00,96,270,5,19,671,586,85,14
13066,2023-06-29 10:00:00,125,177,13,15,729,582,147,10
13067,2023-06-29 11:00:00,82,152,7,11,600,510,90,7
13068,2023-06-29 12:00:00,82,225,6,15,622,507,115,14
13069,2023-06-29 13:00:00,124,285,8,15,737,533,204,6
13070,2023-06-29 14:00:00,69,158,7,17,628,485,143,12
13071,2023-06-29 15:00:00,70,151,12,18,567,449,118,7
13072,2023-06-29 16:00:00,78,291,11,14,642,544,98,8
13073,2023-06-29 17:00:00,127,189,11,15,659,471,188,12
13074,2023-06-29 18:00:00,74,175,10,15,719,614,105,5
13075,2023-06-29 19:00:00,110,247,8,16,502,385,117,10
13076,2023-06-29 20:00:00,81,217,7,12,601,477,124,10
13077,2023-06-29 21:00:00,68,218,7,19,781,602,179,13
13078,2023-06-29 22:00:00,144,105,14,18,509,379,130,13
13079,2023-06-29 23:00:00,99,132,7,17,720,617,103,9
13080,2023-06-30 00:00:00,53,101,12,18,636,558,78,6
13081,2023-06-30 01:00:00,144,289,10,16,634,474,160,11
13082,2023-06-30 02:00:00,93,280,8,15,785,705,80,11
13083,2023-06-30 03:00:00,71,133,9,10,695,614,81,5
13084,2023-06-30 04:00:00,82,184,13,12,661,560,101,7
13085,2023-06-30 05:00:00,74,209,12,13,715,610,105,7
13086,2023-06-30 06:00:00,85,260,10,13,603,434,169,6
13087,2023-06-30 07:00:00,138,181,13,10,654,463,191,8
13088,2023-06-30 08:00:00,132,221,14,14,772,582,190,7
13089,2023-06-30 09:00:00,68,188,10,16,578,495,83,7
13090,2023-06-30 10:00:00,62,257,12,13,553,421,132,8
13091,2023-06-30 11:00:00,117,247,8,18,500,446,54,5
13092,2023-06-30 12:00:00,53,170,14,11,722,645,77,13
13093,2023-06-30 13:00:00,149,173,11,18,766,638,128,8
13094,2023-06-30 14:00:00,123,276,6,14,578,471,107,10
13095,2023-06-30 15:00:00,121,147,10,15,760,650,110,14
13096,2023-06-30 16:00:00,126,238,9,11,534,410,124,14
13097,2023-06-30 17:00:00,103,228,8,14,600,492,108,6
13098,2023-06-30 18:00:00,89,195,5,11,560,462,98,6
13099,2023-06-30 19:00:00,82,170,10,14,762,664,98,5
13100,2023-06-30 20:00:00,126,158,11,16,562,405,157,11
13101,2023-06-30 21:00:00,116,139,9,13,504,387,117,13
13102,2023-06-30 22:00:00,87,145,9,15,601,531,70,13
13103,2023-06-30 23:00:00,77,182,12,16,504,417,87,7
13104,2023-07-01 00:00:00,139,146,10,19,674,523,151,5
13105,2023-07-01 01:00:00,79,176,6,11,628,556,72,7
13106,2023-07-01 02:00:00,118,273,10,15,607,459,148,6
13107,2023-07-01 03:00:00,140,251,14,13,544,452,92,14
13108,2023-07-01 04:00:00,65,172,12,18,604,485,119,11
13109,2023-07-01 05:00:00,80,186,10,10,637,503,134,7
13110,2023-07-01 06:00:00,107,138,5,19,690,518,172,5
13111,2023-07-01 07:00:00,128,217,5,19,573,479,94,10
13112,2023-07-01 08:00:00,59,184,14,16,524,413,111,7
13113,2023-07-01 09:00:00,82,192,14,12,634,532,102,7
13114,2023-07-01 10:00:00,93,200,7,11,766,681,85,13
13115,2023-07-01 11:00:00,58,170,5,15,600,434,166,7
13116,2023-07-01 12:00:00,64,123,5,12,688,519,169,12
13117,2023-07-01 13:00:00,111,253,11,18,535,423,112,9
13118,2023-07-01 14:00:00,123,150,14,16,721,611,110,13
13119,2023-07-01 15:00:00,108,239,7,10,708,597,111,10
13120,2023-07-01 16:00:00,50,296,14,10,589,417,172,10
13121,2023-07-01 17:00:00,79,139,12,10,772,577,195,14
13122,2023-07-01 18:00:00,135,210,8,12,507,422,85,10
13123,2023-07-01 19:00:00,112,140,7,14,594,475,119,10
13124,2023-07-01 20:00:00,82,293,8,13,759,562,197,6
13125,2023-07-01 21:00:00,72,171,7,10,722,577,145,14
13126,2023-07-01 22:00:00,142,151,14,14,594,531,63,6
13127,2023-07-01 23:00:00,108,189,12,12,565,432,133,13
13128,2023-07-02 00:00:00,90,166,12,12,711,603,108,8
13129,2023-07-02 01:00:00,58,224,14,16,570,483,87,14
13130,2023-07-02 02:00:00,54,258,12,17,790,619,171,13
13131,2023-07-02 03:00:00,143,100,13,11,538,414,124,14
13132,2023-07-02 04:00:00,65,219,13,18,630,475,155,5
13133,2023-07-02 05:00:00,88,278,8,13,572,457,115,11
13134,2023-07-02 06:00:00,101,119,12,16,549,452,97,8
13135,2023-07-02 07:00:00,141,107,9,13,795,703,92,8
13136,2023-07-02 08:00:00,104,244,9,11,577,432,145,8
13137,2023-07-02 09:00:00,83,178,9,16,741,666,75,7
13138,2023-07-02 10:00:00,53,252,14,13,688,509,179,10
13139,2023-07-02 11:00:00,135,123,8,12,623,485,138,8
13140,2023-07-02 12:00:00,118,269,12,12,511,432,79,7
13141,2023-07-02 13:00:00,137,183,12,15,611,525,86,8
13142,2023-07-02 14:00:00,101,221,10,14,544,398,146,5
13143,2023-07-02 15:00:00,110,262,7,19,719,627,92,13
13144,2023-07-02 16:00:00,75,245,11,11,622,543,79,13
13145,2023-07-02 17:00:00,53,137,14,14,578,499,79,13
13146,2023-07-02 18:00:00,83,216,7,17,622,552,70,12
13147,2023-07-02 19:00:00,97,277,10,15,729,625,104,9
13148,2023-07-02 20:00:00,77,158,6,17,708,631,77,11
13149,2023-07-02 21:00:00,96,192,7,11,787,665,122,7
13150,2023-07-02 22:00:00,85,140,9,11,524,417,107,12
13151,2023-07-02 23:00:00,124,119,7,14,799,649,150,13
13152,2023-07-03 00:00:00,132,261,6,18,598,492,106,5
13153,2023-07-03 01:00:00,96,204,5,19,683,493,190,6
13154,2023-07-03 02:00:00,116,253,13,15,743,618,125,10
13155,2023-07-03 03:00:00,69,216,11,14,672,541,131,12
13156,2023-07-03 04:00:00,144,201,12,12,713,624,89,13
13157,2023-07-03 05:00:00,56,183,7,19,724,537,187,9
13158,2023-07-03 06:00:00,114,108,9,19,652,586,66,5
13159,2023-07-03 07:00:00,108,215,11,11,671,600,71,11
13160,2023-07-03 08:00:00,51,266,9,16,502,449,53,7
13161,2023-07-03 09:00:00,98,193,13,19,500,364,136,12
13162,2023-07-03 10:00:00,82,276,6,16,719,639,80,8
13163,2023-07-03 11:00:00,108,209,11,18,507,449,58,11
13164,2023-07-03 12:00:00,75,184,7,16,740,632,108,13
13165,2023-07-03 13:00:00,73,287,12,14,516,431,85,6
13166,2023-07-03 14:00:00,75,157,10,16,549,477,72,10
13167,2023-07-03 15:00:00,86,196,7,11,534,374,160,11
13168,2023-07-03 16:00:00,87,252,9,17,685,593,92,14
13169,2023-07-03 17:00:00,80,171,8,11,537,413,124,11
13170,2023-07-03 18:00:00,83,257,7,12,746,551,195,12
13171,2023-07-03 19:00:00,137,254,9,10,787,591,196,7
13172,2023-07-03 20:00:00,101,203,5,10,519,416,103,8
13173,2023-07-03 21:00:00,98,137,14,11,521,368,153,8
13174,2023-07-03 22:00:00,100,241,5,12,526,401,125,7
13175,2023-07-03 23:00:00,59,189,13,19,531,407,124,12
13176,2023-07-04 00:00:00,132,247,6,13,511,445,66,6
13177,2023-07-04 01:00:00,83,158,7,14,511,447,64,13
13178,2023-07-04 02:00:00,57,113,9,13,684,611,73,11
13179,2023-07-04 03:00:00,100,177,14,13,670,520,150,14
13180,2023-07-04 04:00:00,53,210,9,16,521,458,63,13
13181,2023-07-04 05:00:00,136,286,12,15,591,482,109,7
13182,2023-07-04 06:00:00,115,230,5,17,762,642,120,14
13183,2023-07-04 07:00:00,124,137,8,17,597,467,130,11
13184,2023-07-04 08:00:00,127,159,8,11,541,462,79,8
13185,2023-07-04 09:00:00,62,245,9,17,615,540,75,14
13186,2023-07-04 10:00:00,117,232,10,19,589,473,116,14
13187,2023-07-04 11:00:00,103,240,12,12,506,414,92,10
13188,2023-07-04 12:00:00,114,190,5,17,583,500,83,9
13189,2023-07-04 13:00:00,121,212,5,16,689,540,149,6
13190,2023-07-04 14:00:00,110,184,14,17,774,576,198,12
13191,2023-07-04 15:00:00,87,187,14,18,513,366,147,8
13192,2023-07-04 16:00:00,136,187,14,12,679,607,72,9
13193,2023-07-04 17:00:00,129,195,8,18,687,486,201,7
13194,2023-07-04 18:00:00,63,180,8,16,705,535,170,8
13195,2023-07-04 19:00:00,108,274,5,14,796,630,166,7
13196,2023-07-04 20:00:00,119,224,10,13,544,391,153,13
13197,2023-07-04 21:00:00,112,110,6,13,648,539,109,7
13198,2023-07-04 22:00:00,72,197,13,19,631,486,145,14
13199,2023-07-04 23:00:00,91,252,12,11,738,584,154,5
13200,2023-07-05 00:00:00,80,293,10,14,750,672,78,6
13201,2023-07-05 01:00:00,86,158,8,16,740,596,144,7
13202,2023-07-05 02:00:00,58,297,10,17,543,420,123,10
13203,2023-07-05 03:00:00,88,203,7,19,617,472,145,7
13204,2023-07-05 04:00:00,96,136,9,19,581,478,103,14
13205,2023-07-05 05:00:00,111,292,14,18,584,444,140,13
13206,2023-07-05 06:00:00,59,225,7,14,536,451,85,11
13207,2023-07-05 07:00:00,56,208,5,17,675,489,186,8
13208,2023-07-05 08:00:00,80,122,13,15,529,467,62,11
13209,2023-07-05 09:00:00,71,176,5,10,658,573,85,8
13210,2023-07-05 10:00:00,78,226,11,11,661,537,124,12
13211,2023-07-05 11:00:00,143,139,14,13,557,496,61,13
13212,2023-07-05 12:00:00,122,244,14,13,733,562,171,11
13213,2023-07-05 13:00:00,91,114,13,11,760,656,104,10
13214,2023-07-05 14:00:00,117,139,14,10,696,492,204,10
13215,2023-07-05 15:00:00,122,257,6,18,509,441,68,14
13216,2023-07-05 16:00:00,132,238,11,12,552,493,59,14
13217,2023-07-05 17:00:00,87,278,8,12,540,431,109,11
13218,2023-07-05 18:00:00,99,125,9,15,715,617,98,11
13219,2023-07-05 19:00:00,96,278,5,16,690,544,146,14
13220,2023-07-05 20:00:00,102,231,10,13,611,518,93,11
13221,2023-07-05 21:00:00,85,240,11,18,760,669,91,8
13222,2023-07-05 22:00:00,62,241,12,11,633,529,104,10
13223,2023-07-05 23:00:00,132,187,7,13,716,565,151,13
13224,2023-07-06 00:00:00,61,275,14,14,769,633,136,6
13225,2023-07-06 01:00:00,106,153,13,17,713,564,149,9
13226,2023-07-06 02:00:00,52,283,11,11,710,497,213,8
13227,2023-07-06 03:00:00,116,127,13,14,556,389,167,5
13228,2023-07-06 04:00:00,139,294,6,13,626,464,162,12
13229,2023-07-06 05:00:00,83,153,11,19,558,433,125,10
13230,2023-07-06 06:00:00,107,232,11,17,766,602,164,6
13231,2023-07-06 07:00:00,52,176,7,19,529,469,60,10
13232,2023-07-06 08:00:00,71,126,10,19,624,532,92,6
13233,2023-07-06 09:00:00,93,244,7,17,789,579,210,13
13234,2023-07-06 10:00:00,51,128,13,17,542,461,81,10
13235,2023-07-06 11:00:00,74,152,7,11,794,708,86,10
13236,2023-07-06 12:00:00,53,109,10,14,769,654,115,5
13237,2023-07-06 13:00:00,121,137,11,11,572,430,142,8
13238,2023-07-06 14:00:00,58,254,7,11,547,424,123,5
13239,2023-07-06 15:00:00,70,268,13,17,650,527,123,7
13240,2023-07-06 16:00:00,136,180,7,16,682,553,129,8
13241,2023-07-06 17:00:00,98,216,11,18,695,502,193,13
13242,2023-07-06 18:00:00,108,276,11,11,709,616,93,11
13243,2023-07-06 19:00:00,92,201,14,18,797,709,88,11
13244,2023-07-06 20:00:00,110,167,11,11,712,509,203,9
13245,2023-07-06 21:00:00,97,294,14,10,695,528,167,12
13246,2023-07-06 22:00:00,94,179,7,18,724,635,89,12
13247,2023-07-06 23:00:00,68,222,9,15,792,607,185,12
13248,2023-07-07 00:00:00,80,170,14,17,780,574,206,5
13249,2023-07-07 01:00:00,82,141,14,16,770,658,112,7
13250,2023-07-07 02:00:00,102,119,8,19,767,549,218,7
13251,2023-07-07 03:00:00,148,222,11,18,529,427,102,13
13252,2023-07-07 04:00:00,108,222,5,12,721,541,180,6
13253,2023-07-07 05:00:00,141,118,5,17,625,538,87,10
13254,2023-07-07 06:00:00,119,223,10,12,697,535,162,8
13255,2023-07-07 07:00:00,147,161,11,13,730,539,191,12
13256,2023-07-07 08:00:00,140,128,11,17,561,437,124,12
13257,2023-07-07 09:00:00,118,156,8,18,716,628,88,14
13258,2023-07-07 10:00:00,149,269,5,18,698,601,97,6
13259,2023-07-07 11:00:00,86,138,6,17,775,690,85,9
13260,2023-07-07 12:00:00,147,184,9,10,520,425,95,5
13261,2023-07-07 13:00:00,84,264,14,16,583,472,111,9
13262,2023-07-07 14:00:00,128,245,12,10,621,491,130,11
13263,2023-07-07 15:00:00,69,215,9,17,600,535,65,13
13264,2023-07-07 16:00:00,104,257,10,10,592,464,128,12
13265,2023-07-07 17:00:00,85,227,14,13,713,583,130,8
13266,2023-07-07 18:00:00,133,253,10,13,728,590,138,13
13267,2023-07-07 19:00:00,97,108,8,13,604,462,142,6
13268,2023-07-07 20:00:00,125,138,10,19,734,639,95,7
13269,2023-07-07 21:00:00,85,195,14,13,518,444,74,10
13270,2023-07-07 22:00:00,122,212,5,10,502,375,127,8
13271,2023-07-07 23:00:00,136,125,5,10,545,384,161,10
13272,2023-07-08 00:00:00,52,127,7,17,545,482,63,14
13273,2023-07-08 01:00:00,122,128,8,19,725,518,207,5
13274,2023-07-08 02:00:00,89,127,5,15,799,660,139,13
13275,2023-07-08 03:00:00,100,204,7,10,671,530,141,13
13276,2023-07-08 04:00:00,105,171,7,19,529,438,91,5
13277,2023-07-08 05:00:00,82,218,7,12,500,396,104,12
13278,2023-07-08 06:00:00,104,246,7,19,600,445,155,13
13279,2023-07-08 07:00:00,136,293,7,17,522,440,82,12
13280,2023-07-08 08:00:00,115,103,10,14,544,419,125,7
13281,2023-07-08 09:00:00,76,128,6,17,725,512,213,12
13282,2023-07-08 10:00:00,76,219,9,12,617,485,132,7
13283,2023-07-08 11:00:00,116,157,8,13,766,656,110,6
13284,2023-07-08 12:00:00,51,113,10,18,757,586,171,10
13285,2023-07-08 13:00:00,56,109,6,12,665,557,108,8
13286,2023-07-08 14:00:00,82,225,9,16,746,554,192,9
13287,2023-07-08 15:00:00,116,176,14,12,594,533,61,12
13288,2023-07-08 16:00:00,116,197,9,12,507,355,152,7
13289,2023-07-08 17:00:00,127,276,8,11,783,585,198,13
13290,2023-07-08 18:00:00,67,200,8,10,551,469,82,7
13291,2023-07-08 19:00:00,91,139,11,10,754,529,225,14
13292,2023-07-08 20:00:00,68,195,6,12,788,552,236,14
13293,2023-07-08 21:00:00,83,147,12,14,799,639,160,10
13294,2023-07-08 22:00:00,115,233,13,12,790,620,170,13
13295,2023-07-08 23:00:00,126,179,6,11,707,532,175,14
13296,2023-07-09 00:00:00,138,148,6,11,540,484,56,10
13297,2023-07-09 01:00:00,145,213,10,10,784,704,80,12
13298,2023-07-09 02:00:00,70,291,12,17,766,663,103,13
13299,2023-07-09 03:00:00,127,186,11,19,655,545,110,14
13300,2023-07-09 04:00:00,118,104,5,13,679,589,90,7
13301,2023-07-09 05:00:00,108,145,11,10,521,376,145,10
13302,2023-07-09 06:00:00,58,102,11,10,540,479,61,12
13303,2023-07-09 07:00:00,111,266,13,11,514,417,97,6
13304,2023-07-09 08:00:00,103,294,8,13,626,546,80,11
13305,2023-07-09 09:00:00,125,219,6,15,642,523,119,11
13306,2023-07-09 10:00:00,88,115,14,19,770,590,180,8
13307,2023-07-09 11:00:00,124,256,12,15,759,558,201,12
13308,2023-07-09 12:00:00,93,282,7,13,734,586,148,10
13309,2023-07-09 13:00:00,81,218,12,12,548,386,162,6
13310,2023-07-09 14:00:00,131,159,5,10,789,677,112,9
13311,2023-07-09 15:00:00,83,258,10,13,614,532,82,8
13312,2023-07-09 16:00:00,63,152,6,12,722,642,80,6
13313,2023-07-09 17:00:00,144,249,8,12,725,551,174,12
13314,2023-07-09 18:00:00,100,242,5,11,527,376,151,7
13315,2023-07-09 19:00:00,127,126,8,18,768,634,134,8
13316,2023-07-09 20:00:00,86,232,14,17,719,514,205,7
13317,2023-07-09 21:00:00,112,267,6,16,583,450,133,10
13318,2023-07-09 22:00:00,107,156,8,10,706,578,128,6
13319,2023-07-09 23:00:00,126,102,12,13,680,576,104,11
13320,2023-07-10 00:00:00,96,127,5,18,753,629,124,10
13321,2023-07-10 01:00:00,126,222,5,18,543,460,83,11
13322,2023-07-10 02:00:00,52,291,12,12,790,558,232,14
13323,2023-07-10 03:00:00,102,118,8,15,586,505,81,8
13324,2023-07-10 04:00:00,56,130,7,14,743,534,209,9
13325,2023-07-10 05:00:00,88,190,10,12,745,610,135,13
13326,2023-07-10 06:00:00,94,103,9,17,686,576,110,9
13327,2023-07-10 07:00:00,123,178,14,13,612,544,68,5
13328,2023-07-10 08:00:00,65,138,7,12,748,547,201,9
13329,2023-07-10 09:00:00,56,217,13,17,650,522,128,8
13330,2023-07-10 10:00:00,101,191,8,19,671,580,91,8
13331,2023-07-10 11:00:00,106,249,5,14,507,422,85,13
13332,2023-07-10 12:00:00,51,245,12,16,616,448,168,7
13333,2023-07-10 13:00:00,97,135,8,16,793,626,167,12
13334,2023-07-10 14:00:00,97,275,8,16,754,672,82,14
13335,2023-07-10 15:00:00,80,137,10,15,512,368,144,14
13336,2023-07-10 16:00:00,71,266,9,19,610,484,126,7
13337,2023-07-10 17:00:00,76,261,14,10,621,447,174,12
13338,2023-07-10 18:00:00,134,217,6,18,603,487,116,9
13339,2023-07-10 19:00:00,88,109,12,13,534,377,157,11
13340,2023-07-10 20:00:00,124,136,14,18,752,626,126,13
13341,2023-07-10 21:00:00,139,293,13,11,796,593,203,11
13342,2023-07-10 22:00:00,140,279,11,11,517,408,109,6
13343,2023-07-10 23:00:00,62,253,9,12,688,602,86,5
13344,2023-07-11 00:00:00,105,265,8,12,745,623,122,8
13345,2023-07-11 01:00:00,143,166,5,16,657,510,147,6
13346,2023-07-11 02:00:00,112,212,8,10,698,614,84,9
13347,2023-07-11 03:00:00,61,192,6,10,716,629,87,10
13348,2023-07-11 04:00:00,83,184,13,16,554,465,89,14
13349,2023-07-11 05:00:00,91,282,10,11,560,497,63,6
13350,2023-07-11 06:00:00,97,161,12,16,581,515,66,9
13351,2023-07-11 07:00:00,142,138,8,13,594,523,71,6
13352,2023-07-11 08:00:00,67,247,6,11,789,668,121,6
13353,2023-07-11 09:00:00,94,112,5,12,602,487,115,9
13354,2023-07-11 10:00:00,114,130,11,18,741,586,155,11
13355,2023-07-11 11:00:00,112,163,10,13,758,623,135,13
13356,2023-07-11 12:00:00,140,223,9,11,703,559,144,13
13357,2023-07-11 13:00:00,50,179,8,14,786,650,136,8
13358,2023-07-11 14:00:00,67,158,7,14,775,633,142,10
13359,2023-07-11 15:00:00,146,139,9,13,738,522,216,7
13360,2023-07-11 16:00:00,76,285,5,15,667,477,190,7
13361,2023-07-11 17:00:00,108,197,7,14,502,415,87,9
13362,2023-07-11 18:00:00,112,150,5,11,680,499,181,9
13363,2023-07-11 19:00:00,53,187,10,15,760,547,213,6
13364,2023-07-11 20:00:00,90,174,5,13,766,590,176,10
13365,2023-07-11 21:00:00,57,219,11,17,651,520,131,5
13366,2023-07-11 22:00:00,128,130,9,15,731,536,195,10
13367,2023-07-11 23:00:00,81,183,12,10,635,487,148,11
13368,2023-07-12 00:00:00,140,134,13,16,757,636,121,13
13369,2023-07-12 01:00:00,74,146,6,10,548,456,92,9
13370,2023-07-12 02:00:00,94,259,10,16,786,684,102,12
13371,2023-07-12 03:00:00,139,125,5,10,606,507,99,8
13372,2023-07-12 04:00:00,143,297,13,11,507,358,149,11
13373,2023-07-12 05:00:00,149,149,12,14,741,646,95,8
13374,2023-07-12 06:00:00,66,282,13,19,586,422,164,6
13375,2023-07-12 07:00:00,133,187,9,13,566,479,87,14
13376,2023-07-12 08:00:00,74,135,12,11,727,632,95,6
13377,2023-07-12 09:00:00,140,150,11,13,675,577,98,13
13378,2023-07-12 10:00:00,145,274,10,15,765,682,83,13
13379,2023-07-12 11:00:00,137,160,9,10,779,673,106,6
13380,2023-07-12 12:00:00,100,236,7,19,578,511,67,12
13381,2023-07-12 13:00:00,77,287,13,16,641,546,95,9
13382,2023-07-12 14:00:00,137,213,7,16,753,593,160,11
13383,2023-07-12 15:00:00,64,176,6,10,763,682,81,13
13384,2023-07-12 16:00:00,110,149,14,17,514,392,122,9
13385,2023-07-12 17:00:00,138,275,6,12,572,461,111,11
13386,2023-07-12 18:00:00,144,200,5,10,609,460,149,9
13387,2023-07-12 19:00:00,146,217,14,15,708,548,160,7
13388,2023-07-12 20:00:00,117,133,7,10,655,486,169,9
13389,2023-07-12 21:00:00,148,119,5,15,604,485,119,14
13390,2023-07-12 22:00:00,61,203,5,17,670,533,137,7
13391,2023-07-12 23:00:00,132,141,10,10,662,565,97,10
13392,2023-07-13 00:00:00,134,132,6,11,509,412,97,13
13393,2023-07-13 01:00:00,51,234,13,16,596,444,152,10
13394,2023-07-13 02:00:00,114,286,9,15,581,473,108,5
13395,2023-07-13 03:00:00,143,157,6,15,611,484,127,11
13396,2023-07-13 04:00:00,120,206,11,17,704,597,107,7
13397,2023-07-13 05:00:00,122,209,5,15,665,576,89,13
13398,2023-07-13 06:00:00,106,147,5,19,652,494,158,12
13399,2023-07-13 07:00:00,62,149,14,19,544,430,114,11
13400,2023-07-13 08:00:00,51,160,13,11,561,472,89,7
13401,2023-07-13 09:00:00,113,170,14,14,661,519,142,11
13402,2023-07-13 10:00:00,123,120,13,10,711,498,213,11
13403,2023-07-13 11:00:00,88,223,7,18,721,626,95,14
13404,2023-07-13 12:00:00,124,164,10,15,699,579,120,8
13405,2023-07-13 13:00:00,122,127,6,12,538,403,135,7
13406,2023-07-13 14:00:00,125,282,13,12,633,544,89,11
13407,2023-07-13 15:00:00,117,165,6,15,541,389,152,11
13408,2023-07-13 16:00:00,73,101,9,12,703,630,73,10
13409,2023-07-13 17:00:00,139,223,11,18,729,607,122,10
13410,2023-07-13 18:00:00,116,157,6,16,729,577,152,9
13411,2023-07-13 19:00:00,81,278,8,11,692,489,203,14
13412,2023-07-13 20:00:00,72,191,9,14,659,478,181,6
13413,2023-07-13 21:00:00,123,293,5,13,777,590,187,10
13414,2023-07-13 22:00:00,138,153,12,16,681,591,90,7
13415,2023-07-13 23:00:00,121,265,6,11,556,447,109,12
13416,2023-07-14 00:00:00,91,270,7,17,593,507,86,10
13417,2023-07-14 01:00:00,112,127,7,14,796,610,186,8
13418,2023-07-14 02:00:00,91,224,5,11,629,469,160,9
13419,2023-07-14 03:00:00,125,198,6,15,743,610,133,9
13420,2023-07-14 04:00:00,142,106,9,12,563,438,125,6
13421,2023-07-14 05:00:00,90,257,9,18,730,554,176,6
13422,2023-07-14 06:00:00,75,195,6,10,751,557,194,9
13423,2023-07-14 07:00:00,76,162,5,19,798,588,210,5
13424,2023-07-14 08:00:00,123,117,5,14,539,424,115,11
13425,2023-07-14 09:00:00,63,130,13,18,507,409,98,9
13426,2023-07-14 10:00:00,139,203,11,12,533,381,152,14
13427,2023-07-14 11:00:00,89,174,10,15,641,563,78,13
13428,2023-07-14 12:00:00,73,280,14,11,640,461,179,5
13429,2023-07-14 13:00:00,130,202,14,18,592,441,151,14
13430,2023-07-14 14:00:00,55,206,13,13,737,586,151,6
13431,2023-07-14 15:00:00,140,247,7,18,531,421,110,8
13432,2023-07-14 16:00:00,97,150,8,16,748,619,129,5
13433,2023-07-14 17:00:00,68,139,12,11,564,455,109,6
13434,2023-07-14 18:00:00,93,189,14,16,661,561,100,6
13435,2023-07-14 19:00:00,53,290,14,14,584,447,137,6
13436,2023-07-14 20:00:00,101,146,14,15,592,522,70,6
13437,2023-07-14 21:00:00,65,156,6,19,578,407,171,11
13438,2023-07-14 22:00:00,75,167,14,15,555,415,140,14
13439,2023-07-14 23:00:00,87,168,13,17,787,594,193,6
13440,2023-07-15 00:00:00,105,130,5,14,593,462,131,5
13441,2023-07-15 01:00:00,88,232,14,10,722,564,158,8
13442,2023-07-15 02:00:00,114,190,10,11,784,670,114,6
13443,2023-07-15 03:00:00,72,101,13,17,582,484,98,14
13444,2023-07-15 04:00:00,81,140,9,13,747,569,178,14
13445,2023-07-15 05:00:00,111,118,13,13,788,682,106,9
13446,2023-07-15 06:00:00,146,160,8,13,621,505,116,9
13447,2023-07-15 07:00:00,81,192,13,16,618,433,185,9
13448,2023-07-15 08:00:00,62,256,10,19,554,479,75,13
13449,2023-07-15 09:00:00,54,297,6,13,774,667,107,10
13450,2023-07-15 10:00:00,121,187,5,14,660,574,86,8
13451,2023-07-15 11:00:00,62,215,10,10,579,462,117,5
13452,2023-07-15 12:00:00,149,214,10,19,618,474,144,6
13453,2023-07-15 13:00:00,97,188,6,11,607,445,162,9
13454,2023-07-15 14:00:00,109,232,7,10,771,561,210,11
13455,2023-07-15 15:00:00,81,146,9,14,656,489,167,14
13456,2023-07-15 16:00:00,56,198,7,14,638,465,173,9
13457,2023-07-15 17:00:00,132,261,13,10,586,447,139,11
13458,2023-07-15 18:00:00,52,213,6,15,733,514,219,11
13459,2023-07-15 19:00:00,94,130,13,10,780,690,90,7
13460,2023-07-15 20:00:00,93,233,6,17,648,534,114,10
13461,2023-07-15 21:00:00,112,260,7,15,720,585,135,6
13462,2023-07-15 22:00:00,54,189,12,13,729,548,181,14
13463,2023-07-15 23:00:00,132,218,12,18,628,449,179,13
13464,2023-07-16 00:00:00,73,251,10,18,526,384,142,7
13465,2023-07-16 01:00:00,115,185,5,12,568,400,168,13
13466,2023-07-16 02:00:00,119,129,10,18,728,633,95,13
13467,2023-07-16 03:00:00,86,265,7,11,738,610,128,7
13468,2023-07-16 04:00:00,132,223,7,17,726,613,113,10
13469,2023-07-16 05:00:00,122,170,14,10,749,632,117,5
13470,2023-07-16 06:00:00,87,116,12,11,616,468,148,7
13471,2023-07-16 07:00:00,111,218,7,13,625,475,150,5
13472,2023-07-16 08:00:00,68,292,10,11,571,481,90,13
13473,2023-07-16 09:00:00,81,141,9,14,786,664,122,5
13474,2023-07-16 10:00:00,110,124,8,19,789,669,120,6
13475,2023-07-16 11:00:00,53,212,12,10,664,500,164,6
13476,2023-07-16 12:00:00,139,173,9,12,673,583,90,11
13477,2023-07-16 13:00:00,78,232,9,11,759,573,186,9
13478,2023-07-16 14:00:00,114,104,14,14,741,567,174,5
13479,2023-07-16 15:00:00,142,205,12,10,608,436,172,14
13480,2023-07-16 16:00:00,69,241,11,15,737,584,153,13
13481,2023-07-16 17:00:00,104,160,8,10,546,446,100,8
13482,2023-07-16 18:00:00,71,117,5,11,650,523,127,12
13483,2023-07-16 19:00:00,84,188,12,16,734,635,99,8
13484,2023-07-16 20:00:00,132,110,9,16,771,639,132,9
13485,2023-07-16 21:00:00,70,269,14,12,684,570,114,13
13486,2023-07-16 22:00:00,62,184,8,14,742,548,194,9
13487,2023-07-16 23:00:00,109,200,5,16,733,607,126,12
13488,2023-07-17 00:00:00,134,167,14,16,561,432,129,6
13489,2023-07-17 01:00:00,73,207,9,15,665,513,152,11
13490,2023-07-17 02:00:00,74,197,11,15,655,544,111,12
13491,2023-07-17 03:00:00,80,258,7,17,649,539,110,11
13492,2023-07-17 04:00:00,72,257,11,14,569,414,155,13
13493,2023-07-17 05:00:00,108,114,11,11,732,579,153,5
13494,2023-07-17 06:00:00,117,297,9,13,791,698,93,10
13495,2023-07-17 07:00:00,98,250,14,14,768,626,142,5
13496,2023-07-17 08:00:00,146,108,8,13,702,523,179,9
13497,2023-07-17 09:00:00,126,222,10,10,616,486,130,12
13498,2023-07-17 10:00:00,99,243,14,15,740,575,165,10
13499,2023-07-17 11:00:00,116,124,11,14,658,540,118,13
13500,2023-07-17 12:00:00,130,238,8,11,568,439,129,13
13501,2023-07-17 13:00:00,69,123,8,13,502,434,68,14
13502,2023-07-17 14:00:00,123,199,14,11,581,476,105,13
13503,2023-07-17 15:00:00,146,218,11,12,708,601,107,9
13504,2023-07-17 16:00:00,60,161,14,11,683,592,91,6
13505,2023-07-17 17:00:00,124,253,13,13,775,696,79,11
13506,2023-07-17 18:00:00,113,218,5,19,622,557,65,9
13507,2023-07-17 19:00:00,59,115,7,11,684,562,122,5
13508,2023-07-17 20:00:00,55,238,8,10,615,479,136,11
13509,2023-07-17 21:00:00,142,267,5,19,726,557,169,5
13510,2023-07-17 22:00:00,96,174,9,16,635,570,65,10
13511,2023-07-17 23:00:00,145,238,10,14,501,436,65,7
13512,2023-07-18 00:00:00,90,218,12,14,656,570,86,11
13513,2023-07-18 01:00:00,130,144,8,13,780,667,113,11
13514,2023-07-18 02:00:00,67,116,6,11,530,417,113,8
13515,2023-07-18 03:00:00,57,277,9,15,692,487,205,9
13516,2023-07-18 04:00:00,71,223,8,18,537,471,66,9
13517,2023-07-18 05:00:00,125,237,8,12,539,450,89,10
13518,2023-07-18 06:00:00,59,226,5,19,762,626,136,12
13519,2023-07-18 07:00:00,148,234,9,12,798,598,200,11
13520,2023-07-18 08:00:00,79,212,9,18,633,464,169,11
13521,2023-07-18 09:00:00,120,146,10,16,757,636,121,5
13522,2023-07-18 10:00:00,83,235,10,11,630,523,107,5
13523,2023-07-18 11:00:00,76,268,13,13,686,505,181,13
13524,2023-07-18 12:00:00,66,245,7,10,697,615,82,7
13525,2023-07-18 13:00:00,96,297,7,15,562,442,120,9
13526,2023-07-18 14:00:00,109,284,13,11,549,427,122,11
13527,2023-07-18 15:00:00,124,225,8,17,672,536,136,7
13528,2023-07-18 16:00:00,126,219,8,14,523,399,124,9
13529,2023-07-18 17:00:00,144,102,11,14,701,570,131,9
13530,2023-07-18 18:00:00,95,176,8,10,761,588,173,11
13531,2023-07-18 19:00:00,126,226,14,16,572,463,109,5
13532,2023-07-18 20:00:00,148,205,14,17,535,431,104,12
13533,2023-07-18 21:00:00,103,278,12,14,500,433,67,8
13534,2023-07-18 22:00:00,54,126,7,17,694,567,127,6
13535,2023-07-18 23:00:00,113,286,8,19,706,562,144,14
13536,2023-07-19 00:00:00,113,254,6,11,621,477,144,8
13537,2023-07-19 01:00:00,105,251,5,12,513,367,146,9
13538,2023-07-19 02:00:00,66,175,7,19,576,471,105,8
13539,2023-07-19 03:00:00,59,137,11,19,646,537,109,10
13540,2023-07-19 04:00:00,147,190,14,13,641,484,157,11
13541,2023-07-19 05:00:00,145,203,10,13,725,521,204,14
13542,2023-07-19 06:00:00,76,148,8,11,773,563,210,14
13543,2023-07-19 07:00:00,77,284,11,17,669,532,137,11
13544,2023-07-19 08:00:00,69,151,9,16,525,470,55,12
13545,2023-07-19 09:00:00,58,112,6,19,654,564,90,13
13546,2023-07-19 10:00:00,132,189,6,13,634,495,139,10
13547,2023-07-19 11:00:00,69,138,14,16,551,420,131,7
13548,2023-07-19 12:00:00,55,218,10,14,546,489,57,10
13549,2023-07-19 13:00:00,104,131,6,19,667,580,87,9
13550,2023-07-19 14:00:00,117,126,8,13,633,503,130,14
13551,2023-07-19 15:00:00,103,197,12,15,780,701,79,13
13552,2023-07-19 16:00:00,114,222,12,11,763,594,169,9
13553,2023-07-19 17:00:00,127,172,5,15,687,550,137,12
13554,2023-07-19 18:00:00,94,185,14,11,641,463,178,13
13555,2023-07-19 19:00:00,106,183,10,10,646,561,85,11
13556,2023-07-19 20:00:00,119,210,11,15,665,466,199,12
13557,2023-07-19 21:00:00,111,280,9,15,719,547,172,13
13558,2023-07-19 22:00:00,64,155,7,11,567,498,69,9
13559,2023-07-19 23:00:00,141,265,9,16,656,470,186,11
13560,2023-07-20 00:00:00,149,120,9,11,751,672,79,11
13561,2023-07-20 01:00:00,52,225,9,17,719,582,137,12
13562,2023-07-20 02:00:00,107,139,7,10,713,602,111,11
13563,2023-07-20 03:00:00,54,156,12,19,604,443,161,5
13564,2023-07-20 04:00:00,121,265,12,15,708,595,113,12
13565,2023-07-20 05:00:00,89,173,7,10,573,506,67,14
13566,2023-07-20 06:00:00,144,209,12,15,575,433,142,7
13567,2023-07-20 07:00:00,74,146,5,16,574,408,166,5
13568,2023-07-20 08:00:00,64,276,10,17,723,586,137,5
13569,2023-07-20 09:00:00,112,225,14,13,697,556,141,11
13570,2023-07-20 10:00:00,112,272,12,14,628,503,125,8
13571,2023-07-20 11:00:00,131,206,8,14,589,431,158,10
13572,2023-07-20 12:00:00,102,120,7,15,744,530,214,5
13573,2023-07-20 13:00:00,98,111,13,16,700,541,159,9
13574,2023-07-20 14:00:00,123,253,7,14,521,379,142,11
13575,2023-07-20 15:00:00,77,262,12,10,637,476,161,12
13576,2023-07-20 16:00:00,56,281,6,17,529,403,126,6
13577,2023-07-20 17:00:00,139,155,14,12,582,433,149,14
13578,2023-07-20 18:00:00,97,199,10,14,604,537,67,13
13579,2023-07-20 19:00:00,131,182,5,10,706,528,178,12
13580,2023-07-20 20:00:00,94,230,14,13,504,436,68,14
13581,2023-07-20 21:00:00,52,126,8,10,667,520,147,9
13582,2023-07-20 22:00:00,57,299,12,19,691,541,150,12
13583,2023-07-20 23:00:00,110,109,13,18,691,613,78,6
13584,2023-07-21 00:00:00,65,174,5,19,746,617,129,7
13585,2023-07-21 01:00:00,127,141,10,14,678,508,170,5
13586,2023-07-21 02:00:00,126,282,14,15,606,447,159,14
13587,2023-07-21 03:00:00,119,190,6,14,514,461,53,13
13588,2023-07-21 04:00:00,59,246,7,15,660,559,101,9
13589,2023-07-21 05:00:00,106,250,8,18,566,473,93,13
13590,2023-07-21 06:00:00,111,226,10,19,626,515,111,9
13591,2023-07-21 07:00:00,141,158,8,18,678,590,88,10
13592,2023-07-21 08:00:00,59,269,9,15,527,469,58,10
13593,2023-07-21 09:00:00,74,272,6,13,685,615,70,11
13594,2023-07-21 10:00:00,110,283,7,15,706,570,136,5
13595,2023-07-21 11:00:00,131,131,13,12,702,581,121,11
13596,2023-07-21 12:00:00,121,184,12,15,586,448,138,8
13597,2023-07-21 13:00:00,66,211,6,16,682,508,174,7
13598,2023-07-21 14:00:00,149,219,5,12,540,421,119,13
13599,2023-07-21 15:00:00,68,114,13,13,796,638,158,14
13600,2023-07-21 16:00:00,117,241,13,18,649,566,83,11
13601,2023-07-21 17:00:00,105,129,14,14,605,428,177,9
13602,2023-07-21 18:00:00,111,204,8,17,604,479,125,14
13603,2023-07-21 19:00:00,130,144,8,17,579,486,93,8
13604,2023-07-21 20:00:00,91,194,11,12,612,442,170,6
13605,2023-07-21 21:00:00,82,245,13,18,782,630,152,13
13606,2023-07-21 22:00:00,73,250,12,19,643,506,137,11
13607,2023-07-21 23:00:00,127,268,11,16,709,539,170,6
13608,2023-07-22 00:00:00,78,231,11,18,788,626,162,9
13609,2023-07-22 01:00:00,139,261,12,10,593,521,72,7
13610,2023-07-22 02:00:00,104,182,12,15,555,479,76,7
13611,2023-07-22 03:00:00,58,223,6,11,600,422,178,14
13612,2023-07-22 04:00:00,89,204,5,16,773,568,205,14
13613,2023-07-22 05:00:00,80,106,7,18,503,440,63,7
13614,2023-07-22 06:00:00,121,125,8,19,638,535,103,10
13615,2023-07-22 07:00:00,63,288,7,11,607,541,66,13
13616,2023-07-22 08:00:00,66,121,12,12,686,497,189,14
13617,2023-07-22 09:00:00,88,297,14,12,539,381,158,8
13618,2023-07-22 10:00:00,121,288,10,17,653,531,122,9
13619,2023-07-22 11:00:00,56,267,6,19,632,515,117,11
13620,2023-07-22 12:00:00,124,136,9,18,707,597,110,7
13621,2023-07-22 13:00:00,111,174,8,16,792,642,150,13
13622,2023-07-22 14:00:00,101,294,6,18,587,507,80,12
13623,2023-07-22 15:00:00,54,236,10,12,638,503,135,11
13624,2023-07-22 16:00:00,65,108,13,17,761,627,134,7
13625,2023-07-22 17:00:00,101,261,10,16,500,388,112,13
13626,2023-07-22 18:00:00,142,241,10,10,536,435,101,11
13627,2023-07-22 19:00:00,63,140,14,17,527,424,103,13
13628,2023-07-22 20:00:00,125,155,11,15,659,551,108,10
13629,2023-07-22 21:00:00,53,213,6,19,720,550,170,10
13630,2023-07-22 22:00:00,98,103,6,13,681,603,78,7
13631,2023-07-22 23:00:00,67,286,10,17,566,427,139,6
13632,2023-07-23 00:00:00,107,182,6,16,694,588,106,7
13633,2023-07-23 01:00:00,84,270,8,15,736,641,95,9
13634,2023-07-23 02:00:00,69,137,9,19,795,713,82,6
13635,2023-07-23 03:00:00,131,298,9,12,606,475,131,8
13636,2023-07-23 04:00:00,114,297,13,18,722,508,214,13
13637,2023-07-23 05:00:00,103,125,8,10,698,581,117,9
13638,2023-07-23 06:00:00,126,101,14,13,572,480,92,6
13639,2023-07-23 07:00:00,136,248,7,15,758,634,124,11
13640,2023-07-23 08:00:00,79,289,14,12,669,550,119,6
13641,2023-07-23 09:00:00,71,106,11,14,680,592,88,9
13642,2023-07-23 10:00:00,58,296,8,15,535,472,63,9
13643,2023-07-23 11:00:00,63,293,7,12,767,630,137,5
13644,2023-07-23 12:00:00,66,106,6,19,505,360,145,7
13645,2023-07-23 13:00:00,120,208,7,17,661,476,185,8
13646,2023-07-23 14:00:00,119,288,13,18,530,408,122,10
13647,2023-07-23 15:00:00,138,166,6,12,548,434,114,9
13648,2023-07-23 16:00:00,70,110,7,15,747,575,172,10
13649,2023-07-23 17:00:00,55,134,9,16,754,567,187,12
13650,2023-07-23 18:00:00,81,299,7,11,619,436,183,5
13651,2023-07-23 19:00:00,112,233,13,12,695,618,77,14
13652,2023-07-23 20:00:00,56,113,10,16,522,402,120,13
13653,2023-07-23 21:00:00,83,296,11,19,592,459,133,11
13654,2023-07-23 22:00:00,93,299,11,17,601,442,159,6
13655,2023-07-23 23:00:00,89,146,10,14,565,447,118,5
13656,2023-07-24 00:00:00,50,204,10,12,596,502,94,10
13657,2023-07-24 01:00:00,67,145,6,15,715,576,139,11
13658,2023-07-24 02:00:00,124,193,8,15,718,622,96,14
13659,2023-07-24 03:00:00,74,241,6,18,514,405,109,6
13660,2023-07-24 04:00:00,76,128,10,13,580,459,121,5
13661,2023-07-24 05:00:00,53,290,11,11,644,459,185,5
13662,2023-07-24 06:00:00,101,247,5,10,762,606,156,8
13663,2023-07-24 07:00:00,131,188,10,17,697,620,77,8
13664,2023-07-24 08:00:00,123,201,5,12,732,535,197,9
13665,2023-07-24 09:00:00,105,179,13,13,705,567,138,10
13666,2023-07-24 10:00:00,119,261,9,10,561,478,83,8
13667,2023-07-24 11:00:00,90,244,10,13,581,509,72,9
13668,2023-07-24 12:00:00,140,208,11,19,737,542,195,10
13669,2023-07-24 13:00:00,124,265,7,18,502,423,79,14
13670,2023-07-24 14:00:00,138,293,13,11,515,449,66,7
13671,2023-07-24 15:00:00,54,203,10,18,558,450,108,13
13672,2023-07-24 16:00:00,132,135,14,11,583,511,72,13
13673,2023-07-24 17:00:00,135,141,11,14,747,650,97,6
13674,2023-07-24 18:00:00,106,179,9,16,516,385,131,12
13675,2023-07-24 19:00:00,57,107,11,15,690,486,204,5
13676,2023-07-24 20:00:00,138,204,6,16,596,525,71,11
13677,2023-07-24 21:00:00,92,273,9,12,725,519,206,8
13678,2023-07-24 22:00:00,120,289,9,18,695,505,190,5
13679,2023-07-24 23:00:00,136,192,9,15,636,475,161,7
13680,2023-07-25 00:00:00,147,161,14,12,721,569,152,9
13681,2023-07-25 01:00:00,111,288,12,16,787,683,104,10
13682,2023-07-25 02:00:00,67,260,11,16,681,553,128,7
13683,2023-07-25 03:00:00,122,111,5,14,609,508,101,11
13684,2023-07-25 04:00:00,138,120,10,13,722,642,80,6
13685,2023-07-25 05:00:00,90,179,8,18,772,624,148,13
13686,2023-07-25 06:00:00,131,277,6,14,534,471,63,12
13687,2023-07-25 07:00:00,133,241,8,14,634,464,170,13
13688,2023-07-25 08:00:00,93,110,8,14,560,466,94,10
13689,2023-07-25 09:00:00,112,196,10,13,575,457,118,13
13690,2023-07-25 10:00:00,65,298,12,11,599,534,65,7
13691,2023-07-25 11:00:00,75,143,7,19,772,624,148,13
13692,2023-07-25 12:00:00,116,254,11,11,536,384,152,10
13693,2023-07-25 13:00:00,70,231,5,18,748,583,165,11
13694,2023-07-25 14:00:00,75,122,11,11,653,513,140,9
13695,2023-07-25 15:00:00,91,189,12,16,568,411,157,6
13696,2023-07-25 16:00:00,123,107,9,15,548,435,113,11
13697,2023-07-25 17:00:00,50,244,11,13,741,615,126,13
13698,2023-07-25 18:00:00,56,155,12,14,757,563,194,11
13699,2023-07-25 19:00:00,80,253,10,12,634,554,80,13
13700,2023-07-25 20:00:00,141,147,7,10,782,630,152,10
13701,2023-07-25 21:00:00,58,213,13,18,504,425,79,7
13702,2023-07-25 22:00:00,108,244,10,11,755,596,159,9
13703,2023-07-25 23:00:00,131,220,5,10,740,612,128,8
13704,2023-07-26 00:00:00,112,134,5,16,773,601,172,5
13705,2023-07-26 01:00:00,134,275,6,16,782,691,91,10
13706,2023-07-26 02:00:00,62,165,6,18,626,488,138,11
13707,2023-07-26 03:00:00,112,245,11,19,652,553,99,12
13708,2023-07-26 04:00:00,110,126,8,10,542,394,148,6
13709,2023-07-26 05:00:00,116,115,8,13,568,427,141,11
13710,2023-07-26 06:00:00,106,140,14,12,755,658,97,9
13711,2023-07-26 07:00:00,85,201,8,11,713,582,131,13
13712,2023-07-26 08:00:00,108,291,12,18,727,621,106,9
13713,2023-07-26 09:00:00,105,141,13,16,785,635,150,12
13714,2023-07-26 10:00:00,59,264,6,19,698,501,197,12
13715,2023-07-26 11:00:00,102,273,8,11,754,574,180,13
13716,2023-07-26 12:00:00,51,173,14,15,672,527,145,13
13717,2023-07-26 13:00:00,122,211,14,19,676,537,139,13
13718,2023-07-26 14:00:00,135,230,14,16,690,506,184,9
13719,2023-07-26 15:00:00,137,276,5,13,507,436,71,5
13720,2023-07-26 16:00:00,61,112,7,13,678,500,178,8
13721,2023-07-26 17:00:00,81,114,10,11,688,549,139,11
13722,2023-07-26 18:00:00,60,251,6,12,794,679,115,10
13723,2023-07-26 19:00:00,136,299,7,13,676,578,98,6
13724,2023-07-26 20:00:00,75,266,12,10,592,434,158,9
13725,2023-07-26 21:00:00,112,229,10,16,570,468,102,10
13726,2023-07-26 22:00:00,104,117,14,14,670,597,73,13
13727,2023-07-26 23:00:00,57,263,12,14,613,503,110,10
13728,2023-07-27 00:00:00,74,111,8,15,567,398,169,7
13729,2023-07-27 01:00:00,106,166,13,15,622,436,186,8
13730,2023-07-27 02:00:00,93,197,7,13,526,438,88,14
13731,2023-07-27 03:00:00,130,293,14,16,779,605,174,14
13732,2023-07-27 04:00:00,62,196,8,16,544,455,89,11
13733,2023-07-27 05:00:00,77,112,13,13,680,496,184,14
13734,2023-07-27 06:00:00,120,219,6,15,674,500,174,11
13735,2023-07-27 07:00:00,131,171,9,18,559,459,100,7
13736,2023-07-27 08:00:00,134,110,10,16,693,496,197,5
13737,2023-07-27 09:00:00,53,294,8,13,616,453,163,10
13738,2023-07-27 10:00:00,134,162,11,14,795,567,228,10
13739,2023-07-27 11:00:00,72,235,13,16,554,439,115,7
13740,2023-07-27 12:00:00,133,252,8,13,672,561,111,9
13741,2023-07-27 13:00:00,99,237,10,17,577,510,67,13
13742,2023-07-27 14:00:00,62,162,10,12,735,631,104,13
13743,2023-07-27 15:00:00,82,156,12,13,683,519,164,11
13744,2023-07-27 16:00:00,115,261,12,10,767,541,226,10
13745,2023-07-27 17:00:00,124,232,13,12,528,451,77,7
13746,2023-07-27 18:00:00,128,104,12,17,743,638,105,7
13747,2023-07-27 19:00:00,72,111,12,19,665,540,125,13
13748,2023-07-27 20:00:00,129,258,13,14,730,545,185,12
13749,2023-07-27 21:00:00,56,249,10,19,699,580,119,12
13750,2023-07-27 22:00:00,148,287,7,14,756,561,195,14
13751,2023-07-27 23:00:00,131,244,13,15,571,481,90,5
13752,2023-07-28 00:00:00,66,259,11,13,580,439,141,5
13753,2023-07-28 01:00:00,82,141,12,18,768,632,136,5
13754,2023-07-28 02:00:00,137,114,12,18,726,633,93,8
13755,2023-07-28 03:00:00,130,115,14,17,734,644,90,10
13756,2023-07-28 04:00:00,127,185,11,19,567,491,76,10
13757,2023-07-28 05:00:00,113,237,6,15,797,711,86,7
13758,2023-07-28 06:00:00,51,155,5,14,693,606,87,10
13759,2023-07-28 07:00:00,136,193,10,17,760,642,118,8
13760,2023-07-28 08:00:00,66,113,12,17,569,496,73,13
13761,2023-07-28 09:00:00,148,294,7,10,768,599,169,7
13762,2023-07-28 10:00:00,75,108,14,18,607,526,81,9
13763,2023-07-28 11:00:00,111,110,12,15,617,448,169,7
13764,2023-07-28 12:00:00,127,200,6,15,643,496,147,5
13765,2023-07-28 13:00:00,100,121,12,15,604,483,121,14
13766,2023-07-28 14:00:00,112,132,9,18,625,527,98,5
13767,2023-07-28 15:00:00,110,133,12,14,600,480,120,9
13768,2023-07-28 16:00:00,69,161,7,17,602,532,70,13
13769,2023-07-28 17:00:00,88,294,6,13,700,557,143,11
13770,2023-07-28 18:00:00,134,225,9,17,616,476,140,7
13771,2023-07-28 19:00:00,60,217,10,16,798,569,229,13
13772,2023-07-28 20:00:00,90,221,14,16,694,584,110,14
13773,2023-07-28 21:00:00,50,227,6,17,740,613,127,7
13774,2023-07-28 22:00:00,73,200,13,11,523,448,75,9
13775,2023-07-28 23:00:00,128,188,5,16,759,548,211,8
13776,2023-07-29 00:00:00,81,204,6,19,594,449,145,11
13777,2023-07-29 01:00:00,65,194,11,18,740,537,203,6
13778,2023-07-29 02:00:00,53,204,9,11,654,458,196,13
13779,2023-07-29 03:00:00,112,220,12,15,630,512,118,6
13780,2023-07-29 04:00:00,78,100,8,15,654,517,137,9
13781,2023-07-29 05:00:00,127,186,13,10,750,644,106,6
13782,2023-07-29 06:00:00,80,112,10,16,547,477,70,10
13783,2023-07-29 07:00:00,127,191,7,16,540,448,92,5
13784,2023-07-29 08:00:00,62,266,8,17,602,428,174,10
13785,2023-07-29 09:00:00,65,191,6,13,750,659,91,7
13786,2023-07-29 10:00:00,61,235,13,15,784,551,233,7
13787,2023-07-29 11:00:00,60,161,5,19,518,409,109,5
13788,2023-07-29 12:00:00,147,206,5,11,632,508,124,10
13789,2023-07-29 13:00:00,72,233,11,11,782,701,81,12
13790,2023-07-29 14:00:00,85,250,6,12,559,452,107,12
13791,2023-07-29 15:00:00,109,118,12,19,541,454,87,6
13792,2023-07-29 16:00:00,71,221,12,17,639,457,182,12
13793,2023-07-29 17:00:00,123,179,10,19,648,580,68,9
13794,2023-07-29 18:00:00,144,193,11,11,529,445,84,14
13795,2023-07-29 19:00:00,119,277,8,13,575,513,62,10
13796,2023-07-29 20:00:00,124,123,5,10,580,418,162,12
13797,2023-07-29 21:00:00,59,255,12,19,523,459,64,11
13798,2023-07-29 22:00:00,90,147,13,16,583,480,103,6
13799,2023-07-29 23:00:00,85,108,10,11,731,553,178,6
13800,2023-07-30 00:00:00,112,255,11,13,568,510,58,8
13801,2023-07-30 01:00:00,93,255,7,14,798,700,98,11
13802,2023-07-30 02:00:00,73,148,12,17,698,488,210,6
13803,2023-07-30 03:00:00,65,224,8,10,716,524,192,12
13804,2023-07-30 04:00:00,86,238,5,19,580,521,59,9
13805,2023-07-30 05:00:00,87,112,5,11,531,445,86,11
13806,2023-07-30 06:00:00,84,253,11,19,778,652,126,13
13807,2023-07-30 07:00:00,119,162,9,18,723,542,181,12
13808,2023-07-30 08:00:00,121,143,5,11,678,497,181,13
13809,2023-07-30 09:00:00,50,265,13,14,743,660,83,14
13810,2023-07-30 10:00:00,59,137,12,11,633,555,78,9
13811,2023-07-30 11:00:00,125,217,8,12,781,694,87,7
13812,2023-07-30 12:00:00,92,102,5,19,582,447,135,6
13813,2023-07-30 13:00:00,68,259,7,14,710,618,92,13
13814,2023-07-30 14:00:00,56,186,13,10,530,442,88,13
13815,2023-07-30 15:00:00,93,281,14,14,555,389,166,8
13816,2023-07-30 16:00:00,93,212,5,16,553,417,136,7
13817,2023-07-30 17:00:00,140,239,13,12,782,585,197,10
13818,2023-07-30 18:00:00,71,228,11,16,749,613,136,12
13819,2023-07-30 19:00:00,50,137,6,19,625,466,159,8
13820,2023-07-30 20:00:00,96,209,5,16,707,515,192,12
13821,2023-07-30 21:00:00,100,208,14,17,662,472,190,12
13822,2023-07-30 22:00:00,70,252,6,19,604,517,87,5
13823,2023-07-30 23:00:00,137,292,8,15,605,493,112,10
13824,2023-07-31 00:00:00,111,116,14,11,633,564,69,12
13825,2023-07-31 01:00:00,126,124,10,15,748,665,83,10
13826,2023-07-31 02:00:00,64,236,6,13,772,679,93,11
13827,2023-07-31 03:00:00,125,271,12,10,774,573,201,7
13828,2023-07-31 04:00:00,88,290,8,11,503,386,117,11
13829,2023-07-31 05:00:00,56,136,8,10,590,427,163,13
13830,2023-07-31 06:00:00,103,151,6,11,764,575,189,6
13831,2023-07-31 07:00:00,89,171,6,15,540,411,129,8
13832,2023-07-31 08:00:00,147,164,8,10,727,534,193,6
13833,2023-07-31 09:00:00,124,155,10,11,700,546,154,12
13834,2023-07-31 10:00:00,103,212,12,11,532,411,121,14
13835,2023-07-31 11:00:00,115,286,13,11,692,593,99,8
13836,2023-07-31 12:00:00,114,283,5,10,665,478,187,7
13837,2023-07-31 13:00:00,50,209,8,11,744,601,143,9
13838,2023-07-31 14:00:00,105,265,11,18,699,523,176,9
13839,2023-07-31 15:00:00,131,281,14,18,662,562,100,14
13840,2023-07-31 16:00:00,145,119,7,19,677,536,141,12
13841,2023-07-31 17:00:00,113,139,14,19,521,425,96,12
13842,2023-07-31 18:00:00,129,297,13,17,634,522,112,11
13843,2023-07-31 19:00:00,99,138,5,19,573,409,164,14
13844,2023-07-31 20:00:00,148,259,14,12,657,474,183,5
13845,2023-07-31 21:00:00,132,242,13,13,590,449,141,5
13846,2023-07-31 22:00:00,55,174,12,19,577,476,101,10
13847,2023-07-31 23:00:00,83,259,8,16,755,634,121,11
13848,2023-08-01 00:00:00,127,216,5,11,778,617,161,7
13849,2023-08-01 01:00:00,137,298,13,19,752,588,164,14
13850,2023-08-01 02:00:00,129,295,10,10,714,557,157,7
13851,2023-08-01 03:00:00,130,131,8,13,562,457,105,8
13852,2023-08-01 04:00:00,97,273,5,19,751,640,111,6
13853,2023-08-01 05:00:00,113,212,7,10,504,363,141,8
13854,2023-08-01 06:00:00,89,152,11,15,750,641,109,9
13855,2023-08-01 07:00:00,69,158,14,14,586,509,77,8
13856,2023-08-01 08:00:00,117,237,12,10,703,617,86,12
13857,2023-08-01 09:00:00,138,222,11,15,546,416,130,6
13858,2023-08-01 10:00:00,72,265,10,10,583,443,140,10
13859,2023-08-01 11:00:00,108,227,12,18,711,627,84,7
13860,2023-08-01 12:00:00,86,192,6,17,623,506,117,5
13861,2023-08-01 13:00:00,147,112,14,13,523,409,114,7
13862,2023-08-01 14:00:00,91,191,6,13,593,440,153,10
13863,2023-08-01 15:00:00,119,298,6,19,681,498,183,8
13864,2023-08-01 16:00:00,130,255,8,16,641,528,113,5
13865,2023-08-01 17:00:00,136,106,11,10,751,559,192,6
13866,2023-08-01 18:00:00,98,143,5,14,614,498,116,14
13867,2023-08-01 19:00:00,89,284,14,11,600,453,147,12
13868,2023-08-01 20:00:00,86,292,10,15,777,615,162,13
13869,2023-08-01 21:00:00,121,197,12,13,516,379,137,12
13870,2023-08-01 22:00:00,80,181,11,17,790,662,128,8
13871,2023-08-01 23:00:00,65,249,9,18,530,428,102,8
13872,2023-08-02 00:00:00,120,280,6,13,698,577,121,10
13873,2023-08-02 01:00:00,119,249,8,16,523,431,92,13
13874,2023-08-02 02:00:00,140,257,9,12,596,446,150,12
13875,2023-08-02 03:00:00,126,235,8,19,639,498,141,14
13876,2023-08-02 04:00:00,73,100,11,12,628,514,114,5
13877,2023-08-02 05:00:00,60,270,8,16,654,524,130,5
13878,2023-08-02 06:00:00,58,265,11,12,600,507,93,11
13879,2023-08-02 07:00:00,137,207,12,10,713,501,212,9
13880,2023-08-02 08:00:00,139,174,5,16,528,470,58,7
13881,2023-08-02 09:00:00,84,244,13,12,767,621,146,14
13882,2023-08-02 10:00:00,149,180,8,13,676,560,116,12
13883,2023-08-02 11:00:00,127,213,11,12,582,424,158,13
13884,2023-08-02 12:00:00,112,181,6,16,523,378,145,7
13885,2023-08-02 13:00:00,97,296,12,14,585,438,147,11
13886,2023-08-02 14:00:00,136,286,8,17,596,532,64,12
13887,2023-08-02 15:00:00,83,119,5,15,794,697,97,9
13888,2023-08-02 16:00:00,57,222,8,12,742,549,193,13
13889,2023-08-02 17:00:00,98,194,14,12,719,632,87,9
13890,2023-08-02 18:00:00,116,141,12,15,650,492,158,13
13891,2023-08-02 19:00:00,148,211,8,11,624,547,77,6
13892,2023-08-02 20:00:00,104,192,8,13,680,591,89,7
13893,2023-08-02 21:00:00,148,250,5,19,620,436,184,11
13894,2023-08-02 22:00:00,122,271,6,13,617,479,138,11
13895,2023-08-02 23:00:00,149,292,6,17,687,484,203,11
13896,2023-08-03 00:00:00,130,114,5,16,526,465,61,14
13897,2023-08-03 01:00:00,80,269,9,10,695,498,197,13
13898,2023-08-03 02:00:00,94,153,8,18,666,467,199,9
13899,2023-08-03 03:00:00,147,290,11,12,513,387,126,7
13900,2023-08-03 04:00:00,71,168,8,17,687,540,147,7
13901,2023-08-03 05:00:00,76,108,10,18,672,495,177,12
13902,2023-08-03 06:00:00,51,124,11,19,690,533,157,14
13903,2023-08-03 07:00:00,134,298,5,10,680,598,82,7
13904,2023-08-03 08:00:00,86,205,11,14,679,524,155,5
13905,2023-08-03 09:00:00,145,121,11,17,771,582,189,5
13906,2023-08-03 10:00:00,57,136,13,14,592,422,170,9
13907,2023-08-03 11:00:00,117,297,14,14,656,547,109,10
13908,2023-08-03 12:00:00,69,224,12,12,513,438,75,10
13909,2023-08-03 13:00:00,128,203,7,18,748,650,98,6
13910,2023-08-03 14:00:00,139,181,14,13,794,682,112,14
13911,2023-08-03 15:00:00,131,244,12,15,677,568,109,11
13912,2023-08-03 16:00:00,126,136,13,10,516,365,151,10
13913,2023-08-03 17:00:00,50,242,14,17,589,461,128,9
13914,2023-08-03 18:00:00,68,108,12,18,515,451,64,6
13915,2023-08-03 19:00:00,139,205,7,18,573,513,60,8
13916,2023-08-03 20:00:00,131,184,7,17,664,582,82,12
13917,2023-08-03 21:00:00,130,269,6,14,529,388,141,12
13918,2023-08-03 22:00:00,75,147,14,12,555,396,159,9
13919,2023-08-03 23:00:00,114,274,5,12,628,550,78,12
13920,2023-08-04 00:00:00,91,184,6,11,764,600,164,13
13921,2023-08-04 01:00:00,141,286,12,17,652,580,72,6
13922,2023-08-04 02:00:00,138,250,6,17,662,579,83,14
13923,2023-08-04 03:00:00,118,179,9,10,741,588,153,9
13924,2023-08-04 04:00:00,80,202,10,18,750,561,189,9
13925,2023-08-04 05:00:00,81,204,9,14,556,396,160,7
13926,2023-08-04 06:00:00,70,233,10,11,619,484,135,14
13927,2023-08-04 07:00:00,66,161,13,18,798,579,219,7
13928,2023-08-04 08:00:00,110,100,7,13,780,668,112,11
13929,2023-08-04 09:00:00,104,145,10,14,546,399,147,12
13930,2023-08-04 10:00:00,109,108,10,13,647,533,114,8
13931,2023-08-04 11:00:00,109,109,7,11,642,556,86,9
13932,2023-08-04 12:00:00,146,237,11,17,643,478,165,10
13933,2023-08-04 13:00:00,74,206,7,18,664,542,122,6
13934,2023-08-04 14:00:00,147,246,6,12,706,523,183,13
13935,2023-08-04 15:00:00,118,288,13,17,604,526,78,5
13936,2023-08-04 16:00:00,89,275,10,15,742,618,124,6
13937,2023-08-04 17:00:00,132,235,11,11,535,477,58,8
13938,2023-08-04 18:00:00,130,255,5,16,539,398,141,12
13939,2023-08-04 19:00:00,90,259,12,11,712,599,113,14
13940,2023-08-04 20:00:00,121,194,8,12,588,487,101,12
13941,2023-08-04 21:00:00,58,195,8,18,683,523,160,9
13942,2023-08-04 22:00:00,65,131,12,16,676,579,97,10
13943,2023-08-04 23:00:00,149,114,7,19,526,400,126,12
13944,2023-08-05 00:00:00,74,234,7,17,587,413,174,13
13945,2023-08-05 01:00:00,124,276,11,11,581,436,145,11
13946,2023-08-05 02:00:00,104,225,12,12,755,583,172,7
13947,2023-08-05 03:00:00,129,200,8,16,647,528,119,13
13948,2023-08-05 04:00:00,120,210,5,17,719,633,86,5
13949,2023-08-05 05:00:00,149,111,12,13,746,665,81,13
13950,2023-08-05 06:00:00,119,244,11,13,630,513,117,6
13951,2023-08-05 07:00:00,136,157,13,18,786,617,169,12
13952,2023-08-05 08:00:00,112,223,13,14,504,426,78,8
13953,2023-08-05 09:00:00,70,281,14,10,785,574,211,5
13954,2023-08-05 10:00:00,58,266,9,10,758,542,216,9
13955,2023-08-05 11:00:00,142,104,9,13,510,454,56,5
13956,2023-08-05 12:00:00,107,190,5,14,765,647,118,11
13957,2023-08-05 13:00:00,78,135,6,16,738,528,210,7
13958,2023-08-05 14:00:00,79,161,6,15,667,473,194,6
13959,2023-08-05 15:00:00,76,254,9,17,607,496,111,12
13960,2023-08-05 16:00:00,73,166,9,11,632,474,158,7
13961,2023-08-05 17:00:00,128,115,9,17,735,576,159,6
13962,2023-08-05 18:00:00,51,292,13,11,573,421,152,13
13963,2023-08-05 19:00:00,115,242,11,12,638,558,80,11
13964,2023-08-05 20:00:00,112,253,10,17,655,570,85,11
13965,2023-08-05 21:00:00,66,223,12,15,674,542,132,14
13966,2023-08-05 22:00:00,56,163,12,11,618,459,159,10
13967,2023-08-05 23:00:00,94,212,5,19,570,480,90,7
13968,2023-08-06 00:00:00,91,152,7,15,681,600,81,5
13969,2023-08-06 01:00:00,90,113,7,16,534,380,154,12
13970,2023-08-06 02:00:00,108,201,6,16,585,497,88,11
13971,2023-08-06 03:00:00,96,242,8,12,722,539,183,10
13972,2023-08-06 04:00:00,117,155,14,16,548,454,94,11
13973,2023-08-06 05:00:00,129,116,12,14,541,441,100,6
13974,2023-08-06 06:00:00,134,259,6,11,595,461,134,9
13975,2023-08-06 07:00:00,69,171,12,19,760,567,193,12
13976,2023-08-06 08:00:00,103,109,8,17,781,656,125,8
13977,2023-08-06 09:00:00,54,271,10,14,543,407,136,7
13978,2023-08-06 10:00:00,111,289,13,19,610,458,152,13
13979,2023-08-06 11:00:00,99,272,11,13,571,501,70,13
13980,2023-08-06 12:00:00,66,261,11,18,796,593,203,13
13981,2023-08-06 13:00:00,124,192,10,14,555,393,162,10
13982,2023-08-06 14:00:00,94,276,13,13,756,545,211,11
13983,2023-08-06 15:00:00,54,228,9,10,688,488,200,8
13984,2023-08-06 16:00:00,73,167,6,15,723,509,214,7
13985,2023-08-06 17:00:00,75,237,10,18,587,449,138,14
13986,2023-08-06 18:00:00,72,169,14,12,509,433,76,9
13987,2023-08-06 19:00:00,103,206,10,10,741,578,163,9
13988,2023-08-06 20:00:00,51,237,6,11,575,493,82,9
13989,2023-08-06 21:00:00,95,230,5,10,705,627,78,13
13990,2023-08-06 22:00:00,80,280,10,14,561,504,57,10
13991,2023-08-06 23:00:00,83,146,13,11,640,570,70,8
13992,2023-08-07 00:00:00,81,141,7,16,526,442,84,13
13993,2023-08-07 01:00:00,79,154,9,13,682,567,115,5
13994,2023-08-07 02:00:00,97,235,14,10,500,390,110,8
13995,2023-08-07 03:00:00,70,115,14,14,521,441,80,11
13996,2023-08-07 04:00:00,50,276,8,11,687,614,73,8
13997,2023-08-07 05:00:00,74,191,6,14,674,565,109,6
13998,2023-08-07 06:00:00,66,234,5,16,568,505,63,12
13999,2023-08-07 07:00:00,98,122,8,14,619,437,182,12
14000,2023-08-07 08:00:00,86,119,7,14,685,523,162,5
14001,2023-08-07 09:00:00,135,294,5,11,545,446,99,12
14002,2023-08-07 10:00:00,106,101,8,18,704,573,131,5
14003,2023-08-07 11:00:00,112,126,8,12,626,498,128,11
14004,2023-08-07 12:00:00,124,204,6,19,790,622,168,5
14005,2023-08-07 13:00:00,86,293,9,18,677,543,134,9
14006,2023-08-07 14:00:00,87,292,13,10,701,506,195,7
14007,2023-08-07 15:00:00,84,132,6,15,699,574,125,8
14008,2023-08-07 16:00:00,124,160,11,12,543,435,108,6
14009,2023-08-07 17:00:00,127,154,12,10,783,641,142,14
14010,2023-08-07 18:00:00,145,133,13,19,647,456,191,9
14011,2023-08-07 19:00:00,96,266,9,17,731,568,163,14
14012,2023-08-07 20:00:00,124,216,5,16,682,561,121,12
14013,2023-08-07 21:00:00,98,286,9,12,680,551,129,10
14014,2023-08-07 22:00:00,95,212,13,18,544,418,126,11
14015,2023-08-07 23:00:00,103,260,8,14,556,455,101,13
14016,2023-08-08 00:00:00,90,292,7,12,621,459,162,6
14017,2023-08-08 01:00:00,52,141,5,13,604,446,158,9
14018,2023-08-08 02:00:00,122,286,10,10,595,464,131,12
14019,2023-08-08 03:00:00,90,267,11,12,764,588,176,10
14020,2023-08-08 04:00:00,65,274,8,16,759,656,103,13
14021,2023-08-08 05:00:00,141,160,8,18,784,602,182,8
14022,2023-08-08 06:00:00,60,146,14,13,568,438,130,9
14023,2023-08-08 07:00:00,138,268,11,18,721,544,177,5
14024,2023-08-08 08:00:00,70,225,13,10,628,440,188,11
14025,2023-08-08 09:00:00,90,113,7,15,776,559,217,10
14026,2023-08-08 10:00:00,67,104,14,12,640,561,79,13
14027,2023-08-08 11:00:00,129,288,12,19,509,357,152,14
14028,2023-08-08 12:00:00,113,252,8,19,547,472,75,5
14029,2023-08-08 13:00:00,98,232,6,18,742,643,99,7
14030,2023-08-08 14:00:00,108,121,12,13,677,560,117,14
14031,2023-08-08 15:00:00,51,210,5,19,530,386,144,9
14032,2023-08-08 16:00:00,127,204,8,16,575,482,93,6
14033,2023-08-08 17:00:00,108,134,5,17,659,562,97,14
14034,2023-08-08 18:00:00,69,241,14,12,758,656,102,5
14035,2023-08-08 19:00:00,105,112,8,15,737,573,164,6
14036,2023-08-08 20:00:00,74,137,6,17,612,497,115,11
14037,2023-08-08 21:00:00,84,133,9,11,567,437,130,10
14038,2023-08-08 22:00:00,147,174,6,13,576,501,75,8
14039,2023-08-08 23:00:00,81,101,11,17,712,600,112,6
14040,2023-08-09 00:00:00,75,240,7,13,733,545,188,5
14041,2023-08-09 01:00:00,146,268,14,14,627,559,68,12
14042,2023-08-09 02:00:00,131,189,11,15,759,545,214,14
14043,2023-08-09 03:00:00,89,224,11,12,684,513,171,9
14044,2023-08-09 04:00:00,91,296,12,19,698,606,92,9
14045,2023-08-09 05:00:00,140,295,11,15,756,656,100,10
14046,2023-08-09 06:00:00,125,113,8,13,716,603,113,14
14047,2023-08-09 07:00:00,115,165,5,19,627,511,116,13
14048,2023-08-09 08:00:00,65,165,11,19,612,478,134,13
14049,2023-08-09 09:00:00,84,188,11,13,666,565,101,6
14050,2023-08-09 10:00:00,112,121,8,14,746,575,171,12
14051,2023-08-09 11:00:00,57,188,7,15,509,437,72,6
14052,2023-08-09 12:00:00,134,243,6,12,762,567,195,14
14053,2023-08-09 13:00:00,97,209,11,10,540,389,151,9
14054,2023-08-09 14:00:00,67,295,5,10,774,608,166,13
14055,2023-08-09 15:00:00,55,267,9,18,771,555,216,6
14056,2023-08-09 16:00:00,53,281,14,17,784,604,180,14
14057,2023-08-09 17:00:00,148,114,14,11,719,635,84,8
14058,2023-08-09 18:00:00,93,134,13,11,736,612,124,9
14059,2023-08-09 19:00:00,57,192,8,14,780,676,104,8
14060,2023-08-09 20:00:00,66,221,13,12,782,655,127,10
14061,2023-08-09 21:00:00,139,196,12,18,616,512,104,7
14062,2023-08-09 22:00:00,54,276,14,17,698,501,197,8
14063,2023-08-09 23:00:00,104,133,11,17,768,601,167,14
14064,2023-08-10 00:00:00,68,135,11,15,545,485,60,5
14065,2023-08-10 01:00:00,125,147,8,11,538,445,93,6
14066,2023-08-10 02:00:00,65,140,6,12,601,497,104,11
14067,2023-08-10 03:00:00,114,215,10,18,585,522,63,10
14068,2023-08-10 04:00:00,132,181,6,11,582,514,68,9
14069,2023-08-10 05:00:00,61,210,12,11,604,494,110,10
14070,2023-08-10 06:00:00,104,120,8,14,700,626,74,11
14071,2023-08-10 07:00:00,111,215,14,13,556,415,141,11
14072,2023-08-10 08:00:00,116,130,5,12,546,391,155,12
14073,2023-08-10 09:00:00,99,129,8,15,594,504,90,9
14074,2023-08-10 10:00:00,91,283,7,10,690,617,73,7
14075,2023-08-10 11:00:00,95,226,11,13,619,539,80,6
14076,2023-08-10 12:00:00,94,185,14,14,790,626,164,13
14077,2023-08-10 13:00:00,65,160,11,18,569,465,104,13
14078,2023-08-10 14:00:00,69,153,14,19,523,412,111,5
14079,2023-08-10 15:00:00,101,192,7,17,714,588,126,9
14080,2023-08-10 16:00:00,117,268,13,14,692,585,107,8
14081,2023-08-10 17:00:00,68,274,11,16,706,582,124,10
14082,2023-08-10 18:00:00,115,250,9,12,685,572,113,12
14083,2023-08-10 19:00:00,108,170,13,19,690,606,84,6
14084,2023-08-10 20:00:00,119,272,12,17,525,428,97,12
14085,2023-08-10 21:00:00,55,125,9,14,636,540,96,12
14086,2023-08-10 22:00:00,73,184,10,13,531,409,122,10
14087,2023-08-10 23:00:00,82,136,6,13,797,689,108,10
14088,2023-08-11 00:00:00,110,171,13,16,674,492,182,10
14089,2023-08-11 01:00:00,59,134,6,19,529,386,143,7
14090,2023-08-11 02:00:00,140,173,14,14,780,596,184,12
14091,2023-08-11 03:00:00,69,141,8,16,689,490,199,8
14092,2023-08-11 04:00:00,107,107,13,15,558,434,124,14
14093,2023-08-11 05:00:00,120,140,10,11,539,391,148,9
14094,2023-08-11 06:00:00,80,179,6,14,552,491,61,6
14095,2023-08-11 07:00:00,72,216,9,16,549,387,162,9
14096,2023-08-11 08:00:00,132,167,11,12,733,564,169,7
14097,2023-08-11 09:00:00,102,278,14,13,559,455,104,7
14098,2023-08-11 10:00:00,113,283,6,14,524,408,116,8
14099,2023-08-11 11:00:00,124,222,9,17,705,510,195,11
14100,2023-08-11 12:00:00,50,282,12,11,772,673,99,11
14101,2023-08-11 13:00:00,96,295,7,14,670,490,180,11
14102,2023-08-11 14:00:00,71,149,11,19,673,548,125,12
14103,2023-08-11 15:00:00,83,269,9,14,791,636,155,13
14104,2023-08-11 16:00:00,121,126,12,18,767,542,225,12
14105,2023-08-11 17:00:00,96,159,6,19,551,404,147,14
14106,2023-08-11 18:00:00,59,136,13,15,562,484,78,12
14107,2023-08-11 19:00:00,111,236,14,13,519,400,119,9
14108,2023-08-11 20:00:00,73,274,6,16,609,515,94,9
14109,2023-08-11 21:00:00,53,299,5,14,520,430,90,13
14110,2023-08-11 22:00:00,61,276,14,19,544,479,65,5
14111,2023-08-11 23:00:00,109,218,14,16,756,533,223,11
14112,2023-08-12 00:00:00,62,101,10,15,609,487,122,10
14113,2023-08-12 01:00:00,136,139,5,17,651,527,124,13
14114,2023-08-12 02:00:00,108,273,13,18,529,417,112,14
14115,2023-08-12 03:00:00,137,251,11,14,578,505,73,14
14116,2023-08-12 04:00:00,66,203,7,15,557,478,79,8
14117,2023-08-12 05:00:00,65,170,7,12,726,636,90,10
14118,2023-08-12 06:00:00,80,233,12,17,524,467,57,9
14119,2023-08-12 07:00:00,127,292,13,19,737,649,88,5
14120,2023-08-12 08:00:00,107,143,6,17,751,657,94,8
14121,2023-08-12 09:00:00,120,241,8,10,556,460,96,14
14122,2023-08-12 10:00:00,147,287,8,16,695,512,183,6
14123,2023-08-12 11:00:00,111,104,9,11,585,451,134,12
14124,2023-08-12 12:00:00,51,289,11,18,520,408,112,14
14125,2023-08-12 13:00:00,107,102,14,15,505,426,79,6
14126,2023-08-12 14:00:00,53,205,13,11,593,491,102,5
14127,2023-08-12 15:00:00,57,131,8,18,505,443,62,10
14128,2023-08-12 16:00:00,66,250,9,15,514,393,121,13
14129,2023-08-12 17:00:00,104,110,14,17,756,551,205,9
14130,2023-08-12 18:00:00,91,194,13,13,792,628,164,9
14131,2023-08-12 19:00:00,131,284,8,12,683,526,157,7
14132,2023-08-12 20:00:00,78,125,10,15,730,637,93,5
14133,2023-08-12 21:00:00,97,204,14,19,748,532,216,11
14134,2023-08-12 22:00:00,99,156,9,17,705,578,127,7
14135,2023-08-12 23:00:00,126,123,8,16,543,487,56,12
14136,2023-08-13 00:00:00,133,151,6,15,769,622,147,14
14137,2023-08-13 01:00:00,121,259,6,19,792,696,96,5
14138,2023-08-13 02:00:00,133,140,6,10,501,359,142,7
14139,2023-08-13 03:00:00,117,182,12,13,548,384,164,7
14140,2023-08-13 04:00:00,136,259,10,17,514,396,118,11
14141,2023-08-13 05:00:00,67,176,6,12,748,665,83,7
14142,2023-08-13 06:00:00,127,151,14,10,674,576,98,5
14143,2023-08-13 07:00:00,73,158,10,17,753,644,109,11
14144,2023-08-13 08:00:00,77,209,12,15,666,577,89,5
14145,2023-08-13 09:00:00,52,218,12,15,678,592,86,12
14146,2023-08-13 10:00:00,125,264,13,13,615,503,112,8
14147,2023-08-13 11:00:00,148,284,9,11,693,623,70,13
14148,2023-08-13 12:00:00,55,246,10,12,737,522,215,12
14149,2023-08-13 13:00:00,118,212,12,19,569,422,147,11
14150,2023-08-13 14:00:00,89,157,11,13,679,567,112,13
14151,2023-08-13 15:00:00,101,180,5,14,652,515,137,12
14152,2023-08-13 16:00:00,127,237,10,11,681,525,156,14
14153,2023-08-13 17:00:00,88,167,9,12,580,506,74,7
14154,2023-08-13 18:00:00,132,253,11,10,610,531,79,14
14155,2023-08-13 19:00:00,81,200,5,15,552,463,89,5
14156,2023-08-13 20:00:00,115,173,11,12,749,530,219,7
14157,2023-08-13 21:00:00,136,266,7,10,706,512,194,5
14158,2023-08-13 22:00:00,55,180,12,17,640,557,83,5
14159,2023-08-13 23:00:00,148,173,9,16,558,457,101,10
14160,2023-08-14 00:00:00,90,162,5,10,626,534,92,5
14161,2023-08-14 01:00:00,100,291,10,10,676,607,69,5
14162,2023-08-14 02:00:00,146,200,5,15,690,511,179,11
14163,2023-08-14 03:00:00,68,137,8,13,674,519,155,6
14164,2023-08-14 04:00:00,130,264,12,10,725,537,188,8
14165,2023-08-14 05:00:00,60,242,14,13,775,612,163,11
14166,2023-08-14 06:00:00,101,127,5,13,748,670,78,13
14167,2023-08-14 07:00:00,78,245,5,18,635,540,95,7
14168,2023-08-14 08:00:00,64,148,14,17,603,457,146,8
14169,2023-08-14 09:00:00,134,143,10,17,735,517,218,10
14170,2023-08-14 10:00:00,142,240,5,12,644,526,118,6
14171,2023-08-14 11:00:00,101,158,6,19,792,683,109,7
14172,2023-08-14 12:00:00,115,296,8,16,504,418,86,12
14173,2023-08-14 13:00:00,82,233,13,15,741,537,204,6
14174,2023-08-14 14:00:00,70,251,8,15,676,515,161,6
14175,2023-08-14 15:00:00,86,103,13,17,736,580,156,9
14176,2023-08-14 16:00:00,118,252,9,16,523,418,105,10
14177,2023-08-14 17:00:00,86,178,9,12,616,473,143,7
14178,2023-08-14 18:00:00,96,178,6,18,556,446,110,14
14179,2023-08-14 19:00:00,141,226,8,12,647,462,185,11
14180,2023-08-14 20:00:00,144,116,5,13,728,532,196,11
14181,2023-08-14 21:00:00,68,258,12,14,510,387,123,5
14182,2023-08-14 22:00:00,141,157,9,15,722,524,198,11
14183,2023-08-14 23:00:00,62,186,12,11,695,492,203,5
14184,2023-08-15 00:00:00,122,165,14,13,632,549,83,10
14185,2023-08-15 01:00:00,118,226,8,11,555,473,82,9
14186,2023-08-15 02:00:00,129,219,14,10,522,444,78,13
14187,2023-08-15 03:00:00,143,200,13,19,753,605,148,11
14188,2023-08-15 04:00:00,139,187,13,14,563,395,168,10
14189,2023-08-15 05:00:00,144,296,5,16,728,534,194,9
14190,2023-08-15 06:00:00,91,224,13,11,765,658,107,11
14191,2023-08-15 07:00:00,148,229,10,13,597,495,102,7
14192,2023-08-15 08:00:00,66,244,6,14,792,685,107,9
14193,2023-08-15 09:00:00,67,111,10,12,735,518,217,12
14194,2023-08-15 10:00:00,136,190,14,11,671,485,186,13
14195,2023-08-15 11:00:00,85,134,7,15,633,501,132,14
14196,2023-08-15 12:00:00,75,237,9,14,596,498,98,6
14197,2023-08-15 13:00:00,106,188,6,13,567,473,94,12
14198,2023-08-15 14:00:00,109,246,7,13,546,395,151,9
14199,2023-08-15 15:00:00,142,241,5,14,571,453,118,8
14200,2023-08-15 16:00:00,102,255,13,10,592,415,177,8
14201,2023-08-15 17:00:00,84,213,5,16,505,445,60,13
14202,2023-08-15 18:00:00,122,220,8,15,549,394,155,10
14203,2023-08-15 19:00:00,132,160,6,11,765,686,79,5
14204,2023-08-15 20:00:00,131,207,7,19,597,476,121,9
14205,2023-08-15 21:00:00,100,247,7,15,590,420,170,7
14206,2023-08-15 22:00:00,128,157,12,19,735,565,170,7
14207,2023-08-15 23:00:00,72,253,13,10,582,470,112,8
14208,2023-08-16 00:00:00,109,247,7,18,617,551,66,10
14209,2023-08-16 01:00:00,149,134,5,18,548,384,164,5
14210,2023-08-16 02:00:00,58,143,7,15,699,575,124,11
14211,2023-08-16 03:00:00,85,186,14,15,595,420,175,8
14212,2023-08-16 04:00:00,103,152,7,10,663,567,96,12
14213,2023-08-16 05:00:00,75,221,11,10,602,470,132,8
14214,2023-08-16 06:00:00,57,119,7,15,509,428,81,12
14215,2023-08-16 07:00:00,131,193,12,11,665,513,152,12
14216,2023-08-16 08:00:00,78,149,6,16,565,414,151,10
14217,2023-08-16 09:00:00,84,256,6,10,622,483,139,14
14218,2023-08-16 10:00:00,81,100,10,17,647,512,135,11
14219,2023-08-16 11:00:00,145,172,8,10,762,540,222,14
14220,2023-08-16 12:00:00,128,273,9,19,504,388,116,5
14221,2023-08-16 13:00:00,119,205,14,16,521,424,97,9
14222,2023-08-16 14:00:00,66,266,11,17,525,412,113,8
14223,2023-08-16 15:00:00,112,275,6,15,574,448,126,7
14224,2023-08-16 16:00:00,128,291,11,16,764,640,124,7
14225,2023-08-16 17:00:00,87,199,14,17,781,622,159,9
14226,2023-08-16 18:00:00,87,213,10,10,691,534,157,13
14227,2023-08-16 19:00:00,125,125,7,18,770,617,153,6
14228,2023-08-16 20:00:00,75,297,13,17,641,495,146,12
14229,2023-08-16 21:00:00,141,259,10,18,718,574,144,12
14230,2023-08-16 22:00:00,59,224,13,14,770,646,124,9
14231,2023-08-16 23:00:00,115,115,9,15,573,413,160,13
14232,2023-08-17 00:00:00,114,193,13,16,736,634,102,14
14233,2023-08-17 01:00:00,53,275,13,16,564,464,100,6
14234,2023-08-17 02:00:00,69,103,5,11,659,583,76,7
14235,2023-08-17 03:00:00,120,230,8,16,549,444,105,6
14236,2023-08-17 04:00:00,63,293,12,15,767,682,85,11
14237,2023-08-17 05:00:00,59,176,9,11,576,412,164,6
14238,2023-08-17 06:00:00,99,115,8,14,728,565,163,10
14239,2023-08-17 07:00:00,85,143,11,19,746,645,101,8
14240,2023-08-17 08:00:00,68,268,14,19,619,495,124,9
14241,2023-08-17 09:00:00,82,274,9,15,618,539,79,7
14242,2023-08-17 10:00:00,107,170,6,16,769,629,140,13
14243,2023-08-17 11:00:00,85,252,8,18,799,627,172,13
14244,2023-08-17 12:00:00,98,261,14,11,622,555,67,13
14245,2023-08-17 13:00:00,113,196,8,14,765,620,145,11
14246,2023-08-17 14:00:00,116,151,10,13,568,413,155,5
14247,2023-08-17 15:00:00,148,184,12,13,536,391,145,12
14248,2023-08-17 16:00:00,105,100,12,10,676,548,128,6
14249,2023-08-17 17:00:00,97,106,10,19,549,403,146,12
14250,2023-08-17 18:00:00,62,156,5,11,778,577,201,9
14251,2023-08-17 19:00:00,78,238,14,16,500,350,150,6
14252,2023-08-17 20:00:00,103,110,5,12,752,598,154,11
14253,2023-08-17 21:00:00,72,194,7,17,741,656,85,10
14254,2023-08-17 22:00:00,121,245,9,13,740,610,130,14
14255,2023-08-17 23:00:00,89,102,12,12,721,566,155,12
14256,2023-08-18 00:00:00,103,210,10,16,797,646,151,14
14257,2023-08-18 01:00:00,52,161,9,14,591,423,168,14
14258,2023-08-18 02:00:00,79,193,6,10,739,523,216,10
14259,2023-08-18 03:00:00,141,226,12,19,762,550,212,11
14260,2023-08-18 04:00:00,58,133,9,16,538,474,64,9
14261,2023-08-18 05:00:00,147,156,5,16,672,534,138,5
14262,2023-08-18 06:00:00,125,272,12,15,763,680,83,9
14263,2023-08-18 07:00:00,116,148,7,19,563,398,165,6
14264,2023-08-18 08:00:00,75,256,11,17,764,663,101,7
14265,2023-08-18 09:00:00,147,191,9,13,606,504,102,5
14266,2023-08-18 10:00:00,136,287,14,19,678,609,69,5
14267,2023-08-18 11:00:00,118,155,11,17,529,392,137,10
14268,2023-08-18 12:00:00,139,184,13,16,766,612,154,14
14269,2023-08-18 13:00:00,54,205,11,16,656,532,124,10
14270,2023-08-18 14:00:00,149,270,11,19,602,473,129,6
14271,2023-08-18 15:00:00,134,298,5,13,556,415,141,14
14272,2023-08-18 16:00:00,83,176,9,11,768,663,105,13
14273,2023-08-18 17:00:00,106,148,10,13,793,659,134,5
14274,2023-08-18 18:00:00,149,137,13,12,774,693,81,6
14275,2023-08-18 19:00:00,62,156,10,11,585,494,91,8
14276,2023-08-18 20:00:00,119,257,5,15,599,477,122,9
14277,2023-08-18 21:00:00,124,152,10,17,618,502,116,13
14278,2023-08-18 22:00:00,120,236,5,11,634,497,137,12
14279,2023-08-18 23:00:00,58,145,10,12,538,430,108,12
14280,2023-08-19 00:00:00,92,260,12,11,559,442,117,13
14281,2023-08-19 01:00:00,89,216,9,11,532,380,152,11
14282,2023-08-19 02:00:00,75,197,6,13,558,399,159,10
14283,2023-08-19 03:00:00,87,121,12,12,712,579,133,6
14284,2023-08-19 04:00:00,64,109,13,15,668,592,76,8
14285,2023-08-19 05:00:00,109,116,5,19,544,477,67,8
14286,2023-08-19 06:00:00,112,118,13,18,759,662,97,12
14287,2023-08-19 07:00:00,88,110,7,13,733,524,209,8
14288,2023-08-19 08:00:00,104,281,14,11,594,438,156,7
14289,2023-08-19 09:00:00,129,242,9,16,706,579,127,12
14290,2023-08-19 10:00:00,142,177,8,19,705,605,100,7
14291,2023-08-19 11:00:00,122,155,10,17,563,465,98,10
14292,2023-08-19 12:00:00,125,294,9,13,690,512,178,9
14293,2023-08-19 13:00:00,95,190,12,11,691,541,150,14
14294,2023-08-19 14:00:00,131,148,14,15,748,617,131,7
14295,2023-08-19 15:00:00,55,111,13,14,527,453,74,9
14296,2023-08-19 16:00:00,109,273,6,16,661,554,107,5
14297,2023-08-19 17:00:00,95,105,9,12,706,496,210,6
14298,2023-08-19 18:00:00,90,258,6,16,768,583,185,14
14299,2023-08-19 19:00:00,103,250,14,16,575,418,157,5
14300,2023-08-19 20:00:00,103,167,14,13,683,570,113,6
14301,2023-08-19 21:00:00,85,131,13,10,587,496,91,8
14302,2023-08-19 22:00:00,56,263,5,19,728,589,139,13
14303,2023-08-19 23:00:00,87,219,6,11,768,567,201,11
14304,2023-08-20 00:00:00,52,235,6,19,761,616,145,12
14305,2023-08-20 01:00:00,56,116,9,17,668,572,96,7
14306,2023-08-20 02:00:00,113,124,5,17,627,472,155,11
14307,2023-08-20 03:00:00,129,116,8,17,508,394,114,14
14308,2023-08-20 04:00:00,147,221,7,18,650,581,69,8
14309,2023-08-20 05:00:00,92,242,14,18,549,438,111,5
14310,2023-08-20 06:00:00,137,278,6,16,749,552,197,5
14311,2023-08-20 07:00:00,130,185,11,19,784,684,100,13
14312,2023-08-20 08:00:00,126,281,10,10,637,511,126,5
14313,2023-08-20 09:00:00,116,225,5,12,703,568,135,8
14314,2023-08-20 10:00:00,94,248,11,18,610,447,163,5
14315,2023-08-20 11:00:00,81,248,7,18,715,564,151,13
14316,2023-08-20 12:00:00,64,165,13,13,723,535,188,14
14317,2023-08-20 13:00:00,142,203,8,13,730,538,192,5
14318,2023-08-20 14:00:00,79,148,9,12,536,410,126,8
14319,2023-08-20 15:00:00,66,216,9,16,528,389,139,14
14320,2023-08-20 16:00:00,79,280,11,11,716,607,109,8
14321,2023-08-20 17:00:00,65,244,6,15,580,493,87,11
14322,2023-08-20 18:00:00,130,137,8,11,652,555,97,13
14323,2023-08-20 19:00:00,147,224,13,19,664,574,90,7
14324,2023-08-20 20:00:00,76,233,5,13,528,454,74,14
14325,2023-08-20 21:00:00,147,141,13,10,796,675,121,8
14326,2023-08-20 22:00:00,54,222,9,12,782,600,182,6
14327,2023-08-20 23:00:00,56,176,10,17,588,528,60,5
14328,2023-08-21 00:00:00,80,201,7,18,584,472,112,10
14329,2023-08-21 01:00:00,81,227,5,15,764,648,116,8
14330,2023-08-21 02:00:00,88,284,6,18,773,590,183,5
14331,2023-08-21 03:00:00,115,273,13,12,631,532,99,5
14332,2023-08-21 04:00:00,125,142,8,12,728,586,142,13
14333,2023-08-21 05:00:00,103,280,12,13,669,574,95,8
14334,2023-08-21 06:00:00,115,128,14,16,542,435,107,5
14335,2023-08-21 07:00:00,86,153,9,18,764,576,188,13
14336,2023-08-21 08:00:00,145,188,10,10,704,502,202,13
14337,2023-08-21 09:00:00,68,169,8,17,641,473,168,6
14338,2023-08-21 10:00:00,144,285,11,15,735,624,111,7
14339,2023-08-21 11:00:00,63,299,12,19,732,570,162,13
14340,2023-08-21 12:00:00,85,119,13,14,600,447,153,14
14341,2023-08-21 13:00:00,134,170,5,11,615,468,147,10
14342,2023-08-21 14:00:00,116,153,11,11,501,388,113,12
14343,2023-08-21 15:00:00,116,124,12,11,572,406,166,5
14344,2023-08-21 16:00:00,144,243,10,13,657,492,165,14
14345,2023-08-21 17:00:00,91,158,10,19,695,494,201,13
14346,2023-08-21 18:00:00,124,196,11,14,633,568,65,10
14347,2023-08-21 19:00:00,96,161,10,16,554,449,105,8
14348,2023-08-21 20:00:00,72,291,6,11,760,666,94,8
14349,2023-08-21 21:00:00,91,132,9,11,758,673,85,9
14350,2023-08-21 22:00:00,92,289,6,15,658,518,140,5
14351,2023-08-21 23:00:00,62,285,13,17,649,480,169,9
14352,2023-08-22 00:00:00,82,255,5,19,672,553,119,14
14353,2023-08-22 01:00:00,113,109,11,14,784,641,143,5
14354,2023-08-22 02:00:00,72,252,9,12,623,493,130,6
14355,2023-08-22 03:00:00,67,154,9,16,506,411,95,14
14356,2023-08-22 04:00:00,135,269,11,19,723,534,189,14
14357,2023-08-22 05:00:00,135,204,14,12,787,633,154,14
14358,2023-08-22 06:00:00,64,219,9,16,648,578,70,7
14359,2023-08-22 07:00:00,122,164,13,19,693,514,179,13
14360,2023-08-22 08:00:00,131,288,7,19,713,582,131,8
14361,2023-08-22 09:00:00,112,134,6,10,749,533,216,10
14362,2023-08-22 10:00:00,108,238,13,12,513,434,79,13
14363,2023-08-22 11:00:00,110,230,6,12,667,512,155,8
14364,2023-08-22 12:00:00,81,158,13,12,586,522,64,5
14365,2023-08-22 13:00:00,91,259,8,17,766,662,104,10
14366,2023-08-22 14:00:00,139,152,14,18,557,472,85,7
14367,2023-08-22 15:00:00,88,139,7,18,695,600,95,13
14368,2023-08-22 16:00:00,65,193,10,14,644,475,169,13
14369,2023-08-22 17:00:00,77,298,11,16,668,470,198,13
14370,2023-08-22 18:00:00,134,201,5,15,693,555,138,11
14371,2023-08-22 19:00:00,57,127,7,18,582,504,78,8
14372,2023-08-22 20:00:00,84,234,9,19,684,598,86,14
14373,2023-08-22 21:00:00,68,242,11,10,549,476,73,14
14374,2023-08-22 22:00:00,93,206,7,16,549,463,86,10
14375,2023-08-22 23:00:00,125,229,10,10,715,599,116,13
14376,2023-08-23 00:00:00,132,160,12,13,597,489,108,8
14377,2023-08-23 01:00:00,136,250,11,19,538,443,95,12
14378,2023-08-23 02:00:00,64,209,10,15,651,481,170,7
14379,2023-08-23 03:00:00,78,172,9,18,576,459,117,12
14380,2023-08-23 04:00:00,72,220,9,18,788,568,220,6
14381,2023-08-23 05:00:00,94,119,6,19,688,488,200,5
14382,2023-08-23 06:00:00,57,277,7,19,623,541,82,8
14383,2023-08-23 07:00:00,89,245,7,19,564,477,87,12
14384,2023-08-23 08:00:00,75,111,13,18,643,493,150,11
14385,2023-08-23 09:00:00,89,184,8,14,670,506,164,10
14386,2023-08-23 10:00:00,118,101,14,14,552,462,90,12
14387,2023-08-23 11:00:00,62,109,9,17,764,558,206,7
14388,2023-08-23 12:00:00,102,223,14,15,630,546,84,11
14389,2023-08-23 13:00:00,60,184,7,14,578,418,160,10
14390,2023-08-23 14:00:00,72,168,13,16,523,415,108,13
14391,2023-08-23 15:00:00,135,279,9,13,759,605,154,6
14392,2023-08-23 16:00:00,72,142,8,10,736,580,156,13
14393,2023-08-23 17:00:00,85,182,12,13,656,584,72,10
14394,2023-08-23 18:00:00,51,285,7,16,688,528,160,9
14395,2023-08-23 19:00:00,109,249,8,10,779,551,228,9
14396,2023-08-23 20:00:00,79,172,8,18,684,499,185,7
14397,2023-08-23 21:00:00,108,146,12,10,722,644,78,14
14398,2023-08-23 22:00:00,72,211,9,14,612,445,167,10
14399,2023-08-23 23:00:00,76,289,13,14,587,427,160,5
14400,2023-08-24 00:00:00,127,166,6,16,566,437,129,6
14401,2023-08-24 01:00:00,128,255,9,19,553,428,125,9
14402,2023-08-24 02:00:00,119,257,10,12,660,550,110,5
14403,2023-08-24 03:00:00,98,240,10,15,525,429,96,13
14404,2023-08-24 04:00:00,142,169,5,17,550,424,126,13
14405,2023-08-24 05:00:00,146,152,11,17,615,453,162,13
14406,2023-08-24 06:00:00,141,208,5,11,717,543,174,6
14407,2023-08-24 07:00:00,142,217,7,11,556,453,103,6
14408,2023-08-24 08:00:00,103,276,5,19,791,609,182,14
14409,2023-08-24 09:00:00,101,210,14,10,674,526,148,10
14410,2023-08-24 10:00:00,120,103,12,12,752,537,215,5
14411,2023-08-24 11:00:00,112,108,10,18,766,542,224,13
14412,2023-08-24 12:00:00,100,119,12,17,631,545,86,13
14413,2023-08-24 13:00:00,88,204,10,18,501,414,87,13
14414,2023-08-24 14:00:00,111,190,14,10,622,479,143,13
14415,2023-08-24 15:00:00,94,207,9,19,742,632,110,13
14416,2023-08-24 16:00:00,65,298,10,17,750,614,136,14
14417,2023-08-24 17:00:00,56,251,14,18,640,512,128,12
14418,2023-08-24 18:00:00,101,143,14,12,648,539,109,9
14419,2023-08-24 19:00:00,53,228,8,15,727,554,173,14
14420,2023-08-24 20:00:00,55,161,12,18,552,398,154,13
14421,2023-08-24 21:00:00,121,126,11,14,545,400,145,13
14422,2023-08-24 22:00:00,51,262,7,16,538,396,142,8
14423,2023-08-24 23:00:00,64,272,11,18,785,617,168,9
14424,2023-08-25 00:00:00,116,202,7,13,742,557,185,9
14425,2023-08-25 01:00:00,148,166,9,14,561,447,114,10
14426,2023-08-25 02:00:00,141,274,5,19,748,573,175,8
14427,2023-08-25 03:00:00,115,142,6,10,551,410,141,11
14428,2023-08-25 04:00:00,71,256,8,18,666,536,130,5
14429,2023-08-25 05:00:00,146,192,10,18,619,452,167,7
14430,2023-08-25 06:00:00,57,161,13,18,632,524,108,9
14431,2023-08-25 07:00:00,145,216,7,11,507,417,90,13
14432,2023-08-25 08:00:00,50,107,5,10,500,428,72,8
14433,2023-08-25 09:00:00,128,172,5,13,624,515,109,14
14434,2023-08-25 10:00:00,77,147,11,10,719,635,84,13
14435,2023-08-25 11:00:00,127,244,8,10,785,666,119,8
14436,2023-08-25 12:00:00,54,247,11,10,608,470,138,14
14437,2023-08-25 13:00:00,116,283,6,15,600,480,120,10
14438,2023-08-25 14:00:00,93,296,5,13,742,637,105,9
14439,2023-08-25 15:00:00,62,155,5,11,501,358,143,6
14440,2023-08-25 16:00:00,111,153,13,10,717,576,141,10
14441,2023-08-25 17:00:00,66,196,9,17,736,520,216,10
14442,2023-08-25 18:00:00,122,261,14,17,583,459,124,12
14443,2023-08-25 19:00:00,93,245,9,19,587,428,159,11
14444,2023-08-25 20:00:00,105,156,10,15,730,547,183,6
14445,2023-08-25 21:00:00,57,288,14,13,509,447,62,7
14446,2023-08-25 22:00:00,132,281,10,15,567,446,121,6
14447,2023-08-25 23:00:00,130,233,11,17,662,489,173,14
14448,2023-08-26 00:00:00,149,111,11,14,747,606,141,6
14449,2023-08-26 01:00:00,111,280,13,10,743,584,159,8
14450,2023-08-26 02:00:00,71,125,11,12,641,568,73,6
14451,2023-08-26 03:00:00,68,207,8,16,593,466,127,9
14452,2023-08-26 04:00:00,66,235,7,13,564,487,77,8
14453,2023-08-26 05:00:00,92,244,7,13,555,389,166,9
14454,2023-08-26 06:00:00,138,106,8,12,606,431,175,10
14455,2023-08-26 07:00:00,75,149,11,16,553,429,124,10
14456,2023-08-26 08:00:00,109,151,6,15,518,402,116,5
14457,2023-08-26 09:00:00,127,134,5,11,797,581,216,12
14458,2023-08-26 10:00:00,108,220,8,18,793,651,142,9
14459,2023-08-26 11:00:00,98,183,10,16,677,523,154,6
14460,2023-08-26 12:00:00,139,117,13,14,704,620,84,7
14461,2023-08-26 13:00:00,131,177,11,12,741,519,222,10
14462,2023-08-26 14:00:00,115,120,12,11,747,660,87,9
14463,2023-08-26 15:00:00,131,269,13,14,754,652,102,10
14464,2023-08-26 16:00:00,72,105,13,15,663,546,117,5
14465,2023-08-26 17:00:00,126,296,12,19,539,475,64,8
14466,2023-08-26 18:00:00,83,291,8,17,698,622,76,9
14467,2023-08-26 19:00:00,148,114,11,13,643,482,161,11
14468,2023-08-26 20:00:00,122,190,14,17,559,423,136,10
14469,2023-08-26 21:00:00,68,194,8,18,793,561,232,7
14470,2023-08-26 22:00:00,76,180,12,15,601,525,76,12
14471,2023-08-26 23:00:00,57,273,13,10,550,494,56,8
14472,2023-08-27 00:00:00,62,169,9,17,641,462,179,7
14473,2023-08-27 01:00:00,142,138,8,19,739,639,100,12
14474,2023-08-27 02:00:00,99,206,7,19,646,482,164,8
14475,2023-08-27 03:00:00,71,151,10,14,632,541,91,14
14476,2023-08-27 04:00:00,78,257,6,19,727,543,184,14
14477,2023-08-27 05:00:00,95,224,14,10,786,673,113,13
14478,2023-08-27 06:00:00,128,121,14,14,523,382,141,7
14479,2023-08-27 07:00:00,51,223,12,13,535,458,77,8
14480,2023-08-27 08:00:00,131,233,7,16,558,453,105,10
14481,2023-08-27 09:00:00,119,126,14,19,773,603,170,12
14482,2023-08-27 10:00:00,95,124,14,16,775,569,206,9
14483,2023-08-27 11:00:00,92,278,10,15,516,416,100,7
14484,2023-08-27 12:00:00,86,271,6,15,556,389,167,6
14485,2023-08-27 13:00:00,134,156,14,15,616,514,102,13
14486,2023-08-27 14:00:00,79,142,7,17,603,435,168,12
14487,2023-08-27 15:00:00,60,224,8,11,701,621,80,12
14488,2023-08-27 16:00:00,57,117,6,18,504,363,141,7
14489,2023-08-27 17:00:00,55,131,13,16,650,529,121,14
14490,2023-08-27 18:00:00,89,181,11,13,699,541,158,11
14491,2023-08-27 19:00:00,120,287,14,15,777,574,203,11
14492,2023-08-27 20:00:00,57,279,11,19,774,568,206,14
14493,2023-08-27 21:00:00,89,219,13,15,665,536,129,11
14494,2023-08-27 22:00:00,112,172,11,17,576,452,124,6
14495,2023-08-27 23:00:00,133,179,14,18,559,472,87,5
14496,2023-08-28 00:00:00,87,147,14,15,615,453,162,11
14497,2023-08-28 01:00:00,93,201,13,12,732,614,118,6
14498,2023-08-28 02:00:00,64,128,13,11,796,590,206,12
14499,2023-08-28 03:00:00,119,252,14,18,682,489,193,14
14500,2023-08-28 04:00:00,90,245,7,15,502,436,66,8
14501,2023-08-28 05:00:00,122,259,10,16,523,469,54,9
14502,2023-08-28 06:00:00,99,217,10,15,588,465,123,10
14503,2023-08-28 07:00:00,67,216,9,14,539,413,126,8
14504,2023-08-28 08:00:00,73,202,5,19,520,463,57,14
14505,2023-08-28 09:00:00,135,234,11,16,728,526,202,5
14506,2023-08-28 10:00:00,73,276,10,16,646,573,73,5
14507,2023-08-28 11:00:00,100,170,10,13,616,546,70,6
14508,2023-08-28 12:00:00,137,208,8,18,704,583,121,12
14509,2023-08-28 13:00:00,117,175,12,13,770,596,174,14
14510,2023-08-28 14:00:00,62,126,10,14,645,528,117,14
14511,2023-08-28 15:00:00,125,290,8,16,611,483,128,9
14512,2023-08-28 16:00:00,127,169,10,13,783,629,154,13
14513,2023-08-28 17:00:00,52,114,13,17,559,423,136,13
14514,2023-08-28 18:00:00,134,247,9,12,550,479,71,9
14515,2023-08-28 19:00:00,130,189,13,12,772,681,91,8
14516,2023-08-28 20:00:00,98,291,10,10,718,519,199,10
14517,2023-08-28 21:00:00,142,117,10,11,682,513,169,8
14518,2023-08-28 22:00:00,88,108,9,16,764,643,121,5
14519,2023-08-28 23:00:00,139,279,11,17,547,402,145,5
14520,2023-08-29 00:00:00,80,110,5,19,784,550,234,14
14521,2023-08-29 01:00:00,61,152,5,11,634,512,122,6
14522,2023-08-29 02:00:00,72,246,5,10,697,597,100,9
14523,2023-08-29 03:00:00,64,221,14,19,753,579,174,9
14524,2023-08-29 04:00:00,128,131,6,15,538,380,158,11
14525,2023-08-29 05:00:00,105,199,14,18,500,447,53,6
14526,2023-08-29 06:00:00,72,166,5,12,740,556,184,13
14527,2023-08-29 07:00:00,141,285,5,10,596,521,75,13
14528,2023-08-29 08:00:00,67,207,12,11,704,505,199,14
14529,2023-08-29 09:00:00,103,201,10,19,729,554,175,14
14530,2023-08-29 10:00:00,113,209,10,10,711,523,188,12
14531,2023-08-29 11:00:00,69,156,5,11,673,553,120,7
14532,2023-08-29 12:00:00,128,144,10,19,604,474,130,11
14533,2023-08-29 13:00:00,59,155,12,12,661,566,95,9
14534,2023-08-29 14:00:00,95,246,8,15,575,412,163,12
14535,2023-08-29 15:00:00,103,142,13,11,564,465,99,10
14536,2023-08-29 16:00:00,106,180,7,15,542,487,55,10
14537,2023-08-29 17:00:00,73,287,9,10,671,489,182,7
14538,2023-08-29 18:00:00,101,155,12,14,649,520,129,9
14539,2023-08-29 19:00:00,50,149,6,10,696,532,164,14
14540,2023-08-29 20:00:00,103,280,11,12,710,552,158,12
14541,2023-08-29 21:00:00,99,170,9,14,799,573,226,10
14542,2023-08-29 22:00:00,50,246,8,17,555,483,72,6
14543,2023-08-29 23:00:00,57,201,13,17,546,481,65,7
14544,2023-08-30 00:00:00,53,207,6,15,767,549,218,10
14545,2023-08-30 01:00:00,64,140,12,18,567,475,92,5
14546,2023-08-30 02:00:00,82,239,12,17,689,579,110,5
14547,2023-08-30 03:00:00,118,141,5,17,577,409,168,13
14548,2023-08-30 04:00:00,143,259,13,19,766,545,221,11
14549,2023-08-30 05:00:00,98,236,7,10,598,459,139,10
14550,2023-08-30 06:00:00,90,172,9,11,588,442,146,6
14551,2023-08-30 07:00:00,148,154,14,12,658,571,87,7
14552,2023-08-30 08:00:00,128,192,6,15,787,569,218,7
14553,2023-08-30 09:00:00,55,177,11,16,727,559,168,10
14554,2023-08-30 10:00:00,138,233,6,17,691,618,73,8
14555,2023-08-30 11:00:00,110,183,14,12,654,462,192,12
14556,2023-08-30 12:00:00,119,148,12,19,586,508,78,5
14557,2023-08-30 13:00:00,116,200,6,14,562,484,78,6
14558,2023-08-30 14:00:00,78,151,11,12,566,483,83,5
14559,2023-08-30 15:00:00,134,173,7,14,539,471,68,13
14560,2023-08-30 16:00:00,118,123,9,15,617,487,130,14
14561,2023-08-30 17:00:00,86,281,11,14,798,674,124,8
14562,2023-08-30 18:00:00,101,236,9,17,791,680,111,7
14563,2023-08-30 19:00:00,131,212,9,12,616,500,116,9
14564,2023-08-30 20:00:00,128,189,12,17,780,560,220,9
14565,2023-08-30 21:00:00,126,144,14,12,795,581,214,8
14566,2023-08-30 22:00:00,141,199,8,14,562,436,126,11
14567,2023-08-30 23:00:00,76,101,10,17,746,617,129,13
14568,2023-08-31 00:00:00,108,277,10,18,527,454,73,9
14569,2023-08-31 01:00:00,105,229,12,10,619,485,134,10
14570,2023-08-31 02:00:00,50,118,12,17,693,515,178,13
14571,2023-08-31 03:00:00,113,159,10,19,655,468,187,13
14572,2023-08-31 04:00:00,120,176,14,11,711,546,165,10
14573,2023-08-31 05:00:00,90,175,11,13,577,407,170,7
14574,2023-08-31 06:00:00,79,120,9,11,717,625,92,13
14575,2023-08-31 07:00:00,139,263,11,12,622,462,160,5
14576,2023-08-31 08:00:00,84,170,11,19,551,429,122,13
14577,2023-08-31 09:00:00,78,207,13,11,514,361,153,13
14578,2023-08-31 10:00:00,62,258,12,14,524,469,55,9
14579,2023-08-31 11:00:00,144,187,7,17,708,496,212,11
14580,2023-08-31 12:00:00,69,131,11,14,672,591,81,11
14581,2023-08-31 13:00:00,84,281,7,16,798,665,133,8
14582,2023-08-31 14:00:00,109,187,11,18,710,632,78,11
14583,2023-08-31 15:00:00,131,256,11,19,579,418,161,10
14584,2023-08-31 16:00:00,53,189,6,16,571,414,157,14
14585,2023-08-31 17:00:00,62,138,14,10,512,453,59,14
14586,2023-08-31 18:00:00,96,214,9,15,541,426,115,9
14587,2023-08-31 19:00:00,54,196,9,14,787,637,150,9
14588,2023-08-31 20:00:00,119,221,12,10,771,623,148,9
14589,2023-08-31 21:00:00,68,184,7,19,549,475,74,8
14590,2023-08-31 22:00:00,50,238,9,16,631,452,179,11
14591,2023-08-31 23:00:00,69,173,10,18,598,479,119,5
14592,2023-09-01 00:00:00,138,253,10,16,716,569,147,12
14593,2023-09-01 01:00:00,83,177,13,12,736,603,133,7
14594,2023-09-01 02:00:00,86,224,5,13,741,563,178,9
14595,2023-09-01 03:00:00,50,292,12,11,506,390,116,5
14596,2023-09-01 04:00:00,133,148,11,19,776,611,165,11
14597,2023-09-01 05:00:00,131,109,14,19,784,669,115,5
14598,2023-09-01 06:00:00,110,196,7,19,566,417,149,10
14599,2023-09-01 07:00:00,64,243,5,13,770,603,167,10
14600,2023-09-01 08:00:00,85,292,9,14,577,443,134,10
14601,2023-09-01 09:00:00,143,272,8,10,765,590,175,13
14602,2023-09-01 10:00:00,95,182,10,15,685,479,206,8
14603,2023-09-01 11:00:00,79,173,12,15,607,459,148,5
14604,2023-09-01 12:00:00,78,111,9,13,640,532,108,8
14605,2023-09-01 13:00:00,85,292,10,13,510,364,146,14
14606,2023-09-01 14:00:00,138,169,11,18,739,649,90,13
14607,2023-09-01 15:00:00,64,286,11,18,685,593,92,6
14608,2023-09-01 16:00:00,67,149,6,13,615,524,91,12
14609,2023-09-01 17:00:00,130,213,13,10,515,412,103,8
14610,2023-09-01 18:00:00,132,282,10,18,775,591,184,12
14611,2023-09-01 19:00:00,101,150,8,12,694,558,136,13
14612,2023-09-01 20:00:00,127,134,5,19,674,509,165,5
14613,2023-09-01 21:00:00,103,215,7,13,652,495,157,7
14614,2023-09-01 22:00:00,120,176,12,10,678,477,201,6
14615,2023-09-01 23:00:00,141,109,5,11,791,695,96,14
14616,2023-09-02 00:00:00,90,116,10,12,595,457,138,7
14617,2023-09-02 01:00:00,62,117,13,12,554,461,93,13
14618,2023-09-02 02:00:00,76,100,13,15,587,415,172,11
14619,2023-09-02 03:00:00,114,107,14,10,612,492,120,6
14620,2023-09-02 04:00:00,121,251,5,10,572,406,166,5
14621,2023-09-02 05:00:00,76,231,13,10,572,475,97,6
14622,2023-09-02 06:00:00,142,160,7,13,778,596,182,14
14623,2023-09-02 07:00:00,68,226,12,15,592,513,79,10
14624,2023-09-02 08:00:00,104,163,13,15,786,579,207,8
14625,2023-09-02 09:00:00,125,108,6,10,522,428,94,11
14626,2023-09-02 10:00:00,120,234,6,15,689,612,77,12
14627,2023-09-02 11:00:00,82,271,14,12,669,591,78,10
14628,2023-09-02 12:00:00,70,202,13,17,542,411,131,12
14629,2023-09-02 13:00:00,113,289,13,15,734,647,87,12
14630,2023-09-02 14:00:00,123,229,12,12,552,456,96,12
14631,2023-09-02 15:00:00,130,176,6,17,514,436,78,8
14632,2023-09-02 16:00:00,66,288,12,18,509,376,133,5
14633,2023-09-02 17:00:00,139,143,10,11,754,615,139,9
14634,2023-09-02 18:00:00,73,196,9,14,768,653,115,7
14635,2023-09-02 19:00:00,135,262,10,17,774,569,205,14
14636,2023-09-02 20:00:00,110,195,8,14,550,427,123,11
14637,2023-09-02 21:00:00,81,272,6,18,587,487,100,9
14638,2023-09-02 22:00:00,73,288,8,15,554,418,136,6
14639,2023-09-02 23:00:00,100,220,12,13,752,662,90,9
14640,2023-09-03 00:00:00,114,226,6,17,517,418,99,6
14641,2023-09-03 01:00:00,113,104,8,19,515,431,84,5
14642,2023-09-03 02:00:00,68,135,12,11,631,500,131,7
14643,2023-09-03 03:00:00,113,214,11,17,725,568,157,6
14644,2023-09-03 04:00:00,75,135,5,16,562,439,123,10
14645,2023-09-03 05:00:00,73,270,9,11,640,455,185,7
14646,2023-09-03 06:00:00,146,265,14,18,511,430,81,7
14647,2023-09-03 07:00:00,80,217,14,11,751,565,186,11
14648,2023-09-03 08:00:00,124,142,13,19,713,628,85,5
14649,2023-09-03 09:00:00,61,212,8,13,781,579,202,9
14650,2023-09-03 10:00:00,125,173,7,11,715,618,97,13
14651,2023-09-03 11:00:00,115,293,13,16,757,622,135,14
14652,2023-09-03 12:00:00,83,261,14,13,739,581,158,9
14653,2023-09-03 13:00:00,134,243,10,19,619,513,106,12
14654,2023-09-03 14:00:00,60,175,13,15,674,569,105,14
14655,2023-09-03 15:00:00,126,270,7,13,739,628,111,14
14656,2023-09-03 16:00:00,55,224,10,11,674,598,76,6
14657,2023-09-03 17:00:00,104,110,11,13,767,676,91,9
14658,2023-09-03 18:00:00,72,118,11,12,646,553,93,6
14659,2023-09-03 19:00:00,118,265,6,16,698,557,141,5
14660,2023-09-03 20:00:00,111,213,11,10,544,424,120,8
14661,2023-09-03 21:00:00,110,155,7,18,751,670,81,12
14662,2023-09-03 22:00:00,76,141,7,18,732,527,205,14
14663,2023-09-03 23:00:00,149,192,6,10,793,653,140,9
14664,2023-09-04 00:00:00,138,229,9,17,770,577,193,11
14665,2023-09-04 01:00:00,89,188,10,13,700,518,182,14
14666,2023-09-04 02:00:00,88,248,10,10,672,517,155,9
14667,2023-09-04 03:00:00,53,160,8,17,578,437,141,14
14668,2023-09-04 04:00:00,63,198,14,16,742,576,166,6
14669,2023-09-04 05:00:00,122,228,11,14,683,595,88,9
14670,2023-09-04 06:00:00,74,291,12,18,572,443,129,14
14671,2023-09-04 07:00:00,129,148,6,10,633,544,89,13
14672,2023-09-04 08:00:00,128,185,7,14,754,630,124,5
14673,2023-09-04 09:00:00,77,181,5,16,543,437,106,5
14674,2023-09-04 10:00:00,108,134,13,10,601,435,166,6
14675,2023-09-04 11:00:00,129,215,10,14,780,557,223,13
14676,2023-09-04 12:00:00,118,214,11,16,582,422,160,7
14677,2023-09-04 13:00:00,141,227,7,16,547,412,135,13
14678,2023-09-04 14:00:00,122,168,11,19,530,371,159,7
14679,2023-09-04 15:00:00,146,288,5,12,732,625,107,8
14680,2023-09-04 16:00:00,66,121,5,16,531,428,103,14
14681,2023-09-04 17:00:00,54,139,6,10,527,411,116,7
14682,2023-09-04 18:00:00,98,205,13,10,738,523,215,8
14683,2023-09-04 19:00:00,90,113,12,18,624,445,179,12
14684,2023-09-04 20:00:00,54,243,14,14,501,404,97,6
14685,2023-09-04 21:00:00,148,266,12,16,608,442,166,7
14686,2023-09-04 22:00:00,136,220,8,17,632,529,103,8
14687,2023-09-04 23:00:00,126,216,12,17,592,506,86,14
14688,2023-09-05 00:00:00,136,230,6,18,695,559,136,11
14689,2023-09-05 01:00:00,127,124,7,12,617,495,122,9
14690,2023-09-05 02:00:00,62,186,10,17,765,652,113,14
14691,2023-09-05 03:00:00,90,132,6,15,710,638,72,8
14692,2023-09-05 04:00:00,84,115,13,14,549,427,122,5
14693,2023-09-05 05:00:00,126,176,5,12,772,603,169,8
14694,2023-09-05 06:00:00,87,274,13,14,506,385,121,6
14695,2023-09-05 07:00:00,107,169,13,18,610,440,170,8
14696,2023-09-05 08:00:00,146,226,9,12,585,487,98,11
14697,2023-09-05 09:00:00,128,179,9,16,774,584,190,6
14698,2023-09-05 10:00:00,58,226,7,11,706,512,194,12
14699,2023-09-05 11:00:00,143,192,8,15,764,556,208,14
14700,2023-09-05 12:00:00,122,270,6,13,676,555,121,7
14701,2023-09-05 13:00:00,70,123,11,19,545,451,94,12
14702,2023-09-05 14:00:00,73,181,14,15,728,591,137,11
14703,2023-09-05 15:00:00,137,223,11,14,734,524,210,14
14704,2023-09-05 16:00:00,110,208,13,19,731,656,75,7
14705,2023-09-05 17:00:00,101,252,8,14,672,515,157,12
14706,2023-09-05 18:00:00,86,139,8,11,720,547,173,6
14707,2023-09-05 19:00:00,110,159,6,19,657,545,112,5
14708,2023-09-05 20:00:00,51,241,10,18,621,496,125,7
14709,2023-09-05 21:00:00,94,190,12,14,657,545,112,13
14710,2023-09-05 22:00:00,64,181,9,15,553,421,132,11
14711,2023-09-05 23:00:00,64,119,9,17,797,694,103,12
14712,2023-09-06 00:00:00,104,101,13,19,700,608,92,5
14713,2023-09-06 01:00:00,62,206,5,19,728,620,108,11
14714,2023-09-06 02:00:00,60,180,13,16,648,563,85,12
14715,2023-09-06 03:00:00,123,117,11,17,753,534,219,10
14716,2023-09-06 04:00:00,137,161,14,12,648,516,132,13
14717,2023-09-06 05:00:00,56,244,9,12,582,431,151,9
14718,2023-09-06 06:00:00,134,239,12,12,568,456,112,5
14719,2023-09-06 07:00:00,142,143,8,11,623,482,141,14
14720,2023-09-06 08:00:00,141,181,14,18,570,399,171,10
14721,2023-09-06 09:00:00,116,123,11,14,708,579,129,10
14722,2023-09-06 10:00:00,53,123,5,15,578,438,140,13
14723,2023-09-06 11:00:00,58,249,13,18,730,533,197,9
14724,2023-09-06 12:00:00,148,230,13,11,771,574,197,13
14725,2023-09-06 13:00:00,65,177,12,18,603,521,82,7
14726,2023-09-06 14:00:00,78,244,6,19,730,582,148,9
14727,2023-09-06 15:00:00,82,202,8,11,730,594,136,10
14728,2023-09-06 16:00:00,95,125,14,15,752,593,159,11
14729,2023-09-06 17:00:00,100,243,10,10,762,562,200,7
14730,2023-09-06 18:00:00,70,189,6,17,689,516,173,9
14731,2023-09-06 19:00:00,71,293,12,13,660,464,196,13
14732,2023-09-06 20:00:00,141,153,9,16,511,443,68,12
14733,2023-09-06 21:00:00,144,290,13,15,693,597,96,7
14734,2023-09-06 22:00:00,143,285,11,19,792,631,161,14
14735,2023-09-06 23:00:00,78,291,14,17,657,482,175,13
14736,2023-09-07 00:00:00,72,252,6,13,621,537,84,7
14737,2023-09-07 01:00:00,140,223,9,16,568,409,159,12
14738,2023-09-07 02:00:00,72,203,6,13,667,550,117,6
14739,2023-09-07 03:00:00,66,182,11,17,648,501,147,13
14740,2023-09-07 04:00:00,61,235,12,16,606,432,174,5
14741,2023-09-07 05:00:00,100,165,13,19,702,605,97,5
14742,2023-09-07 06:00:00,62,117,12,15,519,418,101,7
14743,2023-09-07 07:00:00,134,247,10,12,609,453,156,6
14744,2023-09-07 08:00:00,114,248,10,19,752,546,206,13
14745,2023-09-07 09:00:00,120,229,5,17,545,463,82,9
14746,2023-09-07 10:00:00,122,257,6,13,710,609,101,10
14747,2023-09-07 11:00:00,77,282,13,14,615,517,98,10
14748,2023-09-07 12:00:00,72,114,10,15,710,549,161,13
14749,2023-09-07 13:00:00,102,178,13,13,692,551,141,11
14750,2023-09-07 14:00:00,97,235,6,19,599,534,65,6
14751,2023-09-07 15:00:00,126,233,9,12,627,537,90,9
14752,2023-09-07 16:00:00,54,149,6,19,795,573,222,10
14753,2023-09-07 17:00:00,147,125,11,16,580,484,96,8
14754,2023-09-07 18:00:00,67,110,13,17,788,562,226,6
14755,2023-09-07 19:00:00,52,296,11,16,682,562,120,9
14756,2023-09-07 20:00:00,125,222,6,14,521,365,156,8
14757,2023-09-07 21:00:00,136,177,11,13,762,595,167,10
14758,2023-09-07 22:00:00,127,241,11,17,684,560,124,10
14759,2023-09-07 23:00:00,63,114,7,15,645,459,186,5
14760,2023-09-08 00:00:00,63,104,10,16,666,555,111,7
14761,2023-09-08 01:00:00,134,275,14,17,701,541,160,13
14762,2023-09-08 02:00:00,100,291,7,11,779,614,165,10
14763,2023-09-08 03:00:00,108,282,6,19,779,553,226,12
14764,2023-09-08 04:00:00,140,195,11,13,721,535,186,9
14765,2023-09-08 05:00:00,148,201,6,11,546,472,74,7
14766,2023-09-08 06:00:00,79,100,5,12,772,627,145,10
14767,2023-09-08 07:00:00,145,201,7,16,644,542,102,7
14768,2023-09-08 08:00:00,88,251,8,19,742,609,133,6
14769,2023-09-08 09:00:00,114,233,12,14,798,662,136,14
14770,2023-09-08 10:00:00,146,119,8,18,639,544,95,7
14771,2023-09-08 11:00:00,62,237,8,13,715,599,116,10
14772,2023-09-08 12:00:00,125,136,12,14,553,433,120,13
14773,2023-09-08 13:00:00,111,256,6,17,651,475,176,11
14774,2023-09-08 14:00:00,108,180,10,11,733,573,160,9
14775,2023-09-08 15:00:00,123,232,13,12,573,501,72,8
14776,2023-09-08 16:00:00,118,120,14,19,732,606,126,13
14777,2023-09-08 17:00:00,63,240,7,14,706,627,79,9
14778,2023-09-08 18:00:00,116,194,12,19,608,447,161,11
14779,2023-09-08 19:00:00,148,115,14,16,798,703,95,13
14780,2023-09-08 20:00:00,133,247,11,12,578,463,115,10
14781,2023-09-08 21:00:00,130,230,5,16,785,674,111,14
14782,2023-09-08 22:00:00,142,132,7,13,667,579,88,13
14783,2023-09-08 23:00:00,115,229,10,11,675,550,125,11
14784,2023-09-09 00:00:00,128,189,14,10,706,603,103,12
14785,2023-09-09 01:00:00,125,244,12,11,551,406,145,13
14786,2023-09-09 02:00:00,77,245,13,15,692,531,161,10
14787,2023-09-09 03:00:00,119,222,11,17,735,532,203,8
14788,2023-09-09 04:00:00,84,110,9,13,728,627,101,13
14789,2023-09-09 05:00:00,53,158,10,10,683,614,69,14
14790,2023-09-09 06:00:00,75,106,10,15,516,418,98,12
14791,2023-09-09 07:00:00,79,292,6,12,617,437,180,14
14792,2023-09-09 08:00:00,57,117,9,19,654,466,188,8
14793,2023-09-09 09:00:00,78,208,11,17,735,613,122,11
14794,2023-09-09 10:00:00,118,255,7,16,628,470,158,14
14795,2023-09-09 11:00:00,63,265,7,16,506,424,82,11
14796,2023-09-09 12:00:00,82,184,7,19,669,593,76,7
14797,2023-09-09 13:00:00,118,148,13,16,560,499,61,5
14798,2023-09-09 14:00:00,50,186,10,13,622,543,79,13
14799,2023-09-09 15:00:00,77,243,7,19,700,548,152,13
14800,2023-09-09 16:00:00,94,228,13,12,586,499,87,10
14801,2023-09-09 17:00:00,126,285,6,15,661,501,160,10
14802,2023-09-09 18:00:00,82,172,9,17,576,496,80,11
14803,2023-09-09 19:00:00,55,172,12,16,632,482,150,8
14804,2023-09-09 20:00:00,149,178,11,19,656,465,191,5
14805,2023-09-09 21:00:00,143,271,7,14,620,536,84,10
14806,2023-09-09 22:00:00,112,297,10,13,704,554,150,7
14807,2023-09-09 23:00:00,124,286,8,18,572,433,139,6
14808,2023-09-10 00:00:00,77,173,8,17,603,454,149,9
14809,2023-09-10 01:00:00,77,298,12,19,702,512,190,9
14810,2023-09-10 02:00:00,134,189,11,19,665,538,127,8
14811,2023-09-10 03:00:00,145,192,13,19,570,505,65,12
14812,2023-09-10 04:00:00,105,228,5,14,680,516,164,13
14813,2023-09-10 05:00:00,133,157,14,18,664,475,189,10
14814,2023-09-10 06:00:00,115,221,13,18,669,580,89,9
14815,2023-09-10 07:00:00,134,260,5,14,674,605,69,10
14816,2023-09-10 08:00:00,86,266,7,12,594,519,75,12
14817,2023-09-10 09:00:00,101,220,13,16,747,538,209,13
14818,2023-09-10 10:00:00,80,268,8,10,543,456,87,7
14819,2023-09-10 11:00:00,102,159,11,13,681,609,72,9
14820,2023-09-10 12:00:00,127,184,5,15,703,624,79,8
14821,2023-09-10 13:00:00,66,200,11,16,794,679,115,13
14822,2023-09-10 14:00:00,67,266,5,12,500,373,127,9
14823,2023-09-10 15:00:00,78,183,13,17,738,516,222,6
14824,2023-09-10 16:00:00,101,143,14,15,600,538,62,8
14825,2023-09-10 17:00:00,70,263,11,11,658,588,70,10
14826,2023-09-10 18:00:00,148,123,14,19,542,450,92,9
14827,2023-09-10 19:00:00,57,202,14,12,574,407,167,13
14828,2023-09-10 20:00:00,72,132,8,11,531,438,93,9
14829,2023-09-10 21:00:00,123,230,9,12,506,416,90,12
14830,2023-09-10 22:00:00,57,189,12,14,794,615,179,13
14831,2023-09-10 23:00:00,79,104,14,18,645,573,72,13
14832,2023-09-11 00:00:00,97,221,14,10,517,393,124,7
14833,2023-09-11 01:00:00,110,177,6,14,534,469,65,11
14834,2023-09-11 02:00:00,118,120,6,12,577,494,83,5
14835,2023-09-11 03:00:00,130,238,11,11,561,467,94,9
14836,2023-09-11 04:00:00,105,231,8,15,732,613,119,6
14837,2023-09-11 05:00:00,105,247,5,15,683,580,103,11
14838,2023-09-11 06:00:00,103,227,14,14,760,606,154,5
14839,2023-09-11 07:00:00,121,274,8,16,735,549,186,7
14840,2023-09-11 08:00:00,115,162,5,17,708,564,144,6
14841,2023-09-11 09:00:00,87,277,11,10,621,535,86,14
14842,2023-09-11 10:00:00,140,122,11,17,738,590,148,11
14843,2023-09-11 11:00:00,68,140,9,12,678,573,105,12
14844,2023-09-11 12:00:00,81,200,11,19,776,661,115,6
14845,2023-09-11 13:00:00,128,115,5,16,792,686,106,13
14846,2023-09-11 14:00:00,55,228,10,11,547,478,69,14
14847,2023-09-11 15:00:00,50,292,6,16,609,505,104,10
14848,2023-09-11 16:00:00,56,151,6,17,712,520,192,5
14849,2023-09-11 17:00:00,54,276,10,19,680,536,144,14
14850,2023-09-11 18:00:00,118,163,12,19,695,616,79,5
14851,2023-09-11 19:00:00,77,276,5,14,797,611,186,11
14852,2023-09-11 20:00:00,62,199,8,14,543,452,91,9
14853,2023-09-11 21:00:00,112,216,7,11,757,563,194,9
14854,2023-09-11 22:00:00,97,178,6,10,609,435,174,6
14855,2023-09-11 23:00:00,62,181,10,18,660,572,88,11
14856,2023-09-12 00:00:00,56,208,8,18,691,581,110,12
14857,2023-09-12 01:00:00,96,250,14,17,528,456,72,7
14858,2023-09-12 02:00:00,51,140,12,11,738,565,173,10
14859,2023-09-12 03:00:00,112,125,9,15,541,414,127,14
14860,2023-09-12 04:00:00,144,203,13,17,570,452,118,14
14861,2023-09-12 05:00:00,66,141,6,19,791,624,167,11
14862,2023-09-12 06:00:00,102,274,8,13,537,394,143,6
14863,2023-09-12 07:00:00,117,120,10,18,544,425,119,9
14864,2023-09-12 08:00:00,140,259,9,14,679,545,134,14
14865,2023-09-12 09:00:00,120,127,5,18,681,603,78,14
14866,2023-09-12 10:00:00,55,110,9,11,702,582,120,11
14867,2023-09-12 11:00:00,66,172,12,17,680,503,177,6
14868,2023-09-12 12:00:00,92,190,7,14,747,670,77,6
14869,2023-09-12 13:00:00,68,278,5,18,618,455,163,8
14870,2023-09-12 14:00:00,73,268,7,11,781,565,216,13
14871,2023-09-12 15:00:00,117,240,7,12,768,555,213,7
14872,2023-09-12 16:00:00,149,273,11,19,641,576,65,11
14873,2023-09-12 17:00:00,131,105,9,17,744,622,122,12
14874,2023-09-12 18:00:00,71,249,9,18,655,476,179,14
14875,2023-09-12 19:00:00,69,281,9,12,559,497,62,10
14876,2023-09-12 20:00:00,86,138,12,15,591,472,119,8
14877,2023-09-12 21:00:00,102,257,6,19,617,552,65,7
14878,2023-09-12 22:00:00,130,129,14,14,722,643,79,9
14879,2023-09-12 23:00:00,122,115,11,18,590,468,122,5
14880,2023-09-13 00:00:00,96,108,13,14,549,490,59,7
14881,2023-09-13 01:00:00,119,142,5,17,579,407,172,14
14882,2023-09-13 02:00:00,121,134,13,13,681,492,189,14
14883,2023-09-13 03:00:00,118,230,10,11,734,553,181,6
14884,2023-09-13 04:00:00,85,111,8,15,624,510,114,14
14885,2023-09-13 05:00:00,76,272,13,12,708,500,208,9
14886,2023-09-13 06:00:00,118,211,11,18,638,448,190,9
14887,2023-09-13 07:00:00,137,173,11,16,579,520,59,12
14888,2023-09-13 08:00:00,77,238,13,14,564,407,157,9
14889,2023-09-13 09:00:00,118,292,12,15,753,591,162,6
14890,2023-09-13 10:00:00,137,155,12,14,701,508,193,7
14891,2023-09-13 11:00:00,133,245,9,17,544,452,92,12
14892,2023-09-13 12:00:00,139,108,12,13,685,584,101,6
14893,2023-09-13 13:00:00,121,102,12,16,785,600,185,12
14894,2023-09-13 14:00:00,101,198,13,19,606,473,133,12
14895,2023-09-13 15:00:00,59,233,13,15,539,469,70,10
14896,2023-09-13 16:00:00,71,118,13,18,748,565,183,5
14897,2023-09-13 17:00:00,110,282,7,17,518,440,78,13
14898,2023-09-13 18:00:00,85,111,13,10,781,593,188,12
14899,2023-09-13 19:00:00,61,152,6,16,645,524,121,13
14900,2023-09-13 20:00:00,61,121,14,11,599,482,117,8
14901,2023-09-13 21:00:00,76,165,5,16,537,456,81,8
14902,2023-09-13 22:00:00,83,129,12,12,789,614,175,6
14903,2023-09-13 23:00:00,105,104,10,10,709,603,106,12
14904,2023-09-14 00:00:00,140,108,6,12,550,475,75,14
14905,2023-09-14 01:00:00,104,280,11,17,751,608,143,7
14906,2023-09-14 02:00:00,82,246,6,19,684,602,82,5
14907,2023-09-14 03:00:00,104,194,6,17,695,507,188,14
14908,2023-09-14 04:00:00,80,150,13,13,741,616,125,11
14909,2023-09-14 05:00:00,137,141,5,15,551,451,100,10
14910,2023-09-14 06:00:00,148,137,6,18,555,488,67,6
14911,2023-09-14 07:00:00,115,103,5,15,591,528,63,14
14912,2023-09-14 08:00:00,95,112,10,10,680,531,149,7
14913,2023-09-14 09:00:00,101,273,5,19,744,548,196,12
14914,2023-09-14 10:00:00,85,133,11,18,590,417,173,8
14915,2023-09-14 11:00:00,94,228,7,14,631,469,162,11
14916,2023-09-14 12:00:00,70,219,6,18,725,561,164,9
14917,2023-09-14 13:00:00,145,276,13,11,706,623,83,5
14918,2023-09-14 14:00:00,68,281,14,13,612,481,131,8
14919,2023-09-14 15:00:00,97,120,8,11,539,379,160,7
14920,2023-09-14 16:00:00,121,210,6,18,533,446,87,14
14921,2023-09-14 17:00:00,82,265,10,10,533,390,143,11
14922,2023-09-14 18:00:00,78,187,11,14,618,537,81,13
14923,2023-09-14 19:00:00,144,209,13,14,600,524,76,8
14924,2023-09-14 20:00:00,96,262,7,18,735,590,145,14
14925,2023-09-14 21:00:00,125,167,10,15,790,641,149,8
14926,2023-09-14 22:00:00,77,196,7,15,740,627,113,7
14927,2023-09-14 23:00:00,116,238,7,15,594,456,138,11
14928,2023-09-15 00:00:00,69,191,11,17,754,577,177,11
14929,2023-09-15 01:00:00,125,166,12,14,670,557,113,12
14930,2023-09-15 02:00:00,106,114,11,15,537,378,159,11
14931,2023-09-15 03:00:00,81,241,7,15,627,518,109,5
14932,2023-09-15 04:00:00,145,127,13,12,796,572,224,12
14933,2023-09-15 05:00:00,122,244,5,18,711,577,134,10
14934,2023-09-15 06:00:00,50,157,14,14,706,627,79,11
14935,2023-09-15 07:00:00,111,290,6,15,731,611,120,14
14936,2023-09-15 08:00:00,79,177,9,15,520,391,129,5
14937,2023-09-15 09:00:00,145,207,5,11,798,629,169,5
14938,2023-09-15 10:00:00,58,297,9,10,523,456,67,13
14939,2023-09-15 11:00:00,77,255,9,11,607,478,129,10
14940,2023-09-15 12:00:00,67,194,7,18,534,439,95,6
14941,2023-09-15 13:00:00,63,119,5,11,581,429,152,12
14942,2023-09-15 14:00:00,88,197,12,12,630,464,166,12
14943,2023-09-15 15:00:00,137,139,11,14,760,644,116,14
14944,2023-09-15 16:00:00,99,215,11,18,506,402,104,11
14945,2023-09-15 17:00:00,105,143,9,14,623,545,78,13
14946,2023-09-15 18:00:00,57,253,11,15,752,617,135,12
14947,2023-09-15 19:00:00,69,230,12,11,736,629,107,9
14948,2023-09-15 20:00:00,139,235,5,14,723,575,148,12
14949,2023-09-15 21:00:00,138,277,6,12,501,364,137,5
14950,2023-09-15 22:00:00,144,289,9,17,588,432,156,9
14951,2023-09-15 23:00:00,148,280,12,17,558,408,150,9
14952,2023-09-16 00:00:00,140,262,5,16,674,535,139,7
14953,2023-09-16 01:00:00,140,128,8,15,627,544,83,6
14954,2023-09-16 02:00:00,117,190,7,15,609,501,108,13
14955,2023-09-16 03:00:00,116,118,8,18,518,385,133,8
14956,2023-09-16 04:00:00,81,127,12,12,568,479,89,11
14957,2023-09-16 05:00:00,124,231,6,13,649,533,116,5
14958,2023-09-16 06:00:00,103,140,12,13,658,556,102,13
14959,2023-09-16 07:00:00,118,244,11,17,525,466,59,7
14960,2023-09-16 08:00:00,140,273,12,15,791,638,153,14
14961,2023-09-16 09:00:00,53,214,5,16,595,464,131,14
14962,2023-09-16 10:00:00,134,185,12,19,639,541,98,5
14963,2023-09-16 11:00:00,146,252,9,18,749,598,151,12
14964,2023-09-16 12:00:00,68,188,14,13,594,481,113,11
14965,2023-09-16 13:00:00,137,141,11,12,718,505,213,9
14966,2023-09-16 14:00:00,53,101,5,17,655,557,98,6
14967,2023-09-16 15:00:00,138,255,10,10,764,568,196,9
14968,2023-09-16 16:00:00,83,193,6,17,718,598,120,5
14969,2023-09-16 17:00:00,111,147,13,15,544,485,59,14
14970,2023-09-16 18:00:00,68,270,11,18,581,419,162,10
14971,2023-09-16 19:00:00,109,297,10,17,670,497,173,14
14972,2023-09-16 20:00:00,62,223,7,16,768,637,131,8
14973,2023-09-16 21:00:00,59,207,11,10,593,455,138,14
14974,2023-09-16 22:00:00,63,120,7,14,588,495,93,14
14975,2023-09-16 23:00:00,74,280,7,14,641,475,166,12
14976,2023-09-17 00:00:00,119,138,6,15,709,614,95,8
14977,2023-09-17 01:00:00,130,228,11,15,592,478,114,9
14978,2023-09-17 02:00:00,56,117,12,12,729,574,155,5
14979,2023-09-17 03:00:00,123,124,14,12,533,437,96,11
14980,2023-09-17 04:00:00,148,162,7,17,610,457,153,5
14981,2023-09-17 05:00:00,53,121,13,11,547,400,147,11
14982,2023-09-17 06:00:00,115,152,12,18,548,405,143,11
14983,2023-09-17 07:00:00,131,220,7,12,741,522,219,10
14984,2023-09-17 08:00:00,115,229,12,14,599,437,162,12
14985,2023-09-17 09:00:00,103,271,14,15,755,629,126,13
14986,2023-09-17 10:00:00,59,204,7,10,607,489,118,10
14987,2023-09-17 11:00:00,52,296,13,14,787,569,218,13
14988,2023-09-17 12:00:00,57,205,5,17,673,485,188,13
14989,2023-09-17 13:00:00,117,289,6,12,555,494,61,12
14990,2023-09-17 14:00:00,126,225,12,12,639,471,168,5
14991,2023-09-17 15:00:00,101,201,8,17,642,451,191,11
14992,2023-09-17 16:00:00,107,228,13,10,651,501,150,12
14993,2023-09-17 17:00:00,78,161,7,19,740,542,198,13
14994,2023-09-17 18:00:00,125,282,13,17,763,668,95,7
14995,2023-09-17 19:00:00,117,105,7,16,562,454,108,9
14996,2023-09-17 20:00:00,144,190,10,10,637,559,78,11
14997,2023-09-17 21:00:00,53,234,6,15,604,464,140,6
14998,2023-09-17 22:00:00,85,190,7,15,649,510,139,14
14999,2023-09-17 23:00:00,122,201,14,18,564,436,128,6
15000,2023-09-18 00:00:00,128,258,13,13,655,576,79,6
15001,2023-09-18 01:00:00,147,229,13,10,794,607,187,8
15002,2023-09-18 02:00:00,134,268,10,16,630,504,126,14
15003,2023-09-18 03:00:00,135,202,7,12,716,582,134,6
15004,2023-09-18 04:00:00,79,253,8,16,765,622,143,13
15005,2023-09-18 05:00:00,133,171,13,17,646,519,127,6
15006,2023-09-18 06:00:00,114,152,13,16,758,607,151,9
15007,2023-09-18 07:00:00,57,295,5,12,712,553,159,6
15008,2023-09-18 08:00:00,145,271,12,14,746,625,121,12
15009,2023-09-18 09:00:00,91,168,5,14,762,586,176,6
15010,2023-09-18 10:00:00,99,298,6,15,563,466,97,7
15011,2023-09-18 11:00:00,93,218,10,18,542,443,99,12
15012,2023-09-18 12:00:00,139,238,13,19,721,526,195,8
15013,2023-09-18 13:00:00,130,280,8,12,613,440,173,14
15014,2023-09-18 14:00:00,114,207,13,13,529,465,64,6
15015,2023-09-18 15:00:00,128,298,5,19,605,527,78,12
15016,2023-09-18 16:00:00,73,298,6,18,778,666,112,8
15017,2023-09-18 17:00:00,62,140,12,11,758,665,93,10
15018,2023-09-18 18:00:00,78,118,13,17,657,561,96,9
15019,2023-09-18 19:00:00,106,191,12,13,672,565,107,13
15020,2023-09-18 20:00:00,120,100,13,18,682,496,186,7
15021,2023-09-18 21:00:00,94,185,8,13,675,555,120,6
15022,2023-09-18 22:00:00,145,156,9,10,610,464,146,7
15023,2023-09-18 23:00:00,139,219,8,18,628,502,126,12
15024,2023-09-19 00:00:00,56,105,5,13,611,538,73,9
15025,2023-09-19 01:00:00,145,192,14,11,562,426,136,9
15026,2023-09-19 02:00:00,104,174,8,13,736,621,115,10
15027,2023-09-19 03:00:00,130,191,6,15,794,713,81,10
15028,2023-09-19 04:00:00,129,188,14,12,754,544,210,10
15029,2023-09-19 05:00:00,144,205,11,10,717,527,190,10
15030,2023-09-19 06:00:00,129,144,7,14,583,422,161,8
15031,2023-09-19 07:00:00,70,241,8,14,648,571,77,14
15032,2023-09-19 08:00:00,108,198,8,19,702,536,166,7
15033,2023-09-19 09:00:00,86,252,7,11,581,476,105,10
15034,2023-09-19 10:00:00,129,195,13,13,729,563,166,7
15035,2023-09-19 11:00:00,73,206,9,10,748,601,147,9
15036,2023-09-19 12:00:00,54,166,6,16,699,575,124,9
15037,2023-09-19 13:00:00,103,194,6,16,504,385,119,7
15038,2023-09-19 14:00:00,51,134,10,18,623,488,135,13
15039,2023-09-19 15:00:00,74,277,9,12,628,460,168,13
15040,2023-09-19 16:00:00,125,172,10,12,796,635,161,11
15041,2023-09-19 17:00:00,126,109,12,15,739,664,75,11
15042,2023-09-19 18:00:00,80,186,14,17,741,629,112,10
15043,2023-09-19 19:00:00,99,123,7,14,597,526,71,8
15044,2023-09-19 20:00:00,58,192,8,17,782,655,127,10
15045,2023-09-19 21:00:00,102,191,13,19,522,393,129,6
15046,2023-09-19 22:00:00,78,285,8,15,625,539,86,10
15047,2023-09-19 23:00:00,128,274,10,11,523,391,132,8
15048,2023-09-20 00:00:00,78,143,9,19,766,584,182,6
15049,2023-09-20 01:00:00,113,223,10,15,790,650,140,6
15050,2023-09-20 02:00:00,144,164,6,15,563,475,88,13
15051,2023-09-20 03:00:00,118,184,12,14,563,487,76,12
15052,2023-09-20 04:00:00,53,248,8,17,628,443,185,11
15053,2023-09-20 05:00:00,140,275,13,13,732,635,97,14
15054,2023-09-20 06:00:00,141,197,8,14,650,579,71,12
15055,2023-09-20 07:00:00,121,178,9,11,529,397,132,11
15056,2023-09-20 08:00:00,58,151,12,11,746,671,75,7
15057,2023-09-20 09:00:00,136,184,5,17,776,628,148,9
15058,2023-09-20 10:00:00,105,196,14,18,740,536,204,5
15059,2023-09-20 11:00:00,124,167,8,16,790,634,156,12
15060,2023-09-20 12:00:00,136,257,12,12,528,467,61,9
15061,2023-09-20 13:00:00,67,299,12,17,710,509,201,13
15062,2023-09-20 14:00:00,54,202,9,19,672,512,160,9
15063,2023-09-20 15:00:00,132,137,13,16,635,567,68,6
15064,2023-09-20 16:00:00,58,241,7,17,799,596,203,9
15065,2023-09-20 17:00:00,83,242,10,16,503,419,84,11
15066,2023-09-20 18:00:00,129,124,5,13,641,557,84,10
15067,2023-09-20 19:00:00,147,211,7,10,679,523,156,13
15068,2023-09-20 20:00:00,127,123,5,16,707,539,168,13
15069,2023-09-20 21:00:00,132,214,6,16,763,675,88,9
15070,2023-09-20 22:00:00,99,199,7,17,689,616,73,10
15071,2023-09-20 23:00:00,92,269,9,13,623,501,122,10
15072,2023-09-21 00:00:00,89,226,14,14,718,604,114,10
15073,2023-09-21 01:00:00,106,138,5,16,738,572,166,12
15074,2023-09-21 02:00:00,59,140,10,17,623,520,103,13
15075,2023-09-21 03:00:00,94,210,5,12,714,558,156,11
15076,2023-09-21 04:00:00,123,114,9,11,663,557,106,8
15077,2023-09-21 05:00:00,75,128,12,10,792,571,221,8
15078,2023-09-21 06:00:00,144,188,10,12,543,418,125,5
15079,2023-09-21 07:00:00,129,201,10,11,555,420,135,9
15080,2023-09-21 08:00:00,72,180,5,17,631,463,168,7
15081,2023-09-21 09:00:00,116,298,9,12,773,686,87,10
15082,2023-09-21 10:00:00,69,176,6,14,538,433,105,12
15083,2023-09-21 11:00:00,109,157,5,18,596,438,158,12
15084,2023-09-21 12:00:00,96,119,11,16,579,407,172,7
15085,2023-09-21 13:00:00,95,219,11,19,694,619,75,5
15086,2023-09-21 14:00:00,107,297,9,19,737,546,191,13
15087,2023-09-21 15:00:00,77,249,9,10,585,488,97,8
15088,2023-09-21 16:00:00,85,256,5,18,623,469,154,7
15089,2023-09-21 17:00:00,97,284,9,18,771,680,91,14
15090,2023-09-21 18:00:00,70,258,14,18,665,496,169,7
15091,2023-09-21 19:00:00,74,202,13,15,749,645,104,8
15092,2023-09-21 20:00:00,77,226,14,17,744,606,138,5
15093,2023-09-21 21:00:00,137,169,12,14,644,515,129,9
15094,2023-09-21 22:00:00,132,188,10,10,552,456,96,5
15095,2023-09-21 23:00:00,74,222,12,11,686,564,122,9
15096,2023-09-22 00:00:00,76,222,14,11,540,404,136,12
15097,2023-09-22 01:00:00,72,279,14,17,738,568,170,9
15098,2023-09-22 02:00:00,76,272,11,17,534,461,73,13
15099,2023-09-22 03:00:00,71,124,10,15,515,361,154,10
15100,2023-09-22 04:00:00,59,292,12,16,690,605,85,12
15101,2023-09-22 05:00:00,85,122,5,18,725,612,113,13
15102,2023-09-22 06:00:00,142,125,5,11,505,361,144,12
15103,2023-09-22 07:00:00,68,104,12,11,539,455,84,14
15104,2023-09-22 08:00:00,123,131,13,11,534,388,146,7
15105,2023-09-22 09:00:00,132,298,9,15,702,616,86,7
15106,2023-09-22 10:00:00,148,262,10,12,606,514,92,8
15107,2023-09-22 11:00:00,107,108,13,18,634,465,169,6
15108,2023-09-22 12:00:00,80,268,7,13,603,491,112,9
15109,2023-09-22 13:00:00,105,127,7,10,679,569,110,8
15110,2023-09-22 14:00:00,124,175,13,18,757,602,155,12
15111,2023-09-22 15:00:00,67,186,8,13,692,494,198,5
15112,2023-09-22 16:00:00,54,213,10,12,685,480,205,13
15113,2023-09-22 17:00:00,83,158,5,15,737,536,201,6
15114,2023-09-22 18:00:00,106,228,12,12,530,434,96,13
15115,2023-09-22 19:00:00,98,230,11,11,640,493,147,13
15116,2023-09-22 20:00:00,80,250,14,11,602,484,118,11
15117,2023-09-22 21:00:00,126,126,10,14,665,504,161,14
15118,2023-09-22 22:00:00,141,295,8,10,558,390,168,6
15119,2023-09-22 23:00:00,124,100,8,11,543,455,88,14
15120,2023-09-23 00:00:00,53,166,14,19,774,615,159,9
15121,2023-09-23 01:00:00,135,265,6,18,534,391,143,14
15122,2023-09-23 02:00:00,63,239,6,16,692,551,141,7
15123,2023-09-23 03:00:00,68,229,13,11,747,576,171,5
15124,2023-09-23 04:00:00,92,149,6,10,502,377,125,12
15125,2023-09-23 05:00:00,100,264,8,10,505,451,54,7
15126,2023-09-23 06:00:00,76,153,13,13,757,581,176,10
15127,2023-09-23 07:00:00,140,206,10,15,522,469,53,11
15128,2023-09-23 08:00:00,136,200,13,15,614,480,134,14
15129,2023-09-23 09:00:00,134,286,9,17,543,469,74,7
15130,2023-09-23 10:00:00,121,228,6,18,670,483,187,10
15131,2023-09-23 11:00:00,120,141,10,18,631,470,161,9
15132,2023-09-23 12:00:00,112,198,9,15,787,617,170,9
15133,2023-09-23 13:00:00,149,125,13,18,545,410,135,6
15134,2023-09-23 14:00:00,64,188,7,17,736,556,180,6
15135,2023-09-23 15:00:00,82,231,13,18,785,700,85,7
15136,2023-09-23 16:00:00,52,211,9,11,524,471,53,12
15137,2023-09-23 17:00:00,54,117,13,10,685,502,183,13
15138,2023-09-23 18:00:00,64,221,11,10,563,498,65,9
15139,2023-09-23 19:00:00,110,160,10,19,673,577,96,9
15140,2023-09-23 20:00:00,101,260,12,14,604,512,92,9
15141,2023-09-23 21:00:00,61,261,11,13,696,499,197,5
15142,2023-09-23 22:00:00,118,112,9,19,737,583,154,8
15143,2023-09-23 23:00:00,71,215,6,19,518,380,138,9
15144,2023-09-24 00:00:00,105,229,13,12,603,539,64,8
15145,2023-09-24 01:00:00,141,101,9,15,747,556,191,12
15146,2023-09-24 02:00:00,147,130,10,14,614,455,159,10
15147,2023-09-24 03:00:00,60,221,9,10,710,618,92,12
15148,2023-09-24 04:00:00,62,133,14,18,533,390,143,5
15149,2023-09-24 05:00:00,82,158,7,13,700,556,144,14
15150,2023-09-24 06:00:00,115,210,7,10,651,576,75,12
15151,2023-09-24 07:00:00,115,144,13,10,746,584,162,10
15152,2023-09-24 08:00:00,88,102,12,13,787,566,221,11
15153,2023-09-24 09:00:00,127,166,8,13,720,556,164,11
15154,2023-09-24 10:00:00,71,133,5,10,621,495,126,10
15155,2023-09-24 11:00:00,107,292,6,13,591,515,76,5
15156,2023-09-24 12:00:00,94,250,11,15,656,583,73,6
15157,2023-09-24 13:00:00,142,189,13,15,779,575,204,13
15158,2023-09-24 14:00:00,80,283,14,10,729,552,177,9
15159,2023-09-24 15:00:00,50,225,5,18,510,365,145,10
15160,2023-09-24 16:00:00,131,115,13,13,625,499,126,12
15161,2023-09-24 17:00:00,125,190,11,14,771,604,167,14
15162,2023-09-24 18:00:00,54,261,11,15,726,566,160,5
15163,2023-09-24 19:00:00,99,212,9,12,655,555,100,11
15164,2023-09-24 20:00:00,70,116,5,13,616,525,91,13
15165,2023-09-24 21:00:00,103,192,7,11,540,388,152,8
15166,2023-09-24 22:00:00,84,182,6,15,589,426,163,5
15167,2023-09-24 23:00:00,90,286,11,12,687,535,152,5
15168,2023-09-25 00:00:00,62,256,9,10,567,482,85,11
15169,2023-09-25 01:00:00,125,192,11,16,670,588,82,5
15170,2023-09-25 02:00:00,69,130,8,17,615,538,77,10
15171,2023-09-25 03:00:00,129,292,13,14,569,482,87,9
15172,2023-09-25 04:00:00,100,288,13,16,512,442,70,10
15173,2023-09-25 05:00:00,136,180,9,19,722,616,106,12
15174,2023-09-25 06:00:00,68,150,9,10,733,630,103,12
15175,2023-09-25 07:00:00,85,273,12,14,585,488,97,11
15176,2023-09-25 08:00:00,61,131,13,10,789,703,86,13
15177,2023-09-25 09:00:00,126,240,11,17,607,442,165,11
15178,2023-09-25 10:00:00,80,166,11,14,736,548,188,7
15179,2023-09-25 11:00:00,82,141,7,19,562,491,71,6
15180,2023-09-25 12:00:00,89,268,10,14,681,507,174,9
15181,2023-09-25 13:00:00,74,170,5,12,586,435,151,11
15182,2023-09-25 14:00:00,89,285,5,15,759,682,77,9
15183,2023-09-25 15:00:00,146,220,5,17,621,477,144,11
15184,2023-09-25 16:00:00,129,176,13,17,707,613,94,14
15185,2023-09-25 17:00:00,65,269,7,14,569,496,73,7
15186,2023-09-25 18:00:00,130,123,9,12,516,371,145,7
15187,2023-09-25 19:00:00,95,233,6,19,798,567,231,10
15188,2023-09-25 20:00:00,126,245,14,12,607,515,92,6
15189,2023-09-25 21:00:00,85,201,8,12,678,512,166,10
15190,2023-09-25 22:00:00,136,267,12,16,654,496,158,10
15191,2023-09-25 23:00:00,149,157,11,16,789,660,129,7
15192,2023-09-26 00:00:00,138,209,7,19,601,457,144,11
15193,2023-09-26 01:00:00,66,197,12,15,635,565,70,13
15194,2023-09-26 02:00:00,119,130,6,12,713,545,168,9
15195,2023-09-26 03:00:00,54,284,9,12,664,520,144,10
15196,2023-09-26 04:00:00,142,129,7,10,626,478,148,8
15197,2023-09-26 05:00:00,90,180,6,17,723,525,198,8
15198,2023-09-26 06:00:00,118,108,9,13,502,429,73,13
15199,2023-09-26 07:00:00,100,276,10,11,521,382,139,11
15200,2023-09-26 08:00:00,146,112,12,18,504,437,67,10
15201,2023-09-26 09:00:00,100,230,12,13,698,585,113,8
15202,2023-09-26 10:00:00,104,127,6,16,662,520,142,12
15203,2023-09-26 11:00:00,58,173,13,14,787,673,114,9
15204,2023-09-26 12:00:00,97,127,5,10,783,646,137,8
15205,2023-09-26 13:00:00,142,220,11,14,706,618,88,11
15206,2023-09-26 14:00:00,111,259,12,12,748,634,114,9
15207,2023-09-26 15:00:00,149,259,9,19,772,635,137,13
15208,2023-09-26 16:00:00,73,131,14,15,656,514,142,12
15209,2023-09-26 17:00:00,61,235,13,19,593,512,81,11
15210,2023-09-26 18:00:00,146,250,11,18,590,516,74,5
15211,2023-09-26 19:00:00,137,195,12,15,668,598,70,13
15212,2023-09-26 20:00:00,133,218,13,19,625,485,140,5
15213,2023-09-26 21:00:00,55,113,12,10,794,576,218,6
15214,2023-09-26 22:00:00,128,112,6,14,611,539,72,12
15215,2023-09-26 23:00:00,50,138,6,11,751,555,196,12
15216,2023-09-27 00:00:00,83,283,13,13,523,423,100,7
15217,2023-09-27 01:00:00,107,143,6,16,654,490,164,10
15218,2023-09-27 02:00:00,147,157,13,18,617,496,121,5
15219,2023-09-27 03:00:00,58,152,14,15,635,493,142,11
15220,2023-09-27 04:00:00,149,296,6,12,587,485,102,5
15221,2023-09-27 05:00:00,92,197,9,18,702,534,168,6
15222,2023-09-27 06:00:00,99,222,14,12,556,418,138,7
15223,2023-09-27 07:00:00,106,169,10,17,656,586,70,12
15224,2023-09-27 08:00:00,138,163,9,11,795,634,161,6
15225,2023-09-27 09:00:00,83,173,12,10,728,596,132,8
15226,2023-09-27 10:00:00,110,192,13,13,774,646,128,6
15227,2023-09-27 11:00:00,141,248,13,14,533,451,82,9
15228,2023-09-27 12:00:00,71,256,10,15,551,462,89,10
15229,2023-09-27 13:00:00,135,172,12,14,645,566,79,11
15230,2023-09-27 14:00:00,109,201,10,17,544,470,74,9
15231,2023-09-27 15:00:00,76,120,7,15,787,615,172,6
15232,2023-09-27 16:00:00,114,107,8,10,784,580,204,12
15233,2023-09-27 17:00:00,61,130,6,17,550,463,87,5
15234,2023-09-27 18:00:00,51,167,9,12,588,493,95,8
15235,2023-09-27 19:00:00,117,220,9,11,555,459,96,9
15236,2023-09-27 20:00:00,62,184,14,18,748,557,191,10
15237,2023-09-27 21:00:00,92,223,10,11,647,575,72,9
15238,2023-09-27 22:00:00,91,261,8,13,612,496,116,13
15239,2023-09-27 23:00:00,98,107,12,10,622,444,178,10
15240,2023-09-28 00:00:00,79,287,13,16,531,469,62,12
15241,2023-09-28 01:00:00,110,208,12,14,519,375,144,6
15242,2023-09-28 02:00:00,100,118,9,18,529,427,102,8
15243,2023-09-28 03:00:00,105,183,13,17,678,572,106,9
15244,2023-09-28 04:00:00,116,246,7,17,680,538,142,5
15245,2023-09-28 05:00:00,127,142,14,10,523,379,144,12
15246,2023-09-28 06:00:00,139,238,6,18,678,494,184,14
15247,2023-09-28 07:00:00,149,176,11,13,768,619,149,9
15248,2023-09-28 08:00:00,91,265,12,14,737,621,116,14
15249,2023-09-28 09:00:00,66,290,13,17,690,599,91,7
15250,2023-09-28 10:00:00,75,240,12,12,619,510,109,9
15251,2023-09-28 11:00:00,138,298,6,15,502,403,99,9
15252,2023-09-28 12:00:00,149,112,9,10,594,490,104,12
15253,2023-09-28 13:00:00,108,274,5,18,664,574,90,13
15254,2023-09-28 14:00:00,141,272,13,11,684,499,185,7
15255,2023-09-28 15:00:00,103,253,7,19,648,496,152,14
15256,2023-09-28 16:00:00,129,226,13,14,779,688,91,13
15257,2023-09-28 17:00:00,53,121,11,17,630,474,156,7
15258,2023-09-28 18:00:00,108,257,11,16,699,593,106,12
15259,2023-09-28 19:00:00,137,155,9,18,543,461,82,10
15260,2023-09-28 20:00:00,64,204,10,19,766,570,196,12
15261,2023-09-28 21:00:00,62,131,8,16,588,497,91,11
15262,2023-09-28 22:00:00,129,255,14,14,559,467,92,12
15263,2023-09-28 23:00:00,100,253,8,11,585,430,155,12
15264,2023-09-29 00:00:00,79,232,12,11,723,590,133,11
15265,2023-09-29 01:00:00,142,209,11,19,580,438,142,7
15266,2023-09-29 02:00:00,98,265,6,13,699,605,94,10
15267,2023-09-29 03:00:00,89,145,10,13,752,538,214,6
15268,2023-09-29 04:00:00,106,147,11,13,737,648,89,14
15269,2023-09-29 05:00:00,113,190,8,15,513,416,97,14
15270,2023-09-29 06:00:00,115,267,12,19,734,539,195,7
15271,2023-09-29 07:00:00,129,108,11,13,659,589,70,5
15272,2023-09-29 08:00:00,90,166,14,15,759,648,111,8
15273,2023-09-29 09:00:00,79,207,14,11,520,381,139,11
15274,2023-09-29 10:00:00,86,125,14,14,646,502,144,12
15275,2023-09-29 11:00:00,73,195,14,12,536,425,111,14
15276,2023-09-29 12:00:00,141,228,7,10,674,506,168,11
15277,2023-09-29 13:00:00,67,112,10,14,790,681,109,12
15278,2023-09-29 14:00:00,122,220,12,18,736,634,102,14
15279,2023-09-29 15:00:00,149,246,11,19,592,513,79,13
15280,2023-09-29 16:00:00,148,207,5,18,556,480,76,7
15281,2023-09-29 17:00:00,92,163,10,11,669,590,79,14
15282,2023-09-29 18:00:00,134,167,14,16,618,548,70,7
15283,2023-09-29 19:00:00,126,136,7,14,591,473,118,6
15284,2023-09-29 20:00:00,142,206,9,16,540,451,89,10
15285,2023-09-29 21:00:00,101,147,6,18,608,508,100,14
15286,2023-09-29 22:00:00,125,160,6,17,735,571,164,14
15287,2023-09-29 23:00:00,103,196,13,10,648,541,107,14
15288,2023-09-30 00:00:00,93,254,11,11,790,578,212,14
15289,2023-09-30 01:00:00,65,217,5,10,542,415,127,12
15290,2023-09-30 02:00:00,72,263,8,18,706,622,84,9
15291,2023-09-30 03:00:00,106,191,11,17,572,485,87,14
15292,2023-09-30 04:00:00,79,277,14,12,705,493,212,9
15293,2023-09-30 05:00:00,129,239,12,19,567,438,129,9
15294,2023-09-30 06:00:00,119,156,10,11,732,542,190,6
15295,2023-09-30 07:00:00,101,218,10,15,576,512,64,6
15296,2023-09-30 08:00:00,61,291,5,17,617,544,73,14
15297,2023-09-30 09:00:00,138,157,8,15,799,707,92,10
15298,2023-09-30 10:00:00,112,166,14,11,535,462,73,14
15299,2023-09-30 11:00:00,139,276,12,15,661,497,164,5
15300,2023-09-30 12:00:00,86,241,6,15,582,443,139,7
15301,2023-09-30 13:00:00,80,219,10,10,730,578,152,6
15302,2023-09-30 14:00:00,112,242,7,19,590,451,139,7
15303,2023-09-30 15:00:00,94,135,9,18,733,515,218,13
15304,2023-09-30 16:00:00,94,194,7,16,725,567,158,7
15305,2023-09-30 17:00:00,92,171,7,10,778,603,175,7
15306,2023-09-30 18:00:00,84,212,8,11,723,553,170,6
15307,2023-09-30 19:00:00,148,292,12,10,739,543,196,13
15308,2023-09-30 20:00:00,53,225,11,16,587,447,140,10
15309,2023-09-30 21:00:00,104,154,13,16,637,468,169,11
15310,2023-09-30 22:00:00,99,244,6,16,748,648,100,10
15311,2023-09-30 23:00:00,130,184,8,11,507,424,83,13
15312,2023-10-01 00:00:00,137,256,11,11,769,662,107,12
15313,2023-10-01 01:00:00,129,247,7,16,791,585,206,10
15314,2023-10-01 02:00:00,112,110,8,10,735,554,181,12
15315,2023-10-01 03:00:00,89,257,6,12,729,553,176,8
15316,2023-10-01 04:00:00,70,242,13,14,772,650,122,11
15317,2023-10-01 05:00:00,136,128,6,15,701,532,169,10
15318,2023-10-01 06:00:00,64,128,7,13,651,574,77,12
15319,2023-10-01 07:00:00,67,120,7,11,722,610,112,9
15320,2023-10-01 08:00:00,73,297,11,19,729,523,206,14
15321,2023-10-01 09:00:00,121,224,6,16,634,505,129,6
15322,2023-10-01 10:00:00,82,244,7,18,540,437,103,12
15323,2023-10-01 11:00:00,118,168,10,11,707,566,141,14
15324,2023-10-01 12:00:00,61,265,14,15,619,488,131,7
15325,2023-10-01 13:00:00,78,123,5,15,691,573,118,6
15326,2023-10-01 14:00:00,98,272,14,13,508,444,64,13
15327,2023-10-01 15:00:00,127,148,10,13,605,442,163,7
15328,2023-10-01 16:00:00,135,199,11,12,744,538,206,13
15329,2023-10-01 17:00:00,84,254,6,14,532,418,114,13
15330,2023-10-01 18:00:00,136,220,5,15,598,433,165,7
15331,2023-10-01 19:00:00,102,182,9,17,550,400,150,12
15332,2023-10-01 20:00:00,93,136,10,11,590,495,95,10
15333,2023-10-01 21:00:00,137,283,11,18,649,474,175,5
15334,2023-10-01 22:00:00,61,224,11,15,632,469,163,9
15335,2023-10-01 23:00:00,63,158,10,11,555,434,121,11
15336,2023-10-02 00:00:00,133,178,8,10,761,543,218,6
15337,2023-10-02 01:00:00,113,118,9,19,671,505,166,8
15338,2023-10-02 02:00:00,146,222,9,18,571,479,92,14
15339,2023-10-02 03:00:00,100,275,12,14,789,699,90,10
15340,2023-10-02 04:00:00,88,258,7,10,580,479,101,14
15341,2023-10-02 05:00:00,62,276,12,11,758,677,81,8
15342,2023-10-02 06:00:00,144,123,8,10,619,509,110,14
15343,2023-10-02 07:00:00,137,209,9,18,581,480,101,9
15344,2023-10-02 08:00:00,113,207,9,14,616,527,89,12
15345,2023-10-02 09:00:00,138,213,10,14,565,432,133,5
15346,2023-10-02 10:00:00,147,259,9,10,649,541,108,9
15347,2023-10-02 11:00:00,68,128,11,18,723,575,148,9
15348,2023-10-02 12:00:00,80,144,14,18,567,447,120,9
15349,2023-10-02 13:00:00,94,120,13,16,707,574,133,6
15350,2023-10-02 14:00:00,66,119,11,13,664,511,153,13
15351,2023-10-02 15:00:00,64,246,9,15,719,557,162,9
15352,2023-10-02 16:00:00,76,215,5,18,795,663,132,11
15353,2023-10-02 17:00:00,78,164,11,10,570,429,141,10
15354,2023-10-02 18:00:00,122,253,11,13,779,685,94,12
15355,2023-10-02 19:00:00,114,270,10,19,650,524,126,10
15356,2023-10-02 20:00:00,148,216,5,18,701,596,105,8
15357,2023-10-02 21:00:00,135,142,12,10,544,451,93,14
15358,2023-10-02 22:00:00,133,168,12,12,720,615,105,11
15359,2023-10-02 23:00:00,136,274,5,12,632,494,138,5
15360,2023-10-03 00:00:00,90,201,12,15,609,544,65,5
15361,2023-10-03 01:00:00,57,243,8,17,529,410,119,11
15362,2023-10-03 02:00:00,84,237,6,13,743,608,135,11
15363,2023-10-03 03:00:00,121,251,13,14,789,676,113,13
15364,2023-10-03 04:00:00,85,180,6,19,631,464,167,8
15365,2023-10-03 05:00:00,128,117,9,12,580,452,128,7
15366,2023-10-03 06:00:00,76,281,9,18,626,520,106,14
15367,2023-10-03 07:00:00,112,159,10,13,639,489,150,11
15368,2023-10-03 08:00:00,130,110,8,17,675,535,140,7
15369,2023-10-03 09:00:00,64,298,8,19,505,426,79,9
15370,2023-10-03 10:00:00,109,105,6,11,663,515,148,12
15371,2023-10-03 11:00:00,83,269,9,16,571,504,67,5
15372,2023-10-03 12:00:00,114,297,7,17,605,507,98,11
15373,2023-10-03 13:00:00,126,293,11,16,720,601,119,7
15374,2023-10-03 14:00:00,130,253,7,15,520,459,61,8
15375,2023-10-03 15:00:00,94,179,10,10,705,566,139,7
15376,2023-10-03 16:00:00,54,227,12,14,620,508,112,12
15377,2023-10-03 17:00:00,62,235,10,16,616,477,139,14
15378,2023-10-03 18:00:00,110,245,11,17,703,587,116,11
15379,2023-10-03 19:00:00,63,215,14,10,733,549,184,10
15380,2023-10-03 20:00:00,65,152,13,18,636,482,154,7
15381,2023-10-03 21:00:00,110,239,10,15,737,602,135,7
15382,2023-10-03 22:00:00,142,214,6,18,549,462,87,9
15383,2023-10-03 23:00:00,74,143,11,19,767,631,136,8
15384,2023-10-04 00:00:00,130,291,13,17,538,434,104,6
15385,2023-10-04 01:00:00,69,240,9,16,552,411,141,14
15386,2023-10-04 02:00:00,146,238,5,12,525,443,82,13
15387,2023-10-04 03:00:00,52,272,11,13,557,501,56,7
15388,2023-10-04 04:00:00,102,202,9,19,632,484,148,11
15389,2023-10-04 05:00:00,76,138,9,17,775,613,162,13
15390,2023-10-04 06:00:00,106,246,12,10,765,679,86,13
15391,2023-10-04 07:00:00,133,285,14,10,596,516,80,9
15392,2023-10-04 08:00:00,87,260,13,15,783,672,111,10
15393,2023-10-04 09:00:00,107,239,5,17,526,426,100,10
15394,2023-10-04 10:00:00,81,280,14,13,701,595,106,5
15395,2023-10-04 11:00:00,146,146,11,10,559,417,142,10
15396,2023-10-04 12:00:00,133,275,12,15,677,517,160,11
15397,2023-10-04 13:00:00,85,285,7,13,772,667,105,8
15398,2023-10-04 14:00:00,89,191,7,15,605,519,86,10
15399,2023-10-04 15:00:00,120,146,7,17,727,640,87,9
15400,2023-10-04 16:00:00,146,235,9,16,754,571,183,8
15401,2023-10-04 17:00:00,91,107,10,12,699,492,207,11
15402,2023-10-04 18:00:00,54,298,12,15,518,452,66,12
15403,2023-10-04 19:00:00,112,231,8,13,734,615,119,13
15404,2023-10-04 20:00:00,103,116,11,13,660,520,140,11
15405,2023-10-04 21:00:00,120,129,7,11,538,469,69,7
15406,2023-10-04 22:00:00,122,249,14,11,506,411,95,12
15407,2023-10-04 23:00:00,105,109,9,16,629,448,181,14
15408,2023-10-05 00:00:00,98,139,14,12,575,410,165,9
15409,2023-10-05 01:00:00,103,114,7,18,607,530,77,14
15410,2023-10-05 02:00:00,136,182,8,11,770,608,162,9
15411,2023-10-05 03:00:00,110,105,6,12,539,394,145,13
15412,2023-10-05 04:00:00,80,276,7,11,520,388,132,8
15413,2023-10-05 05:00:00,102,141,14,18,685,609,76,8
15414,2023-10-05 06:00:00,101,134,11,12,527,459,68,9
15415,2023-10-05 07:00:00,112,269,6,10,724,610,114,8
15416,2023-10-05 08:00:00,63,164,10,10,688,566,122,6
15417,2023-10-05 09:00:00,51,140,10,14,654,525,129,11
15418,2023-10-05 10:00:00,62,131,14,19,606,473,133,14
15419,2023-10-05 11:00:00,112,256,5,14,756,613,143,5
15420,2023-10-05 12:00:00,60,144,12,19,599,516,83,8
15421,2023-10-05 13:00:00,130,287,14,18,736,530,206,12
15422,2023-10-05 14:00:00,122,257,13,10,711,563,148,7
15423,2023-10-05 15:00:00,92,275,14,12,639,464,175,13
15424,2023-10-05 16:00:00,96,260,6,10,554,435,119,11
15425,2023-10-05 17:00:00,131,138,10,17,795,646,149,7
15426,2023-10-05 18:00:00,117,156,11,11,604,526,78,6
15427,2023-10-05 19:00:00,78,204,6,15,604,430,174,7
15428,2023-10-05 20:00:00,139,103,8,15,704,603,101,13
15429,2023-10-05 21:00:00,65,148,8,17,775,621,154,5
15430,2023-10-05 22:00:00,85,199,6,17,658,504,154,10
15431,2023-10-05 23:00:00,51,193,6,13,603,467,136,8
15432,2023-10-06 00:00:00,103,163,5,19,741,635,106,14
15433,2023-10-06 01:00:00,96,107,5,16,502,392,110,9
15434,2023-10-06 02:00:00,93,165,13,15,770,637,133,7
15435,2023-10-06 03:00:00,108,228,14,19,684,572,112,10
15436,2023-10-06 04:00:00,60,109,13,10,645,574,71,7
15437,2023-10-06 05:00:00,114,189,8,16,706,594,112,10
15438,2023-10-06 06:00:00,125,160,5,14,679,489,190,10
15439,2023-10-06 07:00:00,136,113,7,11,773,642,131,7
15440,2023-10-06 08:00:00,144,147,9,13,741,580,161,6
15441,2023-10-06 09:00:00,85,182,5,19,780,635,145,9
15442,2023-10-06 10:00:00,107,200,11,12,546,424,122,10
15443,2023-10-06 11:00:00,99,128,14,18,584,484,100,13
15444,2023-10-06 12:00:00,101,299,10,15,679,509,170,9
15445,2023-10-06 13:00:00,133,102,14,17,503,396,107,11
15446,2023-10-06 14:00:00,136,179,11,19,666,493,173,10
15447,2023-10-06 15:00:00,108,142,13,14,759,570,189,8
15448,2023-10-06 16:00:00,58,261,10,14,626,488,138,13
15449,2023-10-06 17:00:00,148,139,8,14,684,520,164,14
15450,2023-10-06 18:00:00,99,131,7,17,782,627,155,8
15451,2023-10-06 19:00:00,127,272,8,13,676,585,91,7
15452,2023-10-06 20:00:00,80,265,12,12,531,434,97,8
15453,2023-10-06 21:00:00,129,197,11,12,762,545,217,7
15454,2023-10-06 22:00:00,85,149,13,14,563,439,124,10
15455,2023-10-06 23:00:00,111,209,14,18,762,564,198,12
15456,2023-10-07 00:00:00,101,164,6,14,560,444,116,12
15457,2023-10-07 01:00:00,60,209,7,12,542,471,71,13
15458,2023-10-07 02:00:00,143,208,9,12,773,630,143,9
15459,2023-10-07 03:00:00,138,150,7,12,661,492,169,13
15460,2023-10-07 04:00:00,52,194,9,14,679,598,81,14
15461,2023-10-07 05:00:00,86,121,8,18,715,562,153,13
15462,2023-10-07 06:00:00,100,258,9,15,734,588,146,7
15463,2023-10-07 07:00:00,74,247,11,18,502,390,112,7
15464,2023-10-07 08:00:00,108,284,13,10,599,498,101,12
15465,2023-10-07 09:00:00,54,189,11,19,753,590,163,5
15466,2023-10-07 10:00:00,77,215,9,15,751,651,100,14
15467,2023-10-07 11:00:00,148,183,5,16,646,458,188,13
15468,2023-10-07 12:00:00,142,241,9,13,745,558,187,10
15469,2023-10-07 13:00:00,120,133,13,19,771,618,153,8
15470,2023-10-07 14:00:00,131,249,8,13,681,519,162,6
15471,2023-10-07 15:00:00,54,200,5,13,691,503,188,5
15472,2023-10-07 16:00:00,72,212,11,11,541,480,61,5
15473,2023-10-07 17:00:00,141,204,5,19,527,411,116,14
15474,2023-10-07 18:00:00,136,214,5,13,542,460,82,14
15475,2023-10-07 19:00:00,100,103,12,14,501,389,112,10
15476,2023-10-07 20:00:00,140,217,9,19,737,556,181,12
15477,2023-10-07 21:00:00,78,275,10,11,622,495,127,8
15478,2023-10-07 22:00:00,135,147,14,17,636,472,164,10
15479,2023-10-07 23:00:00,88,201,12,11,709,613,96,6
15480,2023-10-08 00:00:00,65,234,7,17,630,496,134,8
15481,2023-10-08 01:00:00,129,160,13,18,797,569,228,5
15482,2023-10-08 02:00:00,104,230,5,11,797,662,135,9
15483,2023-10-08 03:00:00,59,155,5,10,685,556,129,13
15484,2023-10-08 04:00:00,121,259,14,13,608,509,99,9
15485,2023-10-08 05:00:00,81,246,13,16,518,377,141,13
15486,2023-10-08 06:00:00,67,168,5,19,645,506,139,13
15487,2023-10-08 07:00:00,127,228,12,17,552,493,59,5
15488,2023-10-08 08:00:00,118,218,14,18,787,633,154,11
15489,2023-10-08 09:00:00,101,223,10,13,653,467,186,13
15490,2023-10-08 10:00:00,88,162,10,17,603,470,133,6
15491,2023-10-08 11:00:00,62,267,13,18,717,588,129,5
15492,2023-10-08 12:00:00,69,199,11,19,795,608,187,9
15493,2023-10-08 13:00:00,64,150,9,14,703,597,106,12
15494,2023-10-08 14:00:00,66,289,6,13,516,370,146,6
15495,2023-10-08 15:00:00,110,106,14,17,795,705,90,14
15496,2023-10-08 16:00:00,68,295,5,10,584,506,78,11
15497,2023-10-08 17:00:00,74,125,5,19,672,576,96,6
15498,2023-10-08 18:00:00,77,233,13,12,644,506,138,8
15499,2023-10-08 19:00:00,149,288,14,16,620,465,155,5
15500,2023-10-08 20:00:00,99,165,13,10,501,370,131,5
15501,2023-10-08 21:00:00,120,290,5,15,563,441,122,12
15502,2023-10-08 22:00:00,125,144,7,13,722,617,105,12
15503,2023-10-08 23:00:00,125,266,7,17,683,570,113,9
15504,2023-10-09 00:00:00,94,223,10,12,690,574,116,7
15505,2023-10-09 01:00:00,103,228,8,15,773,670,103,12
15506,2023-10-09 02:00:00,144,145,10,15,505,356,149,13
15507,2023-10-09 03:00:00,58,139,8,14,684,587,97,14
15508,2023-10-09 04:00:00,81,196,14,12,646,580,66,13
15509,2023-10-09 05:00:00,143,290,7,14,517,387,130,8
15510,2023-10-09 06:00:00,120,128,7,19,732,567,165,10
15511,2023-10-09 07:00:00,128,168,7,10,617,465,152,6
15512,2023-10-09 08:00:00,147,202,9,18,570,500,70,14
15513,2023-10-09 09:00:00,144,253,12,16,554,494,60,10
15514,2023-10-09 10:00:00,128,166,6,18,735,639,96,14
15515,2023-10-09 11:00:00,66,211,14,19,731,514,217,5
15516,2023-10-09 12:00:00,106,127,11,13,713,506,207,8
15517,2023-10-09 13:00:00,82,157,13,15,724,556,168,9
15518,2023-10-09 14:00:00,122,236,14,14,566,410,156,12
15519,2023-10-09 15:00:00,136,208,14,17,531,403,128,5
15520,2023-10-09 16:00:00,97,102,7,15,748,566,182,10
15521,2023-10-09 17:00:00,77,246,7,15,750,597,153,5
15522,2023-10-09 18:00:00,93,115,6,10,757,679,78,6
15523,2023-10-09 19:00:00,118,241,13,12,719,530,189,9
15524,2023-10-09 20:00:00,103,156,7,17,577,506,71,9
15525,2023-10-09 21:00:00,103,121,14,12,511,430,81,11
15526,2023-10-09 22:00:00,53,271,8,10,570,453,117,13
15527,2023-10-09 23:00:00,103,165,6,17,617,510,107,13
15528,2023-10-10 00:00:00,101,181,5,15,618,534,84,8
15529,2023-10-10 01:00:00,85,123,14,10,632,505,127,11
15530,2023-10-10 02:00:00,117,227,9,12,559,452,107,14
15531,2023-10-10 03:00:00,124,120,14,15,503,360,143,13
15532,2023-10-10 04:00:00,128,180,10,16,770,568,202,9
15533,2023-10-10 05:00:00,142,142,10,19,687,499,188,9
15534,2023-10-10 06:00:00,127,130,10,12,701,579,122,9
15535,2023-10-10 07:00:00,77,295,6,11,605,510,95,5
15536,2023-10-10 08:00:00,128,209,9,12,627,552,75,5
15537,2023-10-10 09:00:00,92,110,6,14,741,549,192,13
15538,2023-10-10 10:00:00,113,161,6,17,560,474,86,5
15539,2023-10-10 11:00:00,127,275,10,16,707,524,183,7
15540,2023-10-10 12:00:00,143,165,6,16,502,362,140,7
15541,2023-10-10 13:00:00,142,206,13,17,763,573,190,8
15542,2023-10-10 14:00:00,85,237,11,18,670,514,156,9
15543,2023-10-10 15:00:00,61,126,13,16,607,467,140,7
15544,2023-10-10 16:00:00,65,293,8,10,506,436,70,12
15545,2023-10-10 17:00:00,89,102,12,13,695,527,168,14
15546,2023-10-10 18:00:00,94,164,10,15,670,493,177,14
15547,2023-10-10 19:00:00,111,247,13,12,585,431,154,8
15548,2023-10-10 20:00:00,69,215,6,12,517,375,142,7
15549,2023-10-10 21:00:00,79,134,5,10,751,675,76,7
15550,2023-10-10 22:00:00,72,152,12,14,618,525,93,9
15551,2023-10-10 23:00:00,119,240,10,14,632,477,155,12
15552,2023-10-11 00:00:00,129,257,11,18,627,447,180,14
15553,2023-10-11 01:00:00,103,132,10,17,761,683,78,11
15554,2023-10-11 02:00:00,51,192,6,13,739,648,91,13
15555,2023-10-11 03:00:00,108,225,9,14,799,622,177,13
15556,2023-10-11 04:00:00,59,262,9,13,626,471,155,6
15557,2023-10-11 05:00:00,143,120,6,18,624,461,163,10
15558,2023-10-11 06:00:00,125,195,12,18,565,418,147,9
15559,2023-10-11 07:00:00,123,227,7,13,552,413,139,11
15560,2023-10-11 08:00:00,125,191,14,14,773,552,221,11
15561,2023-10-11 09:00:00,55,205,8,10,506,448,58,9
15562,2023-10-11 10:00:00,95,278,9,14,689,503,186,8
15563,2023-10-11 11:00:00,88,189,7,19,535,463,72,7
15564,2023-10-11 12:00:00,71,103,8,10,710,555,155,12
15565,2023-10-11 13:00:00,117,201,7,19,650,510,140,9
15566,2023-10-11 14:00:00,73,164,8,15,690,501,189,10
15567,2023-10-11 15:00:00,63,275,12,10,616,547,69,6
15568,2023-10-11 16:00:00,127,254,14,19,514,414,100,8
15569,2023-10-11 17:00:00,146,268,9,16,769,637,132,12
15570,2023-10-11 18:00:00,137,140,5,12,763,662,101,5
15571,2023-10-11 19:00:00,64,198,9,12,792,578,214,6
15572,2023-10-11 20:00:00,95,204,13,19,796,630,166,6
15573,2023-10-11 21:00:00,87,286,7,18,745,632,113,5
15574,2023-10-11 22:00:00,143,292,7,16,607,531,76,14
15575,2023-10-11 23:00:00,127,195,11,15,699,548,151,13
15576,2023-10-12 00:00:00,105,237,13,18,671,521,150,12
15577,2023-10-12 01:00:00,115,228,8,13,734,531,203,14
15578,2023-10-12 02:00:00,125,265,11,16,738,578,160,11
15579,2023-10-12 03:00:00,138,179,7,17,766,577,189,5
15580,2023-10-12 04:00:00,89,174,11,14,536,430,106,6
15581,2023-10-12 05:00:00,99,114,11,17,519,451,68,14
15582,2023-10-12 06:00:00,118,111,13,10,504,411,93,10
15583,2023-10-12 07:00:00,95,127,7,13,768,604,164,6
15584,2023-10-12 08:00:00,140,292,11,13,735,626,109,8
15585,2023-10-12 09:00:00,119,209,12,13,664,583,81,6
15586,2023-10-12 10:00:00,103,277,5,17,632,450,182,9
15587,2023-10-12 11:00:00,101,104,6,17,595,530,65,7
15588,2023-10-12 12:00:00,72,206,5,10,571,414,157,13
15589,2023-10-12 13:00:00,79,294,13,17,556,475,81,6
15590,2023-10-12 14:00:00,116,237,9,18,503,363,140,7
15591,2023-10-12 15:00:00,105,111,9,15,707,582,125,14
15592,2023-10-12 16:00:00,81,219,9,16,741,623,118,9
15593,2023-10-12 17:00:00,139,118,5,13,675,564,111,6
15594,2023-10-12 18:00:00,95,106,13,19,600,425,175,9
15595,2023-10-12 19:00:00,108,139,9,19,564,469,95,14
15596,2023-10-12 20:00:00,103,193,13,10,681,524,157,6
15597,2023-10-12 21:00:00,118,259,9,17,714,516,198,11
15598,2023-10-12 22:00:00,92,100,9,13,701,594,107,13
15599,2023-10-12 23:00:00,57,238,6,13,705,554,151,13
15600,2023-10-13 00:00:00,113,169,7,18,705,510,195,11
15601,2023-10-13 01:00:00,113,299,6,13,642,539,103,7
15602,2023-10-13 02:00:00,107,182,5,19,577,484,93,8
15603,2023-10-13 03:00:00,112,184,13,14,559,460,99,9
15604,2023-10-13 04:00:00,88,218,5,15,667,478,189,14
15605,2023-10-13 05:00:00,85,114,11,19,703,580,123,11
15606,2023-10-13 06:00:00,108,211,9,19,722,616,106,12
15607,2023-10-13 07:00:00,88,150,10,19,605,465,140,9
15608,2023-10-13 08:00:00,57,265,10,19,572,503,69,13
15609,2023-10-13 09:00:00,90,194,7,10,674,583,91,7
15610,2023-10-13 10:00:00,57,125,11,18,744,524,220,7
15611,2023-10-13 11:00:00,66,280,13,17,668,519,149,9
15612,2023-10-13 12:00:00,93,215,13,19,747,664,83,9
15613,2023-10-13 13:00:00,117,168,12,17,571,512,59,6
15614,2023-10-13 14:00:00,111,159,7,15,593,443,150,14
15615,2023-10-13 15:00:00,55,252,7,14,738,625,113,13
15616,2023-10-13 16:00:00,50,142,11,18,672,565,107,6
15617,2023-10-13 17:00:00,58,124,11,16,594,533,61,13
15618,2023-10-13 18:00:00,84,119,8,11,710,501,209,9
15619,2023-10-13 19:00:00,80,291,9,14,704,521,183,5
15620,2023-10-13 20:00:00,85,156,5,11,646,468,178,5
15621,2023-10-13 21:00:00,93,127,10,17,750,603,147,14
15622,2023-10-13 22:00:00,123,152,9,14,684,559,125,11
15623,2023-10-13 23:00:00,113,110,13,13,669,519,150,10
15624,2023-10-14 00:00:00,130,175,12,19,737,660,77,6
15625,2023-10-14 01:00:00,75,293,7,12,616,491,125,7
15626,2023-10-14 02:00:00,57,255,13,11,556,400,156,6
15627,2023-10-14 03:00:00,145,111,5,16,753,666,87,10
15628,2023-10-14 04:00:00,124,165,5,11,728,511,217,11
15629,2023-10-14 05:00:00,129,244,6,15,630,484,146,12
15630,2023-10-14 06:00:00,110,122,8,13,665,544,121,5
15631,2023-10-14 07:00:00,106,103,13,16,589,513,76,7
15632,2023-10-14 08:00:00,87,157,12,18,555,393,162,6
15633,2023-10-14 09:00:00,125,173,5,17,663,474,189,14
15634,2023-10-14 10:00:00,68,166,7,18,749,524,225,9
15635,2023-10-14 11:00:00,106,109,13,17,587,438,149,5
15636,2023-10-14 12:00:00,87,236,13,17,674,574,100,6
15637,2023-10-14 13:00:00,97,230,12,13,698,539,159,11
15638,2023-10-14 14:00:00,108,179,8,10,788,699,89,6
15639,2023-10-14 15:00:00,90,147,11,14,651,568,83,7
15640,2023-10-14 16:00:00,119,201,14,12,706,600,106,7
15641,2023-10-14 17:00:00,113,236,11,10,784,615,169,5
15642,2023-10-14 18:00:00,88,161,8,13,594,460,134,8
15643,2023-10-14 19:00:00,73,222,12,16,758,599,159,14
15644,2023-10-14 20:00:00,145,295,10,14,555,463,92,6
15645,2023-10-14 21:00:00,113,236,12,12,683,542,141,9
15646,2023-10-14 22:00:00,57,170,9,14,540,436,104,8
15647,2023-10-14 23:00:00,90,208,8,10,520,424,96,5
15648,2023-10-15 00:00:00,59,269,6,15,709,527,182,10
15649,2023-10-15 01:00:00,128,197,14,16,628,446,182,9
15650,2023-10-15 02:00:00,136,106,5,19,572,401,171,14
15651,2023-10-15 03:00:00,55,177,13,17,675,584,91,6
15652,2023-10-15 04:00:00,74,145,7,15,748,566,182,12
15653,2023-10-15 05:00:00,56,154,5,10,770,568,202,10
15654,2023-10-15 06:00:00,148,139,5,12,682,541,141,6
15655,2023-10-15 07:00:00,121,102,9,19,503,412,91,13
15656,2023-10-15 08:00:00,110,127,12,16,690,513,177,13
15657,2023-10-15 09:00:00,146,260,8,18,763,607,156,7
15658,2023-10-15 10:00:00,128,199,6,16,543,478,65,11
15659,2023-10-15 11:00:00,119,215,6,15,575,420,155,10
15660,2023-10-15 12:00:00,127,123,10,14,763,574,189,10
15661,2023-10-15 13:00:00,103,250,9,19,792,560,232,13
15662,2023-10-15 14:00:00,59,178,6,13,510,417,93,11
15663,2023-10-15 15:00:00,120,192,8,18,646,461,185,6
15664,2023-10-15 16:00:00,135,238,7,14,551,432,119,13
15665,2023-10-15 17:00:00,62,154,7,16,791,647,144,13
15666,2023-10-15 18:00:00,88,142,13,15,610,494,116,12
15667,2023-10-15 19:00:00,128,148,8,19,533,446,87,8
15668,2023-10-15 20:00:00,148,190,12,16,676,544,132,14
15669,2023-10-15 21:00:00,142,122,9,10,611,461,150,12
15670,2023-10-15 22:00:00,55,288,6,18,728,548,180,6
15671,2023-10-15 23:00:00,110,154,14,11,611,455,156,11
15672,2023-10-16 00:00:00,68,171,14,12,781,670,111,8
15673,2023-10-16 01:00:00,56,271,5,17,537,405,132,8
15674,2023-10-16 02:00:00,68,194,6,11,600,429,171,12
15675,2023-10-16 03:00:00,128,145,10,13,739,562,177,13
15676,2023-10-16 04:00:00,98,147,11,10,755,553,202,14
15677,2023-10-16 05:00:00,61,204,6,16,734,611,123,8
15678,2023-10-16 06:00:00,98,245,14,14,684,548,136,5
15679,2023-10-16 07:00:00,80,122,6,16,543,433,110,13
15680,2023-10-16 08:00:00,115,114,7,14,696,578,118,10
15681,2023-10-16 09:00:00,75,141,5,17,586,527,59,8
15682,2023-10-16 10:00:00,114,176,8,15,790,558,232,12
15683,2023-10-16 11:00:00,85,147,6,14,780,678,102,12
15684,2023-10-16 12:00:00,67,270,9,17,708,618,90,11
15685,2023-10-16 13:00:00,72,107,10,17,605,434,171,8
15686,2023-10-16 14:00:00,73,145,9,11,650,553,97,11
15687,2023-10-16 15:00:00,147,239,6,19,649,509,140,12
15688,2023-10-16 16:00:00,74,287,11,17,714,580,134,8
15689,2023-10-16 17:00:00,72,147,9,13,684,542,142,9
15690,2023-10-16 18:00:00,69,247,11,12,554,438,116,10
15691,2023-10-16 19:00:00,138,257,14,16,706,508,198,14
15692,2023-10-16 20:00:00,89,209,14,11,518,414,104,9
15693,2023-10-16 21:00:00,62,140,11,16,790,695,95,9
15694,2023-10-16 22:00:00,108,125,12,12,673,580,93,6
15695,2023-10-16 23:00:00,106,209,10,12,521,457,64,12
15696,2023-10-17 00:00:00,135,231,13,11,756,641,115,12
15697,2023-10-17 01:00:00,59,111,9,17,561,442,119,9
15698,2023-10-17 02:00:00,97,266,9,15,605,542,63,11
15699,2023-10-17 03:00:00,81,268,9,11,500,366,134,11
15700,2023-10-17 04:00:00,95,235,7,11,636,500,136,6
15701,2023-10-17 05:00:00,87,258,12,10,729,523,206,14
15702,2023-10-17 06:00:00,147,194,9,10,739,651,88,10
15703,2023-10-17 07:00:00,68,133,11,11,608,500,108,11
15704,2023-10-17 08:00:00,149,299,5,15,622,444,178,10
15705,2023-10-17 09:00:00,101,257,14,17,526,380,146,6
15706,2023-10-17 10:00:00,81,259,7,13,582,509,73,8
15707,2023-10-17 11:00:00,52,251,13,14,717,564,153,12
15708,2023-10-17 12:00:00,143,191,7,13,541,481,60,11
15709,2023-10-17 13:00:00,104,281,9,16,655,529,126,9
15710,2023-10-17 14:00:00,88,212,8,13,526,381,145,14
15711,2023-10-17 15:00:00,112,297,12,19,537,473,64,12
15712,2023-10-17 16:00:00,137,107,12,19,507,422,85,6
15713,2023-10-17 17:00:00,59,109,10,16,639,496,143,10
15714,2023-10-17 18:00:00,67,198,13,12,612,492,120,6
15715,2023-10-17 19:00:00,112,113,11,17,524,411,113,10
15716,2023-10-17 20:00:00,120,149,8,18,514,422,92,8
15717,2023-10-17 21:00:00,113,149,9,11,545,435,110,12
15718,2023-10-17 22:00:00,79,240,8,12,554,487,67,14
15719,2023-10-17 23:00:00,84,194,10,18,723,544,179,5
15720,2023-10-18 00:00:00,110,135,12,18,636,505,131,10
15721,2023-10-18 01:00:00,61,125,8,12,551,480,71,7
15722,2023-10-18 02:00:00,148,240,9,19,557,431,126,7
15723,2023-10-18 03:00:00,106,180,9,15,715,633,82,6
15724,2023-10-18 04:00:00,94,265,5,15,760,646,114,5
15725,2023-10-18 05:00:00,74,231,13,12,697,566,131,12
15726,2023-10-18 06:00:00,83,241,7,12,624,534,90,10
15727,2023-10-18 07:00:00,125,151,5,17,685,561,124,6
15728,2023-10-18 08:00:00,62,163,7,19,668,545,123,14
15729,2023-10-18 09:00:00,138,178,14,19,627,516,111,6
15730,2023-10-18 10:00:00,53,131,5,19,571,508,63,8
15731,2023-10-18 11:00:00,54,177,8,18,663,570,93,10
15732,2023-10-18 12:00:00,120,159,7,17,754,556,198,12
15733,2023-10-18 13:00:00,69,273,9,13,712,528,184,6
15734,2023-10-18 14:00:00,135,114,11,10,734,653,81,12
15735,2023-10-18 15:00:00,60,139,14,18,764,679,85,13
15736,2023-10-18 16:00:00,134,159,13,16,558,479,79,7
15737,2023-10-18 17:00:00,70,133,12,10,743,578,165,10
15738,2023-10-18 18:00:00,95,237,5,17,553,420,133,8
15739,2023-10-18 19:00:00,96,150,13,14,773,615,158,9
15740,2023-10-18 20:00:00,63,248,10,17,596,516,80,14
15741,2023-10-18 21:00:00,84,183,13,17,648,573,75,9
15742,2023-10-18 22:00:00,138,253,12,12,537,451,86,10
15743,2023-10-18 23:00:00,85,196,14,16,570,406,164,9
15744,2023-10-19 00:00:00,54,292,9,16,686,525,161,5
15745,2023-10-19 01:00:00,112,100,12,12,683,532,151,11
15746,2023-10-19 02:00:00,107,199,8,12,677,556,121,10
15747,2023-10-19 03:00:00,138,159,13,16,618,541,77,7
15748,2023-10-19 04:00:00,140,220,7,16,556,492,64,14
15749,2023-10-19 05:00:00,60,158,6,14,504,410,94,12
15750,2023-10-19 06:00:00,92,169,10,19,693,485,208,6
15751,2023-10-19 07:00:00,69,185,8,15,543,465,78,12
15752,2023-10-19 08:00:00,130,117,5,14,770,640,130,11
15753,2023-10-19 09:00:00,130,144,9,15,760,543,217,6
15754,2023-10-19 10:00:00,92,165,7,13,776,609,167,9
15755,2023-10-19 11:00:00,74,160,7,15,783,650,133,5
15756,2023-10-19 12:00:00,87,273,14,14,531,433,98,8
15757,2023-10-19 13:00:00,115,147,11,12,609,464,145,5
15758,2023-10-19 14:00:00,88,233,6,19,524,432,92,5
15759,2023-10-19 15:00:00,62,126,14,11,602,431,171,11
15760,2023-10-19 16:00:00,132,133,9,19,756,657,99,11
15761,2023-10-19 17:00:00,114,294,11,19,608,446,162,13
15762,2023-10-19 18:00:00,71,231,14,14,776,545,231,13
15763,2023-10-19 19:00:00,99,169,6,12,581,455,126,9
15764,2023-10-19 20:00:00,73,261,6,17,663,475,188,11
15765,2023-10-19 21:00:00,82,281,12,14,597,462,135,5
15766,2023-10-19 22:00:00,73,173,10,19,562,490,72,8
15767,2023-10-19 23:00:00,74,282,10,17,626,505,121,10
15768,2023-10-20 00:00:00,110,209,5,15,734,620,114,7
15769,2023-10-20 01:00:00,100,227,5,11,578,443,135,14
15770,2023-10-20 02:00:00,123,232,8,10,624,511,113,11
15771,2023-10-20 03:00:00,93,266,11,10,670,514,156,5
15772,2023-10-20 04:00:00,91,100,7,15,533,379,154,11
15773,2023-10-20 05:00:00,120,240,8,16,520,418,102,14
15774,2023-10-20 06:00:00,124,137,8,13,614,529,85,5
15775,2023-10-20 07:00:00,76,214,12,12,534,381,153,8
15776,2023-10-20 08:00:00,92,198,11,12,769,640,129,14
15777,2023-10-20 09:00:00,129,119,10,10,712,502,210,14
15778,2023-10-20 10:00:00,143,149,5,15,793,678,115,5
15779,2023-10-20 11:00:00,114,238,14,15,500,433,67,12
15780,2023-10-20 12:00:00,56,215,12,10,587,438,149,9
15781,2023-10-20 13:00:00,122,284,14,19,784,618,166,12
15782,2023-10-20 14:00:00,79,163,12,14,749,607,142,6
15783,2023-10-20 15:00:00,90,137,11,13,631,537,94,8
15784,2023-10-20 16:00:00,120,256,7,12,641,517,124,13
15785,2023-10-20 17:00:00,70,172,11,17,574,500,74,12
15786,2023-10-20 18:00:00,100,201,10,13,517,456,61,8
15787,2023-10-20 19:00:00,83,105,12,10,712,604,108,6
15788,2023-10-20 20:00:00,119,297,13,11,768,581,187,7
15789,2023-10-20 21:00:00,137,299,11,18,769,656,113,9
15790,2023-10-20 22:00:00,53,113,14,13,729,624,105,10
15791,2023-10-20 23:00:00,136,299,12,14,619,445,174,11
15792,2023-10-21 00:00:00,135,283,12,15,602,489,113,6
15793,2023-10-21 01:00:00,121,136,8,14,587,463,124,14
15794,2023-10-21 02:00:00,76,193,9,18,703,604,99,14
15795,2023-10-21 03:00:00,53,104,7,19,681,606,75,7
15796,2023-10-21 04:00:00,71,170,12,13,771,591,180,10
15797,2023-10-21 05:00:00,108,121,7,18,767,614,153,11
15798,2023-10-21 06:00:00,122,299,6,19,692,497,195,7
15799,2023-10-21 07:00:00,87,119,5,16,582,461,121,8
15800,2023-10-21 08:00:00,128,194,6,17,566,408,158,9
15801,2023-10-21 09:00:00,64,104,11,17,708,604,104,11
15802,2023-10-21 10:00:00,92,288,7,12,577,414,163,9
15803,2023-10-21 11:00:00,91,292,5,18,594,477,117,11
15804,2023-10-21 12:00:00,71,165,12,18,726,554,172,5
15805,2023-10-21 13:00:00,98,199,11,12,671,547,124,7
15806,2023-10-21 14:00:00,125,207,8,16,736,630,106,6
15807,2023-10-21 15:00:00,70,273,12,11,518,430,88,9
15808,2023-10-21 16:00:00,115,163,8,14,662,499,163,12
15809,2023-10-21 17:00:00,109,121,8,17,683,597,86,12
15810,2023-10-21 18:00:00,93,285,14,18,541,479,62,9
15811,2023-10-21 19:00:00,104,146,11,16,690,595,95,9
15812,2023-10-21 20:00:00,119,171,13,10,604,492,112,10
15813,2023-10-21 21:00:00,107,205,7,14,723,620,103,11
15814,2023-10-21 22:00:00,84,106,7,12,702,517,185,11
15815,2023-10-21 23:00:00,94,152,8,17,616,477,139,7
15816,2023-10-22 00:00:00,66,222,6,19,520,383,137,12
15817,2023-10-22 01:00:00,95,129,7,15,623,509,114,10
15818,2023-10-22 02:00:00,77,198,12,11,617,540,77,11
15819,2023-10-22 03:00:00,129,189,11,19,772,619,153,6
15820,2023-10-22 04:00:00,138,118,6,18,640,450,190,11
15821,2023-10-22 05:00:00,62,159,10,11,757,543,214,14
15822,2023-10-22 06:00:00,145,278,9,11,723,636,87,10
15823,2023-10-22 07:00:00,62,277,8,18,505,442,63,6
15824,2023-10-22 08:00:00,113,173,10,19,689,595,94,10
15825,2023-10-22 09:00:00,120,108,10,15,716,530,186,12
15826,2023-10-22 10:00:00,129,168,10,19,547,423,124,6
15827,2023-10-22 11:00:00,79,156,8,11,511,438,73,6
15828,2023-10-22 12:00:00,106,101,5,19,758,653,105,8
15829,2023-10-22 13:00:00,118,168,9,16,728,634,94,12
15830,2023-10-22 14:00:00,65,124,6,14,610,457,153,11
15831,2023-10-22 15:00:00,132,145,11,17,713,535,178,12
15832,2023-10-22 16:00:00,79,153,6,18,697,591,106,13
15833,2023-10-22 17:00:00,134,172,13,14,543,421,122,13
15834,2023-10-22 18:00:00,117,119,6,19,649,521,128,12
15835,2023-10-22 19:00:00,95,168,9,19,530,430,100,7
15836,2023-10-22 20:00:00,146,114,7,15,504,412,92,6
15837,2023-10-22 21:00:00,61,161,9,10,585,450,135,13
15838,2023-10-22 22:00:00,113,196,9,11,798,679,119,14
15839,2023-10-22 23:00:00,64,249,7,15,608,536,72,5
15840,2023-10-23 00:00:00,138,191,5,16,627,535,92,13
15841,2023-10-23 01:00:00,92,282,6,16,700,545,155,9
15842,2023-10-23 02:00:00,145,206,10,18,536,451,85,14
15843,2023-10-23 03:00:00,120,176,14,10,643,482,161,13
15844,2023-10-23 04:00:00,92,247,12,14,755,655,100,13
15845,2023-10-23 05:00:00,119,295,12,11,556,396,160,7
15846,2023-10-23 06:00:00,105,149,12,12,760,682,78,7
15847,2023-10-23 07:00:00,101,133,6,14,722,526,196,8
15848,2023-10-23 08:00:00,129,103,8,16,753,671,82,13
15849,2023-10-23 09:00:00,62,256,5,16,573,434,139,6
15850,2023-10-23 10:00:00,102,263,12,18,720,599,121,14
15851,2023-10-23 11:00:00,81,155,7,10,638,473,165,6
15852,2023-10-23 12:00:00,100,192,5,10,799,689,110,5
15853,2023-10-23 13:00:00,103,230,6,19,693,517,176,7
15854,2023-10-23 14:00:00,63,252,13,13,570,456,114,5
15855,2023-10-23 15:00:00,59,262,11,11,600,422,178,9
15856,2023-10-23 16:00:00,149,119,13,17,623,491,132,5
15857,2023-10-23 17:00:00,127,280,14,15,615,494,121,14
15858,2023-10-23 18:00:00,106,265,5,19,641,511,130,5
15859,2023-10-23 19:00:00,63,208,5,14,566,398,168,13
15860,2023-10-23 20:00:00,139,295,7,11,506,436,70,12
15861,2023-10-23 21:00:00,60,237,8,18,571,459,112,14
15862,2023-10-23 22:00:00,62,158,8,11,632,489,143,8
15863,2023-10-23 23:00:00,133,121,6,14,787,658,129,6
15864,2023-10-24 00:00:00,76,129,8,17,753,583,170,10
15865,2023-10-24 01:00:00,81,105,6,18,634,524,110,9
15866,2023-10-24 02:00:00,123,123,9,14,638,486,152,9
15867,2023-10-24 03:00:00,127,204,5,13,587,466,121,14
15868,2023-10-24 04:00:00,142,177,13,18,758,553,205,11
15869,2023-10-24 05:00:00,88,230,13,13,772,569,203,9
15870,2023-10-24 06:00:00,134,285,11,19,782,674,108,6
15871,2023-10-24 07:00:00,148,241,8,12,565,466,99,13
15872,2023-10-24 08:00:00,142,198,12,15,590,509,81,9
15873,2023-10-24 09:00:00,79,257,8,18,589,450,139,9
15874,2023-10-24 10:00:00,99,240,9,16,611,530,81,10
15875,2023-10-24 11:00:00,134,170,12,18,529,441,88,8
15876,2023-10-24 12:00:00,62,173,12,13,751,598,153,7
15877,2023-10-24 13:00:00,118,105,6,16,608,462,146,10
15878,2023-10-24 14:00:00,76,231,5,10,592,515,77,9
15879,2023-10-24 15:00:00,129,199,12,12,717,597,120,5
15880,2023-10-24 16:00:00,95,236,12,15,636,532,104,10
15881,2023-10-24 17:00:00,134,259,14,11,508,435,73,12
15882,2023-10-24 18:00:00,108,231,11,16,717,551,166,8
15883,2023-10-24 19:00:00,138,140,13,18,571,437,134,7
15884,2023-10-24 20:00:00,109,222,13,14,598,488,110,12
15885,2023-10-24 21:00:00,124,234,6,14,509,399,110,6
15886,2023-10-24 22:00:00,88,296,6,10,679,588,91,9
15887,2023-10-24 23:00:00,68,165,13,14,578,449,129,11
15888,2023-10-25 00:00:00,66,288,8,14,549,492,57,8
15889,2023-10-25 01:00:00,109,123,5,13,646,569,77,5
15890,2023-10-25 02:00:00,104,141,10,18,533,380,153,13
15891,2023-10-25 03:00:00,122,136,5,16,587,467,120,11
15892,2023-10-25 04:00:00,84,200,7,11,746,671,75,14
15893,2023-10-25 05:00:00,91,289,10,10,512,453,59,8
15894,2023-10-25 06:00:00,87,199,12,18,555,433,122,9
15895,2023-10-25 07:00:00,57,266,8,17,652,486,166,14
15896,2023-10-25 08:00:00,54,235,14,14,726,643,83,7
15897,2023-10-25 09:00:00,51,161,8,18,642,485,157,5
15898,2023-10-25 10:00:00,116,204,5,10,606,433,173,10
15899,2023-10-25 11:00:00,56,252,7,12,580,502,78,5
15900,2023-10-25 12:00:00,61,284,12,17,553,474,79,14
15901,2023-10-25 13:00:00,85,119,11,14,506,379,127,7
15902,2023-10-25 14:00:00,91,120,6,17,731,556,175,11
15903,2023-10-25 15:00:00,145,225,13,17,777,656,121,13
15904,2023-10-25 16:00:00,73,135,7,12,550,479,71,7
15905,2023-10-25 17:00:00,61,170,11,11,692,551,141,11
15906,2023-10-25 18:00:00,89,225,10,14,646,478,168,14
15907,2023-10-25 19:00:00,127,126,14,13,646,540,106,6
15908,2023-10-25 20:00:00,128,195,8,17,691,569,122,5
15909,2023-10-25 21:00:00,102,223,11,13,771,630,141,8
15910,2023-10-25 22:00:00,121,208,7,10,515,384,131,5
15911,2023-10-25 23:00:00,109,220,10,19,689,583,106,13
15912,2023-10-26 00:00:00,80,248,7,19,683,558,125,12
15913,2023-10-26 01:00:00,102,203,11,11,634,542,92,8
15914,2023-10-26 02:00:00,133,112,5,14,674,588,86,13
15915,2023-10-26 03:00:00,99,293,11,14,611,530,81,11
15916,2023-10-26 04:00:00,72,186,11,17,721,623,98,5
15917,2023-10-26 05:00:00,59,239,7,12,700,542,158,5
15918,2023-10-26 06:00:00,140,104,13,13,514,424,90,7
15919,2023-10-26 07:00:00,58,199,14,14,536,376,160,10
15920,2023-10-26 08:00:00,149,128,6,12,651,490,161,7
15921,2023-10-26 09:00:00,69,177,6,16,682,600,82,7
15922,2023-10-26 10:00:00,95,108,9,16,693,580,113,5
15923,2023-10-26 11:00:00,146,244,12,19,577,418,159,9
15924,2023-10-26 12:00:00,117,131,12,10,574,412,162,14
15925,2023-10-26 13:00:00,120,177,10,19,528,412,116,5
15926,2023-10-26 14:00:00,114,150,9,11,660,513,147,12
15927,2023-10-26 15:00:00,142,202,9,17,719,511,208,12
15928,2023-10-26 16:00:00,146,288,10,11,724,530,194,7
15929,2023-10-26 17:00:00,147,280,8,18,672,578,94,5
15930,2023-10-26 18:00:00,117,292,8,13,776,661,115,14
15931,2023-10-26 19:00:00,59,126,10,11,712,579,133,12
15932,2023-10-26 20:00:00,58,182,11,14,554,401,153,13
15933,2023-10-26 21:00:00,143,245,13,13,772,625,147,6
15934,2023-10-26 22:00:00,104,292,13,10,641,556,85,14
15935,2023-10-26 23:00:00,100,241,5,13,644,556,88,7
15936,2023-10-27 00:00:00,137,242,10,12,723,510,213,7
15937,2023-10-27 01:00:00,121,179,6,11,787,594,193,12
15938,2023-10-27 02:00:00,113,150,5,16,582,501,81,8
15939,2023-10-27 03:00:00,109,145,14,15,610,510,100,13
15940,2023-10-27 04:00:00,94,212,12,15,694,515,179,9
15941,2023-10-27 05:00:00,101,123,13,18,644,534,110,10
15942,2023-10-27 06:00:00,69,299,7,18,759,539,220,9
15943,2023-10-27 07:00:00,51,209,12,13,658,561,97,13
15944,2023-10-27 08:00:00,79,127,8,19,691,554,137,5
15945,2023-10-27 09:00:00,73,104,14,16,565,437,128,9
15946,2023-10-27 10:00:00,107,145,10,14,575,455,120,12
15947,2023-10-27 11:00:00,90,294,11,14,603,479,124,11
15948,2023-10-27 12:00:00,108,126,9,13,590,463,127,8
15949,2023-10-27 13:00:00,96,233,10,13,698,504,194,6
15950,2023-10-27 14:00:00,87,174,6,12,542,385,157,9
15951,2023-10-27 15:00:00,123,123,12,13,791,696,95,5
15952,2023-10-27 16:00:00,97,112,6,18,709,575,134,5
15953,2023-10-27 17:00:00,144,259,7,15,569,413,156,14
15954,2023-10-27 18:00:00,111,106,11,15,630,493,137,6
15955,2023-10-27 19:00:00,76,141,12,18,542,406,136,12
15956,2023-10-27 20:00:00,117,257,9,18,570,486,84,12
15957,2023-10-27 21:00:00,132,278,10,14,687,529,158,13
15958,2023-10-27 22:00:00,147,123,11,18,681,579,102,10
15959,2023-10-27 23:00:00,51,271,8,15,561,459,102,12
15960,2023-10-28 00:00:00,75,242,9,10,650,532,118,5
15961,2023-10-28 01:00:00,83,245,10,13,610,450,160,7
15962,2023-10-28 02:00:00,141,191,14,14,563,463,100,11
15963,2023-10-28 03:00:00,148,288,7,18,699,571,128,12
15964,2023-10-28 04:00:00,115,164,5,13,634,515,119,10
15965,2023-10-28 05:00:00,114,247,12,16,775,619,156,12
15966,2023-10-28 06:00:00,60,159,9,18,583,470,113,13
15967,2023-10-28 07:00:00,106,137,6,15,798,585,213,12
15968,2023-10-28 08:00:00,68,128,8,15,735,540,195,11
15969,2023-10-28 09:00:00,107,188,7,19,683,600,83,14
15970,2023-10-28 10:00:00,69,236,10,15,602,478,124,14
15971,2023-10-28 11:00:00,73,205,7,17,632,514,118,12
15972,2023-10-28 12:00:00,123,253,14,13,506,414,92,11
15973,2023-10-28 13:00:00,103,166,5,19,552,431,121,12
15974,2023-10-28 14:00:00,105,228,12,19,571,409,162,14
15975,2023-10-28 15:00:00,106,144,9,13,572,463,109,8
15976,2023-10-28 16:00:00,149,153,8,12,756,552,204,10
15977,2023-10-28 17:00:00,135,103,10,14,759,615,144,6
15978,2023-10-28 18:00:00,59,263,8,16,644,469,175,9
15979,2023-10-28 19:00:00,108,151,10,11,523,380,143,14
15980,2023-10-28 20:00:00,107,286,13,18,537,415,122,6
15981,2023-10-28 21:00:00,146,195,6,14,576,487,89,13
15982,2023-10-28 22:00:00,129,111,6,11,610,506,104,7
15983,2023-10-28 23:00:00,106,103,11,18,683,565,118,11
15984,2023-10-29 00:00:00,96,200,12,19,666,522,144,11
15985,2023-10-29 01:00:00,58,172,10,19,596,439,157,11
15986,2023-10-29 02:00:00,89,299,8,15,606,535,71,11
15987,2023-10-29 03:00:00,125,108,13,12,555,461,94,12
15988,2023-10-29 04:00:00,137,297,9,15,517,422,95,9
15989,2023-10-29 05:00:00,112,289,7,12,529,471,58,7
15990,2023-10-29 06:00:00,66,217,13,14,798,683,115,6
15991,2023-10-29 07:00:00,89,287,5,14,663,524,139,6
15992,2023-10-29 08:00:00,111,141,12,14,501,424,77,7
15993,2023-10-29 09:00:00,133,184,11,15,737,591,146,5
15994,2023-10-29 10:00:00,51,212,6,12,514,402,112,14
15995,2023-10-29 11:00:00,102,118,12,14,731,541,190,9
15996,2023-10-29 12:00:00,113,125,10,15,799,669,130,7
15997,2023-10-29 13:00:00,73,152,14,19,681,488,193,5
15998,2023-10-29 14:00:00,101,168,14,11,524,444,80,14
15999,2023-10-29 15:00:00,138,164,11,15,752,581,171,8
16000,2023-10-29 16:00:00,123,257,6,11,670,484,186,10
16001,2023-10-29 17:00:00,54,148,13,17,753,640,113,11
16002,2023-10-29 18:00:00,113,179,8,11,583,451,132,12
16003,2023-10-29 19:00:00,137,294,14,17,652,459,193,9
16004,2023-10-29 20:00:00,119,138,13,16,749,640,109,11
16005,2023-10-29 21:00:00,93,211,5,14,760,573,187,13
16006,2023-10-29 22:00:00,119,149,7,16,576,472,104,10
16007,2023-10-29 23:00:00,145,249,6,17,633,457,176,8
16008,2023-10-30 00:00:00,138,204,5,12,795,709,86,10
16009,2023-10-30 01:00:00,69,100,12,13,596,463,133,11
16010,2023-10-30 02:00:00,123,289,14,15,522,398,124,14
16011,2023-10-30 03:00:00,105,188,11,11,758,585,173,7
16012,2023-10-30 04:00:00,54,126,9,18,560,411,149,8
16013,2023-10-30 05:00:00,116,227,10,17,763,598,165,10
16014,2023-10-30 06:00:00,105,234,11,15,723,599,124,7
16015,2023-10-30 07:00:00,118,292,13,17,612,528,84,7
16016,2023-10-30 08:00:00,66,200,10,16,658,541,117,11
16017,2023-10-30 09:00:00,50,204,9,10,692,546,146,14
16018,2023-10-30 10:00:00,112,157,13,14,775,551,224,10
16019,2023-10-30 11:00:00,131,201,14,13,523,394,129,14
16020,2023-10-30 12:00:00,93,235,7,16,540,380,160,14
16021,2023-10-30 13:00:00,99,199,11,16,576,504,72,7
16022,2023-10-30 14:00:00,80,213,13,18,648,522,126,6
16023,2023-10-30 15:00:00,90,258,5,16,505,391,114,10
16024,2023-10-30 16:00:00,109,282,12,16,626,512,114,8
16025,2023-10-30 17:00:00,111,239,9,12,766,674,92,5
16026,2023-10-30 18:00:00,124,233,11,16,685,540,145,6
16027,2023-10-30 19:00:00,66,170,10,14,790,649,141,9
16028,2023-10-30 20:00:00,122,151,12,19,706,501,205,10
16029,2023-10-30 21:00:00,96,220,7,18,565,436,129,14
16030,2023-10-30 22:00:00,79,187,12,18,741,540,201,14
16031,2023-10-30 23:00:00,116,161,13,11,771,540,231,7
16032,2023-10-31 00:00:00,57,217,11,11,667,496,171,12
16033,2023-10-31 01:00:00,82,160,7,18,656,540,116,9
16034,2023-10-31 02:00:00,52,155,6,14,649,490,159,8
16035,2023-10-31 03:00:00,68,241,7,14,725,649,76,8
16036,2023-10-31 04:00:00,145,163,13,15,723,542,181,11
16037,2023-10-31 05:00:00,64,221,5,13,666,593,73,10
16038,2023-10-31 06:00:00,51,203,6,11,579,446,133,9
16039,2023-10-31 07:00:00,84,119,8,16,757,600,157,8
16040,2023-10-31 08:00:00,131,163,6,18,604,454,150,11
16041,2023-10-31 09:00:00,138,281,8,12,626,538,88,9
16042,2023-10-31 10:00:00,132,193,5,10,623,457,166,14
16043,2023-10-31 11:00:00,142,127,9,11,712,518,194,5
16044,2023-10-31 12:00:00,65,186,14,19,663,539,124,10
16045,2023-10-31 13:00:00,72,152,7,14,671,567,104,6
16046,2023-10-31 14:00:00,123,171,13,13,610,513,97,5
16047,2023-10-31 15:00:00,63,200,12,11,641,480,161,9
16048,2023-10-31 16:00:00,111,209,5,19,611,539,72,12
16049,2023-10-31 17:00:00,85,225,7,13,526,448,78,7
16050,2023-10-31 18:00:00,139,240,6,10,659,542,117,9
16051,2023-10-31 19:00:00,110,243,5,19,636,479,157,12
16052,2023-10-31 20:00:00,116,155,7,18,749,533,216,8
16053,2023-10-31 21:00:00,85,268,10,18,539,379,160,13
16054,2023-10-31 22:00:00,138,116,6,19,738,525,213,14
16055,2023-10-31 23:00:00,99,249,6,15,769,669,100,9
16056,2023-11-01 00:00:00,129,230,7,18,580,429,151,8
16057,2023-11-01 01:00:00,78,284,11,11,787,577,210,5
16058,2023-11-01 02:00:00,54,108,10,16,629,472,157,11
16059,2023-11-01 03:00:00,124,221,7,14,538,401,137,8
16060,2023-11-01 04:00:00,66,110,6,11,543,414,129,12
16061,2023-11-01 05:00:00,89,233,7,12,578,450,128,9
16062,2023-11-01 06:00:00,75,287,12,17,581,475,106,9
16063,2023-11-01 07:00:00,148,235,11,18,567,428,139,7
16064,2023-11-01 08:00:00,126,103,10,15,561,449,112,11
16065,2023-11-01 09:00:00,58,139,12,13,666,471,195,9
16066,2023-11-01 10:00:00,98,218,13,16,643,533,110,10
16067,2023-11-01 11:00:00,95,100,14,12,661,544,117,8
16068,2023-11-01 12:00:00,64,166,14,12,654,492,162,9
16069,2023-11-01 13:00:00,110,287,12,18,771,665,106,7
16070,2023-11-01 14:00:00,64,223,12,12,505,385,120,12
16071,2023-11-01 15:00:00,113,139,13,13,551,456,95,10
16072,2023-11-01 16:00:00,116,271,6,13,706,574,132,12
16073,2023-11-01 17:00:00,122,292,11,17,522,434,88,5
16074,2023-11-01 18:00:00,124,290,13,13,539,381,158,13
16075,2023-11-01 19:00:00,125,208,11,10,605,528,77,9
16076,2023-11-01 20:00:00,101,299,13,17,764,555,209,14
16077,2023-11-01 21:00:00,67,294,8,17,754,595,159,11
16078,2023-11-01 22:00:00,66,221,10,14,720,580,140,6
16079,2023-11-01 23:00:00,149,145,8,13,796,624,172,9
16080,2023-11-02 00:00:00,74,259,7,19,520,467,53,6
16081,2023-11-02 01:00:00,134,277,7,19,770,587,183,11
16082,2023-11-02 02:00:00,71,138,12,17,736,596,140,11
16083,2023-11-02 03:00:00,148,101,7,10,655,583,72,8
16084,2023-11-02 04:00:00,94,239,10,11,518,418,100,10
16085,2023-11-02 05:00:00,113,117,9,13,742,651,91,7
16086,2023-11-02 06:00:00,120,207,7,19,627,541,86,10
16087,2023-11-02 07:00:00,86,291,13,19,688,553,135,6
16088,2023-11-02 08:00:00,118,198,10,18,535,377,158,13
16089,2023-11-02 09:00:00,134,184,7,15,789,657,132,12
16090,2023-11-02 10:00:00,136,173,6,17,728,599,129,7
16091,2023-11-02 11:00:00,102,119,14,13,622,492,130,10
16092,2023-11-02 12:00:00,101,121,11,17,553,459,94,10
16093,2023-11-02 13:00:00,141,239,14,16,636,526,110,8
16094,2023-11-02 14:00:00,97,140,9,18,754,547,207,10
16095,2023-11-02 15:00:00,56,173,5,17,774,661,113,6
16096,2023-11-02 16:00:00,80,271,6,16,595,497,98,9
16097,2023-11-02 17:00:00,94,115,12,17,715,621,94,11
16098,2023-11-02 18:00:00,51,156,9,15,788,607,181,6
16099,2023-11-02 19:00:00,95,115,14,18,530,377,153,14
16100,2023-11-02 20:00:00,90,241,12,18,630,503,127,9
16101,2023-11-02 21:00:00,113,271,6,17,710,621,89,11
16102,2023-11-02 22:00:00,110,147,12,17,644,454,190,7
16103,2023-11-02 23:00:00,65,168,13,12,621,475,146,5
16104,2023-11-03 00:00:00,146,213,9,14,699,579,120,7
16105,2023-11-03 01:00:00,97,112,14,14,643,539,104,6
16106,2023-11-03 02:00:00,73,248,7,18,725,525,200,5
16107,2023-11-03 03:00:00,96,142,5,14,674,545,129,12
16108,2023-11-03 04:00:00,108,183,5,17,764,607,157,13
16109,2023-11-03 05:00:00,117,222,9,14,515,406,109,6
16110,2023-11-03 06:00:00,69,175,7,11,582,421,161,11
16111,2023-11-03 07:00:00,85,299,5,19,510,415,95,13
16112,2023-11-03 08:00:00,118,241,11,18,516,400,116,13
16113,2023-11-03 09:00:00,109,281,6,11,765,563,202,11
16114,2023-11-03 10:00:00,52,218,5,14,782,622,160,8
16115,2023-11-03 11:00:00,76,208,8,19,596,525,71,14
16116,2023-11-03 12:00:00,145,179,11,15,728,549,179,8
16117,2023-11-03 13:00:00,86,248,10,13,708,636,72,5
16118,2023-11-03 14:00:00,70,210,8,19,645,501,144,5
16119,2023-11-03 15:00:00,147,246,14,18,501,382,119,6
16120,2023-11-03 16:00:00,97,295,9,16,575,462,113,5
16121,2023-11-03 17:00:00,91,296,14,19,672,587,85,10
16122,2023-11-03 18:00:00,138,234,12,11,791,638,153,7
16123,2023-11-03 19:00:00,91,278,13,14,522,419,103,11
16124,2023-11-03 20:00:00,123,275,8,15,648,471,177,13
16125,2023-11-03 21:00:00,106,130,13,13,633,461,172,8
16126,2023-11-03 22:00:00,131,114,14,12,690,533,157,5
16127,2023-11-03 23:00:00,50,166,9,14,614,443,171,5
16128,2023-11-04 00:00:00,116,246,5,19,656,512,144,11
16129,2023-11-04 01:00:00,100,133,7,13,752,546,206,7
16130,2023-11-04 02:00:00,148,146,11,19,707,627,80,8
16131,2023-11-04 03:00:00,101,252,12,15,601,431,170,8
16132,2023-11-04 04:00:00,72,105,5,14,515,392,123,14
16133,2023-11-04 05:00:00,94,225,14,19,720,566,154,11
16134,2023-11-04 06:00:00,112,226,10,10,610,449,161,7
16135,2023-11-04 07:00:00,118,259,13,12,590,501,89,11
16136,2023-11-04 08:00:00,76,231,5,18,789,624,165,10
16137,2023-11-04 09:00:00,149,222,9,13,744,590,154,9
16138,2023-11-04 10:00:00,87,250,8,13,566,502,64,9
16139,2023-11-04 11:00:00,124,146,9,11,555,414,141,7
16140,2023-11-04 12:00:00,140,177,11,18,796,649,147,11
16141,2023-11-04 13:00:00,109,170,7,18,684,516,168,7
16142,2023-11-04 14:00:00,143,198,10,10,751,539,212,7
16143,2023-11-04 15:00:00,134,227,5,15,662,505,157,10
16144,2023-11-04 16:00:00,58,292,7,11,727,598,129,10
16145,2023-11-04 17:00:00,65,142,14,17,681,608,73,8
16146,2023-11-04 18:00:00,96,232,10,12,697,515,182,8
16147,2023-11-04 19:00:00,59,281,11,11,707,556,151,13
16148,2023-11-04 20:00:00,148,159,10,16,501,363,138,12
16149,2023-11-04 21:00:00,127,113,5,12,536,418,118,11
16150,2023-11-04 22:00:00,104,277,10,12,730,512,218,12
16151,2023-11-04 23:00:00,63,268,11,16,614,454,160,11
16152,2023-11-05 00:00:00,115,108,7,16,768,623,145,7
16153,2023-11-05 01:00:00,70,186,7,19,546,455,91,8
16154,2023-11-05 02:00:00,54,217,12,10,579,456,123,6
16155,2023-11-05 03:00:00,145,141,9,17,583,426,157,7
16156,2023-11-05 04:00:00,70,175,5,16,502,393,109,10
16157,2023-11-05 05:00:00,103,255,14,16,575,491,84,14
16158,2023-11-05 06:00:00,73,285,14,12,716,527,189,6
16159,2023-11-05 07:00:00,58,105,11,18,786,646,140,10
16160,2023-11-05 08:00:00,144,233,6,13,565,453,112,5
16161,2023-11-05 09:00:00,147,153,9,16,635,535,100,13
16162,2023-11-05 10:00:00,132,197,11,19,501,426,75,9
16163,2023-11-05 11:00:00,56,123,14,14,711,533,178,8
16164,2023-11-05 12:00:00,104,166,7,16,531,375,156,12
16165,2023-11-05 13:00:00,138,176,10,16,628,500,128,14
16166,2023-11-05 14:00:00,95,219,8,15,572,460,112,12
16167,2023-11-05 15:00:00,131,108,9,13,710,614,96,13
16168,2023-11-05 16:00:00,130,178,13,14,554,401,153,8
16169,2023-11-05 17:00:00,78,128,13,19,739,592,147,14
16170,2023-11-05 18:00:00,120,267,11,11,691,550,141,14
16171,2023-11-05 19:00:00,50,112,8,17,524,470,54,9
16172,2023-11-05 20:00:00,58,232,7,10,644,480,164,8
16173,2023-11-05 21:00:00,85,111,13,19,605,525,80,13
16174,2023-11-05 22:00:00,133,239,13,18,505,353,152,10
16175,2023-11-05 23:00:00,129,184,13,14,604,463,141,13
16176,2023-11-06 00:00:00,87,212,12,12,786,566,220,12
16177,2023-11-06 01:00:00,108,203,9,17,594,466,128,13
16178,2023-11-06 02:00:00,82,139,14,15,652,537,115,5
16179,2023-11-06 03:00:00,148,248,13,15,526,369,157,6
16180,2023-11-06 04:00:00,86,256,10,10,749,584,165,14
16181,2023-11-06 05:00:00,80,139,13,14,627,447,180,11
16182,2023-11-06 06:00:00,142,253,6,11,740,618,122,12
16183,2023-11-06 07:00:00,106,112,5,11,619,550,69,6
16184,2023-11-06 08:00:00,127,216,5,11,766,551,215,8
16185,2023-11-06 09:00:00,113,228,7,13,769,646,123,13
16186,2023-11-06 10:00:00,53,220,8,16,665,517,148,12
16187,2023-11-06 11:00:00,114,169,10,15,683,522,161,9
16188,2023-11-06 12:00:00,105,247,10,13,638,474,164,12
16189,2023-11-06 13:00:00,52,255,13,16,619,437,182,9
16190,2023-11-06 14:00:00,132,297,10,14,731,583,148,14
16191,2023-11-06 15:00:00,71,220,13,11,752,651,101,5
16192,2023-11-06 16:00:00,126,182,12,12,594,483,111,7
16193,2023-11-06 17:00:00,141,267,5,15,785,586,199,11
16194,2023-11-06 18:00:00,127,280,10,16,681,481,200,9
16195,2023-11-06 19:00:00,125,191,12,13,745,534,211,8
16196,2023-11-06 20:00:00,60,199,7,10,540,475,65,7
16197,2023-11-06 21:00:00,87,149,5,19,707,605,102,9
16198,2023-11-06 22:00:00,85,264,6,14,526,413,113,8
16199,2023-11-06 23:00:00,78,112,10,17,569,493,76,5
16200,2023-11-07 00:00:00,74,227,6,11,602,512,90,11
16201,2023-11-07 01:00:00,72,162,9,19,651,522,129,12
16202,2023-11-07 02:00:00,60,288,6,14,619,507,112,10
16203,2023-11-07 03:00:00,86,270,8,11,517,384,133,12
16204,2023-11-07 04:00:00,75,153,14,12,567,444,123,9
16205,2023-11-07 05:00:00,59,290,14,11,678,592,86,5
16206,2023-11-07 06:00:00,142,240,11,10,713,599,114,5
16207,2023-11-07 07:00:00,98,294,10,16,681,602,79,8
16208,2023-11-07 08:00:00,57,140,6,16,786,569,217,13
16209,2023-11-07 09:00:00,54,288,12,12,589,415,174,10
16210,2023-11-07 10:00:00,85,299,10,17,577,504,73,11
16211,2023-11-07 11:00:00,104,188,13,16,770,641,129,7
16212,2023-11-07 12:00:00,149,211,7,11,617,449,168,6
16213,2023-11-07 13:00:00,125,112,13,10,659,517,142,6
16214,2023-11-07 14:00:00,77,271,10,13,548,403,145,13
16215,2023-11-07 15:00:00,101,245,7,15,590,510,80,5
16216,2023-11-07 16:00:00,103,141,7,16,674,529,145,9
16217,2023-11-07 17:00:00,133,279,8,17,576,515,61,13
16218,2023-11-07 18:00:00,71,142,8,19,542,380,162,11
16219,2023-11-07 19:00:00,121,228,14,19,515,378,137,13
16220,2023-11-07 20:00:00,70,248,8,10,774,570,204,7
16221,2023-11-07 21:00:00,145,293,5,18,580,437,143,6
16222,2023-11-07 22:00:00,69,110,13,17,533,419,114,7
16223,2023-11-07 23:00:00,95,195,9,13,793,665,128,11
16224,2023-11-08 00:00:00,111,193,11,13,777,568,209,7
16225,2023-11-08 01:00:00,51,186,5,12,603,438,165,10
16226,2023-11-08 02:00:00,72,109,8,19,616,515,101,10
16227,2023-11-08 03:00:00,74,180,14,16,787,644,143,7
16228,2023-11-08 04:00:00,122,173,13,16,655,560,95,8
16229,2023-11-08 05:00:00,72,149,10,11,574,480,94,10
16230,2023-11-08 06:00:00,58,263,11,12,737,631,106,10
16231,2023-11-08 07:00:00,109,247,13,10,636,475,161,7
16232,2023-11-08 08:00:00,85,194,12,10,705,626,79,9
16233,2023-11-08 09:00:00,65,122,12,14,751,526,225,5
16234,2023-11-08 10:00:00,138,270,9,17,798,657,141,6
16235,2023-11-08 11:00:00,106,135,14,16,702,619,83,11
16236,2023-11-08 12:00:00,129,177,7,19,769,558,211,7
16237,2023-11-08 13:00:00,140,262,6,18,696,602,94,14
16238,2023-11-08 14:00:00,53,164,5,18,563,448,115,13
16239,2023-11-08 15:00:00,110,105,5,14,694,540,154,12
16240,2023-11-08 16:00:00,99,162,10,10,529,444,85,11
16241,2023-11-08 17:00:00,54,215,10,13,515,440,75,8
16242,2023-11-08 18:00:00,83,103,12,19,711,590,121,12
16243,2023-11-08 19:00:00,141,161,12,16,672,510,162,12
16244,2023-11-08 20:00:00,85,287,5,18,544,428,116,12
16245,2023-11-08 21:00:00,127,273,8,19,506,449,57,13
16246,2023-11-08 22:00:00,132,249,12,11,792,633,159,7
16247,2023-11-08 23:00:00,114,138,8,11,508,399,109,8
16248,2023-11-09 00:00:00,109,168,14,18,519,418,101,10
16249,2023-11-09 01:00:00,92,281,12,17,669,583,86,13
16250,2023-11-09 02:00:00,128,265,6,13,500,390,110,14
16251,2023-11-09 03:00:00,100,250,7,19,587,424,163,5
16252,2023-11-09 04:00:00,70,197,7,14,639,476,163,8
16253,2023-11-09 05:00:00,93,263,12,10,529,423,106,8
16254,2023-11-09 06:00:00,54,291,13,19,510,376,134,9
16255,2023-11-09 07:00:00,139,176,8,12,655,483,172,11
16256,2023-11-09 08:00:00,117,243,6,16,692,530,162,13
16257,2023-11-09 09:00:00,132,176,6,15,778,592,186,13
16258,2023-11-09 10:00:00,117,247,11,18,697,594,103,12
16259,2023-11-09 11:00:00,117,115,14,17,655,487,168,8
16260,2023-11-09 12:00:00,69,195,11,17,675,558,117,12
16261,2023-11-09 13:00:00,69,261,11,11,527,389,138,12
16262,2023-11-09 14:00:00,68,108,12,13,776,667,109,14
16263,2023-11-09 15:00:00,80,155,13,11,795,659,136,14
16264,2023-11-09 16:00:00,115,175,6,11,618,448,170,11
16265,2023-11-09 17:00:00,107,263,7,19,561,493,68,8
16266,2023-11-09 18:00:00,69,128,9,17,642,546,96,5
16267,2023-11-09 19:00:00,63,107,6,15,522,409,113,6
16268,2023-11-09 20:00:00,104,115,5,12,727,529,198,12
16269,2023-11-09 21:00:00,50,259,13,11,673,495,178,6
16270,2023-11-09 22:00:00,90,228,11,17,681,493,188,9
16271,2023-11-09 23:00:00,132,285,14,17,515,372,143,10
16272,2023-11-10 00:00:00,83,285,10,19,676,571,105,12
16273,2023-11-10 01:00:00,84,254,10,19,633,539,94,7
16274,2023-11-10 02:00:00,112,283,10,17,673,576,97,8
16275,2023-11-10 03:00:00,56,279,12,11,583,444,139,13
16276,2023-11-10 04:00:00,120,284,14,16,785,633,152,14
16277,2023-11-10 05:00:00,140,115,13,10,620,499,121,11
16278,2023-11-10 06:00:00,86,138,11,16,635,482,153,9
16279,2023-11-10 07:00:00,60,284,9,15,765,560,205,13
16280,2023-11-10 08:00:00,69,101,8,10,561,492,69,14
16281,2023-11-10 09:00:00,68,204,13,18,785,554,231,8
16282,2023-11-10 10:00:00,77,232,13,13,729,576,153,14
16283,2023-11-10 11:00:00,108,286,5,14,599,519,80,9
16284,2023-11-10 12:00:00,84,225,14,11,673,512,161,13
16285,2023-11-10 13:00:00,85,171,7,15,713,555,158,9
16286,2023-11-10 14:00:00,129,281,7,19,575,439,136,13
16287,2023-11-10 15:00:00,148,287,13,11,602,485,117,11
16288,2023-11-10 16:00:00,120,127,11,10,568,414,154,10
16289,2023-11-10 17:00:00,123,269,9,11,724,599,125,13
16290,2023-11-10 18:00:00,106,267,9,11,564,408,156,6
16291,2023-11-10 19:00:00,138,146,14,14,507,443,64,11
16292,2023-11-10 20:00:00,64,111,12,17,583,516,67,9
16293,2023-11-10 21:00:00,85,111,12,12,613,542,71,11
16294,2023-11-10 22:00:00,94,225,7,16,532,468,64,13
16295,2023-11-10 23:00:00,109,134,6,12,754,616,138,5
16296,2023-11-11 00:00:00,105,196,9,18,653,484,169,5
16297,2023-11-11 01:00:00,149,121,6,13,543,469,74,13
16298,2023-11-11 02:00:00,124,139,7,12,626,489,137,5
16299,2023-11-11 03:00:00,122,212,12,10,578,507,71,5
16300,2023-11-11 04:00:00,127,224,5,17,771,594,177,7
16301,2023-11-11 05:00:00,101,228,13,18,516,383,133,11
16302,2023-11-11 06:00:00,54,101,11,15,751,614,137,7
16303,2023-11-11 07:00:00,147,247,11,13,796,698,98,13
16304,2023-11-11 08:00:00,61,123,14,12,796,597,199,11
16305,2023-11-11 09:00:00,127,235,8,11,500,376,124,14
16306,2023-11-11 10:00:00,126,168,8,11,641,549,92,14
16307,2023-11-11 11:00:00,52,164,6,14,546,426,120,8
16308,2023-11-11 12:00:00,104,251,8,16,670,576,94,13
16309,2023-11-11 13:00:00,88,116,11,16,642,536,106,12
16310,2023-11-11 14:00:00,80,211,9,13,530,446,84,11
16311,2023-11-11 15:00:00,148,148,10,17,549,491,58,8
16312,2023-11-11 16:00:00,109,299,10,15,661,554,107,5
16313,2023-11-11 17:00:00,68,141,10,16,644,478,166,8
16314,2023-11-11 18:00:00,53,251,7,10,793,673,120,7
16315,2023-11-11 19:00:00,115,142,11,13,507,372,135,12
16316,2023-11-11 20:00:00,119,245,5,15,720,550,170,7
16317,2023-11-11 21:00:00,68,256,12,17,600,502,98,11
16318,2023-11-11 22:00:00,132,223,11,13,600,485,115,5
16319,2023-11-11 23:00:00,142,170,10,15,539,428,111,9
16320,2023-11-12 00:00:00,110,119,6,13,506,358,148,11
16321,2023-11-12 01:00:00,58,259,11,13,671,514,157,12
16322,2023-11-12 02:00:00,129,146,5,14,750,572,178,13
16323,2023-11-12 03:00:00,100,172,5,14,633,518,115,13
16324,2023-11-12 04:00:00,50,103,14,13,676,508,168,11
16325,2023-11-12 05:00:00,143,116,7,13,554,412,142,5
16326,2023-11-12 06:00:00,142,162,12,19,565,467,98,14
16327,2023-11-12 07:00:00,51,238,9,18,621,525,96,5
16328,2023-11-12 08:00:00,61,140,11,11,648,543,105,6
16329,2023-11-12 09:00:00,83,285,14,12,610,467,143,10
16330,2023-11-12 10:00:00,79,259,8,13,607,498,109,13
16331,2023-11-12 11:00:00,114,171,14,18,551,490,61,6
16332,2023-11-12 12:00:00,63,270,12,15,684,541,143,6
16333,2023-11-12 13:00:00,62,124,12,12,700,608,92,11
16334,2023-11-12 14:00:00,70,167,12,13,517,457,60,9
16335,2023-11-12 15:00:00,69,188,6,11,717,511,206,10
16336,2023-11-12 16:00:00,90,163,8,18,690,484,206,9
16337,2023-11-12 17:00:00,123,259,6,17,664,515,149,5
16338,2023-11-12 18:00:00,147,267,9,14,580,441,139,8
16339,2023-11-12 19:00:00,119,157,9,19,693,528,165,5
16340,2023-11-12 20:00:00,78,125,14,19,669,583,86,5
16341,2023-11-12 21:00:00,141,153,12,10,554,470,84,12
16342,2023-11-12 22:00:00,148,118,8,11,533,477,56,7
16343,2023-11-12 23:00:00,149,121,11,19,780,689,91,13
16344,2023-11-13 00:00:00,105,115,5,16,523,438,85,5
16345,2023-11-13 01:00:00,91,185,13,12,515,444,71,5
16346,2023-11-13 02:00:00,95,275,8,19,792,624,168,14
16347,2023-11-13 03:00:00,60,141,10,11,565,445,120,6
16348,2023-11-13 04:00:00,123,168,5,11,774,679,95,5
16349,2023-11-13 05:00:00,63,295,7,11,753,659,94,10
16350,2023-11-13 06:00:00,105,134,5,15,793,657,136,8
16351,2023-11-13 07:00:00,120,288,12,13,756,550,206,14
16352,2023-11-13 08:00:00,80,186,8,10,518,465,53,8
16353,2023-11-13 09:00:00,145,220,9,15,613,533,80,12
16354,2023-11-13 10:00:00,83,191,11,12,767,602,165,14
16355,2023-11-13 11:00:00,68,189,13,16,742,655,87,14
16356,2023-11-13 12:00:00,130,197,11,16,723,595,128,10
16357,2023-11-13 13:00:00,110,251,13,19,798,600,198,8
16358,2023-11-13 14:00:00,106,102,8,10,574,480,94,13
16359,2023-11-13 15:00:00,58,126,13,15,638,544,94,5
16360,2023-11-13 16:00:00,83,147,7,19,686,557,129,7
16361,2023-11-13 17:00:00,112,279,7,12,664,553,111,6
16362,2023-11-13 18:00:00,146,233,13,11,733,544,189,10
16363,2023-11-13 19:00:00,68,118,6,18,705,511,194,11
16364,2023-11-13 20:00:00,78,175,7,13,526,414,112,10
16365,2023-11-13 21:00:00,133,266,5,18,628,486,142,13
16366,2023-11-13 22:00:00,134,186,6,13,796,580,216,7
16367,2023-11-13 23:00:00,77,267,12,10,547,401,146,13
16368,2023-11-14 00:00:00,117,269,5,14,776,581,195,11
16369,2023-11-14 01:00:00,60,242,9,17,605,476,129,8
16370,2023-11-14 02:00:00,77,212,5,10,718,617,101,9
16371,2023-11-14 03:00:00,144,125,11,14,752,548,204,6
16372,2023-11-14 04:00:00,58,261,14,12,605,431,174,7
16373,2023-11-14 05:00:00,131,129,9,10,657,487,170,14
16374,2023-11-14 06:00:00,74,248,12,15,608,487,121,14
16375,2023-11-14 07:00:00,92,276,10,16,565,395,170,5
16376,2023-11-14 08:00:00,69,108,10,17,563,433,130,14
16377,2023-11-14 09:00:00,138,194,9,14,697,557,140,9
16378,2023-11-14 10:00:00,114,282,6,16,513,444,69,10
16379,2023-11-14 11:00:00,113,197,10,11,572,501,71,11
16380,2023-11-14 12:00:00,65,159,6,19,582,407,175,5
16381,2023-11-14 13:00:00,71,273,12,17,699,501,198,13
16382,2023-11-14 14:00:00,101,195,14,10,725,566,159,6
16383,2023-11-14 15:00:00,101,207,9,18,644,578,66,12
16384,2023-11-14 16:00:00,130,127,6,14,768,559,209,8
16385,2023-11-14 17:00:00,98,251,6,18,531,415,116,12
16386,2023-11-14 18:00:00,93,259,7,10,627,503,124,6
16387,2023-11-14 19:00:00,111,237,6,18,653,505,148,10
16388,2023-11-14 20:00:00,91,283,9,14,651,569,82,13
16389,2023-11-14 21:00:00,53,143,9,14,545,385,160,6
16390,2023-11-14 22:00:00,146,227,6,16,510,416,94,14
16391,2023-11-14 23:00:00,97,155,7,14,632,523,109,14
16392,2023-11-15 00:00:00,72,295,12,11,646,513,133,10
16393,2023-11-15 01:00:00,97,297,12,18,764,640,124,11
16394,2023-11-15 02:00:00,128,205,8,10,642,562,80,6
16395,2023-11-15 03:00:00,90,173,9,13,739,567,172,7
16396,2023-11-15 04:00:00,73,127,13,18,557,439,118,8
16397,2023-11-15 05:00:00,75,135,6,10,552,454,98,14
16398,2023-11-15 06:00:00,86,228,11,17,799,561,238,13
16399,2023-11-15 07:00:00,96,107,6,17,773,653,120,7
16400,2023-11-15 08:00:00,56,260,13,14,747,551,196,12
16401,2023-11-15 09:00:00,89,145,6,10,686,587,99,6
16402,2023-11-15 10:00:00,136,183,13,16,609,498,111,13
16403,2023-11-15 11:00:00,125,151,11,13,730,518,212,9
16404,2023-11-15 12:00:00,51,143,5,15,750,644,106,8
16405,2023-11-15 13:00:00,113,241,7,10,556,438,118,5
16406,2023-11-15 14:00:00,125,164,9,12,592,522,70,14
16407,2023-11-15 15:00:00,79,189,14,19,749,655,94,12
16408,2023-11-15 16:00:00,146,237,9,17,778,584,194,9
16409,2023-11-15 17:00:00,110,171,6,14,753,539,214,6
16410,2023-11-15 18:00:00,148,234,7,15,660,534,126,13
16411,2023-11-15 19:00:00,125,208,11,10,512,409,103,14
16412,2023-11-15 20:00:00,110,195,9,11,718,518,200,6
16413,2023-11-15 21:00:00,86,283,5,14,536,376,160,9
16414,2023-11-15 22:00:00,123,241,9,15,699,548,151,5
16415,2023-11-15 23:00:00,130,140,7,17,682,484,198,12
16416,2023-11-16 00:00:00,104,169,14,13,533,456,77,12
16417,2023-11-16 01:00:00,143,259,6,19,627,483,144,6
16418,2023-11-16 02:00:00,102,188,12,16,679,525,154,8
16419,2023-11-16 03:00:00,129,237,12,13,689,540,149,5
16420,2023-11-16 04:00:00,69,181,9,18,593,473,120,12
16421,2023-11-16 05:00:00,51,147,14,19,523,390,133,11
16422,2023-11-16 06:00:00,130,136,12,13,645,548,97,12
16423,2023-11-16 07:00:00,132,176,13,12,649,583,66,12
16424,2023-11-16 08:00:00,137,296,11,17,635,460,175,6
16425,2023-11-16 09:00:00,132,281,9,16,764,683,81,12
16426,2023-11-16 10:00:00,96,294,6,19,596,436,160,13
16427,2023-11-16 11:00:00,83,297,8,10,631,523,108,5
16428,2023-11-16 12:00:00,105,210,13,16,551,455,96,8
16429,2023-11-16 13:00:00,83,291,13,12,632,535,97,12
16430,2023-11-16 14:00:00,106,132,12,13,588,433,155,9
16431,2023-11-16 15:00:00,75,252,13,14,661,541,120,8
16432,2023-11-16 16:00:00,112,297,8,10,670,547,123,6
16433,2023-11-16 17:00:00,70,206,5,17,516,399,117,6
16434,2023-11-16 18:00:00,115,259,14,18,782,573,209,8
16435,2023-11-16 19:00:00,83,260,11,15,590,494,96,12
16436,2023-11-16 20:00:00,122,218,5,13,551,446,105,5
16437,2023-11-16 21:00:00,148,131,11,15,614,542,72,7
16438,2023-11-16 22:00:00,59,255,13,10,627,537,90,9
16439,2023-11-16 23:00:00,140,197,10,18,551,434,117,7
16440,2023-11-17 00:00:00,76,230,9,15,679,605,74,6
16441,2023-11-17 01:00:00,123,271,6,17,567,469,98,9
16442,2023-11-17 02:00:00,60,171,13,12,791,576,215,6
16443,2023-11-17 03:00:00,147,238,10,15,768,563,205,14
16444,2023-11-17 04:00:00,56,114,13,15,765,639,126,6
16445,2023-11-17 05:00:00,138,123,14,19,543,382,161,13
16446,2023-11-17 06:00:00,82,203,12,16,678,485,193,14
16447,2023-11-17 07:00:00,123,261,14,19,511,376,135,11
16448,2023-11-17 08:00:00,104,207,9,15,530,476,54,5
16449,2023-11-17 09:00:00,81,222,12,19,522,412,110,7
16450,2023-11-17 10:00:00,83,288,11,18,562,400,162,7
16451,2023-11-17 11:00:00,99,125,9,13,546,455,91,11
16452,2023-11-17 12:00:00,144,208,12,19,668,501,167,6
16453,2023-11-17 13:00:00,54,150,12,10,502,402,100,5
16454,2023-11-17 14:00:00,82,170,13,12,704,598,106,14
16455,2023-11-17 15:00:00,62,175,12,11,630,475,155,10
16456,2023-11-17 16:00:00,88,118,8,10,651,574,77,5
16457,2023-11-17 17:00:00,83,103,8,13,783,550,233,14
16458,2023-11-17 18:00:00,52,263,11,17,583,410,173,14
16459,2023-11-17 19:00:00,115,117,8,10,536,465,71,8
16460,2023-11-17 20:00:00,104,209,6,10,707,570,137,12
16461,2023-11-17 21:00:00,59,290,7,14,614,480,134,8
16462,2023-11-17 22:00:00,125,155,12,15,614,483,131,13
16463,2023-11-17 23:00:00,95,268,14,17,568,426,142,7
16464,2023-11-18 00:00:00,140,187,14,17,517,458,59,8
16465,2023-11-18 01:00:00,118,134,7,11,750,553,197,13
16466,2023-11-18 02:00:00,108,152,12,11,536,453,83,14
16467,2023-11-18 03:00:00,112,277,11,15,507,403,104,6
16468,2023-11-18 04:00:00,86,140,8,17,518,400,118,7
16469,2023-11-18 05:00:00,81,106,9,14,547,418,129,12
16470,2023-11-18 06:00:00,78,129,7,19,685,590,95,10
16471,2023-11-18 07:00:00,148,267,13,16,513,411,102,6
16472,2023-11-18 08:00:00,130,171,6,12,514,461,53,6
16473,2023-11-18 09:00:00,82,198,13,15,740,538,202,13
16474,2023-11-18 10:00:00,73,152,7,15,797,577,220,8
16475,2023-11-18 11:00:00,104,145,8,18,670,502,168,11
16476,2023-11-18 12:00:00,148,294,6,12,661,562,99,9
16477,2023-11-18 13:00:00,143,264,11,13,701,617,84,11
16478,2023-11-18 14:00:00,125,255,7,17,548,404,144,13
16479,2023-11-18 15:00:00,50,130,7,10,599,532,67,6
16480,2023-11-18 16:00:00,57,103,11,10,662,479,183,8
16481,2023-11-18 17:00:00,98,137,11,18,708,604,104,14
16482,2023-11-18 18:00:00,84,270,14,16,545,426,119,5
16483,2023-11-18 19:00:00,51,113,10,12,799,575,224,13
16484,2023-11-18 20:00:00,128,126,11,15,772,676,96,9
16485,2023-11-18 21:00:00,143,218,10,10,602,513,89,5
16486,2023-11-18 22:00:00,146,194,14,18,712,534,178,6
16487,2023-11-18 23:00:00,95,123,10,14,641,509,132,5
16488,2023-11-19 00:00:00,56,150,7,11,605,484,121,9
16489,2023-11-19 01:00:00,138,232,5,16,610,432,178,7
16490,2023-11-19 02:00:00,128,269,13,17,605,462,143,13
16491,2023-11-19 03:00:00,131,298,12,17,766,677,89,14
16492,2023-11-19 04:00:00,140,236,14,17,625,533,92,11
16493,2023-11-19 05:00:00,98,258,14,17,791,618,173,10
16494,2023-11-19 06:00:00,145,239,8,12,517,440,77,11
16495,2023-11-19 07:00:00,140,217,11,13,771,618,153,13
16496,2023-11-19 08:00:00,146,288,14,11,770,583,187,14
16497,2023-11-19 09:00:00,116,160,10,11,581,484,97,13
16498,2023-11-19 10:00:00,94,116,8,11,663,522,141,9
16499,2023-11-19 11:00:00,98,112,12,12,655,483,172,5
16500,2023-11-19 12:00:00,141,153,10,10,678,590,88,13
16501,2023-11-19 13:00:00,84,283,6,17,613,515,98,5
16502,2023-11-19 14:00:00,131,143,6,18,500,397,103,10
16503,2023-11-19 15:00:00,106,162,11,16,757,598,159,9
16504,2023-11-19 16:00:00,134,203,13,18,786,654,132,13
16505,2023-11-19 17:00:00,53,130,12,18,751,608,143,10
16506,2023-11-19 18:00:00,132,126,8,11,710,547,163,9
16507,2023-11-19 19:00:00,85,221,14,11,670,559,111,12
16508,2023-11-19 20:00:00,130,210,7,17,708,592,116,8
16509,2023-11-19 21:00:00,57,189,10,13,651,480,171,7
16510,2023-11-19 22:00:00,145,121,12,12,770,623,147,13
16511,2023-11-19 23:00:00,125,261,13,15,517,422,95,5
16512,2023-11-20 00:00:00,118,235,5,13,626,546,80,10
16513,2023-11-20 01:00:00,108,172,14,15,774,600,174,14
16514,2023-11-20 02:00:00,59,180,7,11,515,444,71,8
16515,2023-11-20 03:00:00,144,217,14,15,775,657,118,8
16516,2023-11-20 04:00:00,103,244,8,14,570,467,103,14
16517,2023-11-20 05:00:00,109,160,6,10,772,584,188,6
16518,2023-11-20 06:00:00,118,294,14,16,761,646,115,10
16519,2023-11-20 07:00:00,149,193,9,18,633,493,140,5
16520,2023-11-20 08:00:00,53,251,13,17,787,615,172,7
16521,2023-11-20 09:00:00,72,247,9,17,534,447,87,8
16522,2023-11-20 10:00:00,68,157,12,15,530,402,128,13
16523,2023-11-20 11:00:00,108,176,6,11,606,506,100,6
16524,2023-11-20 12:00:00,66,298,8,10,534,462,72,10
16525,2023-11-20 13:00:00,149,106,6,14,594,468,126,12
16526,2023-11-20 14:00:00,135,133,8,16,659,581,78,13
16527,2023-11-20 15:00:00,67,113,5,12,506,369,137,13
16528,2023-11-20 16:00:00,102,207,11,15,665,467,198,6
16529,2023-11-20 17:00:00,77,278,12,12,786,706,80,7
16530,2023-11-20 18:00:00,147,275,7,13,696,508,188,6
16531,2023-11-20 19:00:00,130,291,9,19,595,525,70,10
16532,2023-11-20 20:00:00,110,231,5,11,701,509,192,13
16533,2023-11-20 21:00:00,71,106,11,18,554,471,83,12
16534,2023-11-20 22:00:00,97,143,13,16,616,529,87,7
16535,2023-11-20 23:00:00,62,152,13,14,576,488,88,6
16536,2023-11-21 00:00:00,145,118,11,12,749,526,223,8
16537,2023-11-21 01:00:00,62,147,7,16,693,564,129,12
16538,2023-11-21 02:00:00,139,267,10,12,707,543,164,8
16539,2023-11-21 03:00:00,128,146,5,17,633,475,158,13
16540,2023-11-21 04:00:00,141,243,12,13,724,626,98,6
16541,2023-11-21 05:00:00,134,195,11,17,564,395,169,8
16542,2023-11-21 06:00:00,98,100,6,17,572,412,160,8
16543,2023-11-21 07:00:00,126,221,14,15,619,542,77,12
16544,2023-11-21 08:00:00,106,147,9,10,741,623,118,6
16545,2023-11-21 09:00:00,135,155,8,10,550,428,122,12
16546,2023-11-21 10:00:00,118,215,10,15,638,458,180,12
16547,2023-11-21 11:00:00,66,143,6,10,627,449,178,9
16548,2023-11-21 12:00:00,82,160,12,17,693,517,176,6
16549,2023-11-21 13:00:00,50,250,8,16,503,409,94,9
16550,2023-11-21 14:00:00,123,124,8,17,614,499,115,11
16551,2023-11-21 15:00:00,89,258,10,19,620,548,72,11
16552,2023-11-21 16:00:00,149,272,13,19,606,539,67,14
16553,2023-11-21 17:00:00,119,137,5,15,624,469,155,11
16554,2023-11-21 18:00:00,120,268,13,17,516,423,93,5
16555,2023-11-21 19:00:00,119,216,8,18,624,456,168,11
16556,2023-11-21 20:00:00,126,199,14,15,615,507,108,5
16557,2023-11-21 21:00:00,148,146,12,14,503,426,77,14
16558,2023-11-21 22:00:00,56,173,8,16,542,456,86,5
16559,2023-11-21 23:00:00,91,204,7,17,571,427,144,9
16560,2023-11-22 00:00:00,104,204,12,13,545,400,145,6
16561,2023-11-22 01:00:00,53,112,7,19,779,691,88,10
16562,2023-11-22 02:00:00,124,248,14,16,679,507,172,7
16563,2023-11-22 03:00:00,102,236,14,19,796,691,105,14
16564,2023-11-22 04:00:00,64,249,5,15,761,632,129,9
16565,2023-11-22 05:00:00,121,293,8,18,558,424,134,10
16566,2023-11-22 06:00:00,62,233,12,15,613,470,143,10
16567,2023-11-22 07:00:00,84,247,12,12,587,482,105,12
16568,2023-11-22 08:00:00,100,140,5,14,666,548,118,6
16569,2023-11-22 09:00:00,65,112,12,10,510,390,120,11
16570,2023-11-22 10:00:00,127,103,13,14,742,567,175,9
16571,2023-11-22 11:00:00,126,144,11,15,533,394,139,5
16572,2023-11-22 12:00:00,141,112,9,11,662,581,81,9
16573,2023-11-22 13:00:00,148,179,13,12,633,522,111,14
16574,2023-11-22 14:00:00,88,220,12,15,547,474,73,9
16575,2023-11-22 15:00:00,125,275,11,18,716,588,128,5
16576,2023-11-22 16:00:00,125,266,14,19,699,508,191,9
16577,2023-11-22 17:00:00,89,133,6,13,644,577,67,5
16578,2023-11-22 18:00:00,65,116,10,13,520,467,53,13
16579,2023-11-22 19:00:00,56,106,5,13,655,492,163,9
16580,2023-11-22 20:00:00,134,193,9,19,580,491,89,10
16581,2023-11-22 21:00:00,69,204,8,10,647,519,128,9
16582,2023-11-22 22:00:00,142,132,8,18,776,560,216,6
16583,2023-11-22 23:00:00,51,135,13,16,786,647,139,11
16584,2023-11-23 00:00:00,141,107,6,13,638,573,65,8
16585,2023-11-23 01:00:00,138,272,10,11,761,641,120,13
16586,2023-11-23 02:00:00,124,106,6,13,607,497,110,6
16587,2023-11-23 03:00:00,127,215,6,13,519,369,150,13
16588,2023-11-23 04:00:00,66,177,6,16,692,494,198,6
16589,2023-11-23 05:00:00,94,132,9,11,697,545,152,6
16590,2023-11-23 06:00:00,138,133,6,12,641,550,91,13
16591,2023-11-23 07:00:00,128,191,13,17,719,518,201,5
16592,2023-11-23 08:00:00,65,272,12,11,571,501,70,6
16593,2023-11-23 09:00:00,114,242,14,10,653,491,162,11
16594,2023-11-23 10:00:00,63,142,5,19,781,548,233,11
16595,2023-11-23 11:00:00,83,252,5,15,675,477,198,12
16596,2023-11-23 12:00:00,96,297,10,14,589,478,111,14
16597,2023-11-23 13:00:00,65,287,9,12,741,578,163,8
16598,2023-11-23 14:00:00,52,193,7,10,777,587,190,10
16599,2023-11-23 15:00:00,106,224,8,18,774,589,185,5
16600,2023-11-23 16:00:00,127,151,9,10,737,519,218,8
16601,2023-11-23 17:00:00,119,209,11,16,695,582,113,5
16602,2023-11-23 18:00:00,132,119,13,10,668,522,146,9
16603,2023-11-23 19:00:00,102,240,6,12,680,509,171,8
16604,2023-11-23 20:00:00,148,149,13,15,525,438,87,13
16605,2023-11-23 21:00:00,129,264,14,10,511,451,60,8
16606,2023-11-23 22:00:00,108,210,11,10,513,399,114,11
16607,2023-11-23 23:00:00,64,224,7,17,524,466,58,6
16608,2023-11-24 00:00:00,62,148,11,12,541,428,113,9
16609,2023-11-24 01:00:00,59,256,14,12,506,382,124,5
16610,2023-11-24 02:00:00,58,172,8,10,645,494,151,12
16611,2023-11-24 03:00:00,149,196,14,13,728,654,74,11
16612,2023-11-24 04:00:00,143,258,6,15,534,467,67,6
16613,2023-11-24 05:00:00,104,213,13,12,607,433,174,11
16614,2023-11-24 06:00:00,142,286,13,17,728,529,199,10
16615,2023-11-24 07:00:00,61,286,9,16,537,388,149,10
16616,2023-11-24 08:00:00,83,246,10,17,632,480,152,14
16617,2023-11-24 09:00:00,75,298,10,18,502,365,137,14
16618,2023-11-24 10:00:00,94,127,5,15,794,562,232,10
16619,2023-11-24 11:00:00,114,178,8,11,651,491,160,12
16620,2023-11-24 12:00:00,144,182,7,18,568,451,117,8
16621,2023-11-24 13:00:00,112,227,9,13,744,624,120,14
16622,2023-11-24 14:00:00,55,100,12,16,609,472,137,12
16623,2023-11-24 15:00:00,125,126,14,17,671,476,195,5
16624,2023-11-24 16:00:00,52,211,8,18,731,537,194,14
16625,2023-11-24 17:00:00,81,294,6,15,519,407,112,8
16626,2023-11-24 18:00:00,95,200,10,17,777,601,176,12
16627,2023-11-24 19:00:00,116,255,14,18,663,482,181,11
16628,2023-11-24 20:00:00,69,259,14,16,577,516,61,9
16629,2023-11-24 21:00:00,141,208,9,13,673,483,190,5
16630,2023-11-24 22:00:00,144,284,11,15,540,464,76,5
16631,2023-11-24 23:00:00,69,276,5,10,507,402,105,5
16632,2023-11-25 00:00:00,103,115,9,18,619,461,158,14
16633,2023-11-25 01:00:00,103,173,8,16,665,592,73,8
16634,2023-11-25 02:00:00,102,190,7,18,760,545,215,6
16635,2023-11-25 03:00:00,63,156,12,19,748,669,79,13
16636,2023-11-25 04:00:00,107,189,9,18,742,601,141,13
16637,2023-11-25 05:00:00,76,299,8,12,668,475,193,6
16638,2023-11-25 06:00:00,57,164,10,16,619,466,153,12
16639,2023-11-25 07:00:00,139,269,14,18,510,395,115,14
16640,2023-11-25 08:00:00,74,175,14,14,710,608,102,13
16641,2023-11-25 09:00:00,72,282,14,15,556,493,63,13
16642,2023-11-25 10:00:00,85,211,6,18,588,443,145,14
16643,2023-11-25 11:00:00,144,220,13,19,530,427,103,12
16644,2023-11-25 12:00:00,64,183,9,14,683,568,115,11
16645,2023-11-25 13:00:00,127,295,11,11,620,450,170,10
16646,2023-11-25 14:00:00,141,137,10,15,577,414,163,6
16647,2023-11-25 15:00:00,87,233,11,12,524,385,139,6
16648,2023-11-25 16:00:00,96,146,12,16,503,376,127,13
16649,2023-11-25 17:00:00,81,276,13,16,797,620,177,11
16650,2023-11-25 18:00:00,146,227,12,12,613,551,62,6
16651,2023-11-25 19:00:00,144,121,8,19,586,525,61,5
16652,2023-11-25 20:00:00,130,226,11,14,741,599,142,11
16653,2023-11-25 21:00:00,102,194,11,17,505,370,135,12
16654,2023-11-25 22:00:00,144,149,9,13,656,483,173,5
16655,2023-11-25 23:00:00,145,175,8,10,793,695,98,14
16656,2023-11-26 00:00:00,61,260,5,19,637,523,114,7
16657,2023-11-26 01:00:00,121,244,9,12,768,687,81,11
16658,2023-11-26 02:00:00,96,146,12,12,641,539,102,10
16659,2023-11-26 03:00:00,149,299,13,10,560,400,160,12
16660,2023-11-26 04:00:00,54,160,13,19,686,614,72,11
16661,2023-11-26 05:00:00,115,178,11,16,557,488,69,8
16662,2023-11-26 06:00:00,50,190,11,17,534,432,102,5
16663,2023-11-26 07:00:00,147,175,5,18,796,642,154,12
16664,2023-11-26 08:00:00,79,109,7,13,576,486,90,5
16665,2023-11-26 09:00:00,144,290,14,11,556,434,122,7
16666,2023-11-26 10:00:00,78,178,11,11,521,370,151,11
16667,2023-11-26 11:00:00,100,294,10,10,747,591,156,6
16668,2023-11-26 12:00:00,123,173,6,14,694,517,177,5
16669,2023-11-26 13:00:00,81,190,7,12,504,449,55,10
16670,2023-11-26 14:00:00,117,163,8,12,510,396,114,5
16671,2023-11-26 15:00:00,84,256,10,12,586,454,132,8
16672,2023-11-26 16:00:00,57,176,14,17,500,413,87,12
16673,2023-11-26 17:00:00,93,219,13,16,727,629,98,14
16674,2023-11-26 18:00:00,98,137,12,19,748,549,199,14
16675,2023-11-26 19:00:00,62,297,5,17,659,518,141,13
16676,2023-11-26 20:00:00,142,284,7,11,649,553,96,7
16677,2023-11-26 21:00:00,114,295,9,18,728,518,210,5
16678,2023-11-26 22:00:00,63,110,14,19,589,472,117,7
16679,2023-11-26 23:00:00,54,299,10,11,738,594,144,7
16680,2023-11-27 00:00:00,99,138,8,19,556,397,159,12
16681,2023-11-27 01:00:00,87,226,12,19,595,445,150,6
16682,2023-11-27 02:00:00,68,245,10,18,642,555,87,8
16683,2023-11-27 03:00:00,87,283,11,13,713,599,114,12
16684,2023-11-27 04:00:00,145,113,10,13,747,660,87,11
16685,2023-11-27 05:00:00,93,215,5,14,615,491,124,13
16686,2023-11-27 06:00:00,87,243,6,17,755,648,107,13
16687,2023-11-27 07:00:00,75,137,12,11,600,465,135,9
16688,2023-11-27 08:00:00,67,184,10,10,686,590,96,9
16689,2023-11-27 09:00:00,94,113,9,12,527,379,148,14
16690,2023-11-27 10:00:00,135,186,9,14,777,664,113,11
16691,2023-11-27 11:00:00,135,191,14,13,502,386,116,12
16692,2023-11-27 12:00:00,113,299,11,12,777,543,234,9
16693,2023-11-27 13:00:00,107,192,10,10,786,625,161,6
16694,2023-11-27 14:00:00,60,237,11,12,590,488,102,7
16695,2023-11-27 15:00:00,143,152,6,19,556,419,137,7
16696,2023-11-27 16:00:00,135,221,11,16,603,454,149,12
16697,2023-11-27 17:00:00,101,274,6,18,577,454,123,13
16698,2023-11-27 18:00:00,61,271,8,17,631,473,158,5
16699,2023-11-27 19:00:00,132,135,5,10,536,438,98,13
16700,2023-11-27 20:00:00,141,258,12,15,645,468,177,10
16701,2023-11-27 21:00:00,126,156,5,15,559,392,167,13
16702,2023-11-27 22:00:00,127,271,13,12,737,541,196,5
16703,2023-11-27 23:00:00,54,250,11,19,611,503,108,7
16704,2023-11-28 00:00:00,69,272,10,12,548,442,106,8
16705,2023-11-28 01:00:00,51,130,14,13,567,487,80,14
16706,2023-11-28 02:00:00,110,196,9,19,589,454,135,7
16707,2023-11-28 03:00:00,138,244,14,10,521,448,73,10
16708,2023-11-28 04:00:00,56,199,8,12,570,481,89,5
16709,2023-11-28 05:00:00,127,153,6,11,655,471,184,11
16710,2023-11-28 06:00:00,72,227,13,11,783,683,100,13
16711,2023-11-28 07:00:00,83,287,14,17,778,685,93,9
16712,2023-11-28 08:00:00,119,130,11,19,644,483,161,6
16713,2023-11-28 09:00:00,146,120,13,11,656,546,110,9
16714,2023-11-28 10:00:00,90,166,10,10,577,433,144,8
16715,2023-11-28 11:00:00,90,225,8,16,550,447,103,13
16716,2023-11-28 12:00:00,136,267,9,14,642,543,99,10
16717,2023-11-28 13:00:00,135,243,14,13,624,508,116,10
16718,2023-11-28 14:00:00,53,148,9,11,593,472,121,12
16719,2023-11-28 15:00:00,92,279,14,12,579,439,140,10
16720,2023-11-28 16:00:00,93,220,11,17,795,575,220,12
16721,2023-11-28 17:00:00,82,175,12,16,523,454,69,9
16722,2023-11-28 18:00:00,56,183,11,17,604,469,135,11
16723,2023-11-28 19:00:00,87,184,14,14,616,481,135,8
16724,2023-11-28 20:00:00,128,279,13,15,671,476,195,12
16725,2023-11-28 21:00:00,139,170,14,13,551,414,137,5
16726,2023-11-28 22:00:00,61,289,7,17,519,435,84,7
16727,2023-11-28 23:00:00,100,191,10,17,751,593,158,5
16728,2023-11-29 00:00:00,111,179,6,13,649,576,73,5
16729,2023-11-29 01:00:00,58,136,14,16,535,443,92,11
16730,2023-11-29 02:00:00,104,210,7,19,547,395,152,9
16731,2023-11-29 03:00:00,101,153,10,14,787,602,185,14
16732,2023-11-29 04:00:00,73,157,14,15,528,394,134,9
16733,2023-11-29 05:00:00,125,265,13,13,682,522,160,6
16734,2023-11-29 06:00:00,137,271,12,14,781,701,80,9
16735,2023-11-29 07:00:00,109,290,6,15,771,615,156,8
16736,2023-11-29 08:00:00,79,257,12,18,689,615,74,7
16737,2023-11-29 09:00:00,116,183,7,10,769,684,85,7
16738,2023-11-29 10:00:00,75,108,13,17,693,551,142,13
16739,2023-11-29 11:00:00,74,190,11,10,758,627,131,12
16740,2023-11-29 12:00:00,118,182,12,16,571,405,166,12
16741,2023-11-29 13:00:00,65,125,5,15,517,440,77,13
16742,2023-11-29 14:00:00,138,137,9,13,706,527,179,11
16743,2023-11-29 15:00:00,73,278,10,12,764,672,92,6
16744,2023-11-29 16:00:00,127,208,9,16,513,422,91,9
16745,2023-11-29 17:00:00,55,121,13,17,626,460,166,11
16746,2023-11-29 18:00:00,56,244,12,13,631,462,169,9
16747,2023-11-29 19:00:00,73,193,5,12,568,508,60,12
16748,2023-11-29 20:00:00,55,265,13,16,783,621,162,13
16749,2023-11-29 21:00:00,107,208,11,19,670,549,121,12
16750,2023-11-29 22:00:00,116,235,7,15,664,488,176,7
16751,2023-11-29 23:00:00,75,262,13,10,787,641,146,12
16752,2023-11-30 00:00:00,132,200,13,18,550,478,72,8
16753,2023-11-30 01:00:00,126,174,14,10,719,633,86,14
16754,2023-11-30 02:00:00,124,215,10,14,510,376,134,6
16755,2023-11-30 03:00:00,64,134,13,11,571,403,168,10
16756,2023-11-30 04:00:00,144,258,11,19,708,548,160,7
16757,2023-11-30 05:00:00,50,273,12,11,736,547,189,8
16758,2023-11-30 06:00:00,122,272,8,13,647,482,165,14
16759,2023-11-30 07:00:00,138,119,6,16,698,539,159,12
16760,2023-11-30 08:00:00,118,119,10,17,694,537,157,5
16761,2023-11-30 09:00:00,144,121,5,10,575,487,88,11
16762,2023-11-30 10:00:00,130,236,10,19,658,524,134,14
16763,2023-11-30 11:00:00,110,234,9,11,572,435,137,6
16764,2023-11-30 12:00:00,106,191,6,14,654,466,188,8
16765,2023-11-30 13:00:00,111,177,9,19,610,512,98,12
16766,2023-11-30 14:00:00,70,222,8,12,693,612,81,7
16767,2023-11-30 15:00:00,75,121,14,10,635,489,146,6
16768,2023-11-30 16:00:00,112,279,9,13,682,564,118,12
16769,2023-11-30 17:00:00,138,206,8,18,644,531,113,13
16770,2023-11-30 18:00:00,102,273,11,10,549,415,134,7
16771,2023-11-30 19:00:00,52,133,13,12,767,638,129,14
16772,2023-11-30 20:00:00,51,220,13,17,795,626,169,12
16773,2023-11-30 21:00:00,124,281,9,13,510,425,85,5
16774,2023-11-30 22:00:00,92,151,7,12,502,410,92,6
16775,2023-11-30 23:00:00,123,248,5,19,689,581,108,14
16776,2023-12-01 00:00:00,63,246,12,18,567,489,78,11
16777,2023-12-01 01:00:00,77,258,6,19,676,591,85,7
16778,2023-12-01 02:00:00,137,272,8,18,737,657,80,9
16779,2023-12-01 03:00:00,141,193,12,13,535,418,117,6
16780,2023-12-01 04:00:00,143,177,6,12,602,428,174,11
16781,2023-12-01 05:00:00,138,242,7,15,532,383,149,5
16782,2023-12-01 06:00:00,86,244,8,10,693,541,152,10
16783,2023-12-01 07:00:00,82,145,5,17,641,547,94,6
16784,2023-12-01 08:00:00,113,225,7,15,647,520,127,9
16785,2023-12-01 09:00:00,104,185,5,19,617,437,180,11
16786,2023-12-01 10:00:00,127,151,8,10,795,585,210,7
16787,2023-12-01 11:00:00,116,160,7,13,620,454,166,14
16788,2023-12-01 12:00:00,117,202,9,13,596,485,111,10
16789,2023-12-01 13:00:00,130,260,13,14,734,604,130,9
16790,2023-12-01 14:00:00,78,281,14,12,525,437,88,10
16791,2023-12-01 15:00:00,125,255,5,12,777,558,219,7
16792,2023-12-01 16:00:00,102,272,12,10,774,618,156,14
16793,2023-12-01 17:00:00,56,213,6,13,528,441,87,14
16794,2023-12-01 18:00:00,131,269,13,16,694,601,93,8
16795,2023-12-01 19:00:00,82,214,11,10,607,530,77,7
16796,2023-12-01 20:00:00,111,289,13,10,653,510,143,14
16797,2023-12-01 21:00:00,114,158,10,17,731,622,109,9
16798,2023-12-01 22:00:00,125,213,12,13,729,604,125,6
16799,2023-12-01 23:00:00,64,174,11,11,672,568,104,14
16800,2023-12-02 00:00:00,147,211,7,15,718,571,147,7
16801,2023-12-02 01:00:00,85,104,10,15,605,508,97,10
16802,2023-12-02 02:00:00,113,168,12,13,671,586,85,10
16803,2023-12-02 03:00:00,108,123,12,18,777,653,124,5
16804,2023-12-02 04:00:00,137,144,13,10,678,608,70,12
16805,2023-12-02 05:00:00,117,200,12,18,712,585,127,12
16806,2023-12-02 06:00:00,134,183,12,16,680,561,119,6
16807,2023-12-02 07:00:00,119,274,13,17,560,503,57,14
16808,2023-12-02 08:00:00,104,221,11,18,758,579,179,5
16809,2023-12-02 09:00:00,105,250,6,13,767,546,221,11
16810,2023-12-02 10:00:00,146,119,9,16,572,480,92,7
16811,2023-12-02 11:00:00,93,184,12,11,533,457,76,12
16812,2023-12-02 12:00:00,128,119,6,16,709,564,145,8
16813,2023-12-02 13:00:00,57,224,7,16,720,617,103,8
16814,2023-12-02 14:00:00,53,189,12,19,739,588,151,10
16815,2023-12-02 15:00:00,59,134,5,10,608,441,167,12
16816,2023-12-02 16:00:00,101,120,13,14,672,516,156,8
16817,2023-12-02 17:00:00,94,214,11,12,679,569,110,9
16818,2023-12-02 18:00:00,87,248,14,11,561,470,91,14
16819,2023-12-02 19:00:00,90,225,9,18,629,557,72,5
16820,2023-12-02 20:00:00,103,214,10,18,629,531,98,11
16821,2023-12-02 21:00:00,116,177,13,18,757,533,224,13
16822,2023-12-02 22:00:00,110,228,14,11,720,513,207,7
16823,2023-12-02 23:00:00,118,112,10,14,574,505,69,13
16824,2023-12-03 00:00:00,118,171,10,10,646,577,69,9
16825,2023-12-03 01:00:00,127,295,12,18,794,601,193,13
16826,2023-12-03 02:00:00,101,236,13,17,528,413,115,10
16827,2023-12-03 03:00:00,90,127,6,18,794,590,204,12
16828,2023-12-03 04:00:00,93,144,12,15,622,537,85,9
16829,2023-12-03 05:00:00,98,143,13,14,543,412,131,5
16830,2023-12-03 06:00:00,105,252,8,19,794,564,230,14
16831,2023-12-03 07:00:00,57,290,7,18,668,571,97,7
16832,2023-12-03 08:00:00,114,224,11,12,656,512,144,6
16833,2023-12-03 09:00:00,84,127,10,15,581,411,170,6
16834,2023-12-03 10:00:00,108,188,5,19,739,599,140,5
16835,2023-12-03 11:00:00,92,253,7,15,577,505,72,9
16836,2023-12-03 12:00:00,107,180,14,17,604,476,128,10
16837,2023-12-03 13:00:00,77,167,12,10,717,602,115,10
16838,2023-12-03 14:00:00,59,245,9,13,683,534,149,5
16839,2023-12-03 15:00:00,77,199,10,15,709,559,150,13
16840,2023-12-03 16:00:00,110,136,10,11,511,452,59,8
16841,2023-12-03 17:00:00,140,219,14,17,741,633,108,9
16842,2023-12-03 18:00:00,85,102,10,16,744,663,81,8
16843,2023-12-03 19:00:00,55,298,12,12,700,531,169,10
16844,2023-12-03 20:00:00,79,243,6,11,657,537,120,7
16845,2023-12-03 21:00:00,121,152,12,18,586,511,75,7
16846,2023-12-03 22:00:00,132,138,7,10,574,514,60,9
16847,2023-12-03 23:00:00,77,175,11,11,541,432,109,6
16848,2023-12-04 00:00:00,78,193,11,13,570,412,158,10
16849,2023-12-04 01:00:00,76,214,6,18,730,585,145,14
16850,2023-12-04 02:00:00,78,122,11,14,621,435,186,11
16851,2023-12-04 03:00:00,69,286,10,15,603,537,66,5
16852,2023-12-04 04:00:00,137,227,7,10,602,458,144,9
16853,2023-12-04 05:00:00,92,218,9,14,747,538,209,9
16854,2023-12-04 06:00:00,80,147,7,13,656,490,166,7
16855,2023-12-04 07:00:00,137,248,6,17,700,575,125,10
16856,2023-12-04 08:00:00,70,187,7,10,529,407,122,12
16857,2023-12-04 09:00:00,61,140,5,14,585,459,126,11
16858,2023-12-04 10:00:00,103,183,8,14,796,696,100,6
16859,2023-12-04 11:00:00,139,129,12,10,703,616,87,11
16860,2023-12-04 12:00:00,144,108,5,10,554,487,67,13
16861,2023-12-04 13:00:00,70,225,13,15,638,568,70,8
16862,2023-12-04 14:00:00,146,259,14,14,688,593,95,6
16863,2023-12-04 15:00:00,90,228,9,13,721,546,175,8
16864,2023-12-04 16:00:00,56,103,14,14,708,509,199,11
16865,2023-12-04 17:00:00,91,132,14,10,693,568,125,9
16866,2023-12-04 18:00:00,122,262,11,11,786,605,181,11
16867,2023-12-04 19:00:00,90,220,12,16,779,548,231,11
16868,2023-12-04 20:00:00,141,145,7,10,515,445,70,14
16869,2023-12-04 21:00:00,50,154,14,12,685,557,128,12
16870,2023-12-04 22:00:00,133,209,10,19,729,548,181,13
16871,2023-12-04 23:00:00,81,166,13,15,734,518,216,11
16872,2023-12-05 00:00:00,77,288,5,19,798,701,97,6
16873,2023-12-05 01:00:00,51,259,9,14,585,462,123,13
16874,2023-12-05 02:00:00,73,116,8,13,517,464,53,9
16875,2023-12-05 03:00:00,143,278,5,11,629,497,132,14
16876,2023-12-05 04:00:00,78,292,6,11,756,646,110,13
16877,2023-12-05 05:00:00,66,160,6,12,615,502,113,10
16878,2023-12-05 06:00:00,140,123,5,14,685,488,197,7
16879,2023-12-05 07:00:00,131,269,11,11,638,523,115,9
16880,2023-12-05 08:00:00,94,280,8,13,514,413,101,13
16881,2023-12-05 09:00:00,100,285,8,15,728,628,100,8
16882,2023-12-05 10:00:00,140,272,14,11,680,603,77,10
16883,2023-12-05 11:00:00,114,153,6,15,785,675,110,8
16884,2023-12-05 12:00:00,142,148,9,17,521,462,59,8
16885,2023-12-05 13:00:00,117,238,8,19,513,451,62,8
16886,2023-12-05 14:00:00,125,206,12,18,700,569,131,10
16887,2023-12-05 15:00:00,66,163,8,18,648,549,99,9
16888,2023-12-05 16:00:00,54,127,14,19,789,631,158,11
16889,2023-12-05 17:00:00,106,252,13,17,540,400,140,5
16890,2023-12-05 18:00:00,121,209,9,11,510,449,61,9
16891,2023-12-05 19:00:00,104,256,10,18,749,598,151,7
16892,2023-12-05 20:00:00,145,155,9,18,532,405,127,11
16893,2023-12-05 21:00:00,143,117,6,18,509,375,134,14
16894,2023-12-05 22:00:00,52,175,10,17,734,559,175,6
16895,2023-12-05 23:00:00,56,153,14,14,527,399,128,9
16896,2023-12-06 00:00:00,82,198,14,12,717,570,147,14
16897,2023-12-06 01:00:00,100,223,13,13,768,630,138,5
16898,2023-12-06 02:00:00,75,278,12,11,688,592,96,9
16899,2023-12-06 03:00:00,80,176,6,19,662,484,178,10
16900,2023-12-06 04:00:00,67,291,8,16,610,457,153,6
16901,2023-12-06 05:00:00,62,173,9,14,741,652,89,13
16902,2023-12-06 06:00:00,109,273,11,18,591,530,61,8
16903,2023-12-06 07:00:00,112,299,13,17,698,579,119,6
16904,2023-12-06 08:00:00,91,250,12,12,511,377,134,12
16905,2023-12-06 09:00:00,80,218,5,11,788,599,189,7
16906,2023-12-06 10:00:00,87,128,7,16,759,591,168,12
16907,2023-12-06 11:00:00,71,230,11,13,754,664,90,9
16908,2023-12-06 12:00:00,64,109,13,10,563,456,107,12
16909,2023-12-06 13:00:00,111,146,8,16,602,503,99,13
16910,2023-12-06 14:00:00,143,298,10,19,700,524,176,7
16911,2023-12-06 15:00:00,124,200,9,12,752,653,99,9
16912,2023-12-06 16:00:00,136,254,13,12,697,533,164,6
16913,2023-12-06 17:00:00,143,160,8,13,732,544,188,13
16914,2023-12-06 18:00:00,101,298,5,11,714,594,120,13
16915,2023-12-06 19:00:00,139,166,11,19,668,518,150,8
16916,2023-12-06 20:00:00,78,282,7,18,740,521,219,10
16917,2023-12-06 21:00:00,130,210,10,12,564,502,62,6
16918,2023-12-06 22:00:00,72,257,7,12,701,552,149,10
16919,2023-12-06 23:00:00,128,179,13,18,695,606,89,10
16920,2023-12-07 00:00:00,113,216,12,10,557,429,128,6
16921,2023-12-07 01:00:00,76,244,8,19,656,530,126,11
16922,2023-12-07 02:00:00,104,180,12,18,594,461,133,14
16923,2023-12-07 03:00:00,149,217,14,17,650,520,130,14
16924,2023-12-07 04:00:00,144,102,13,10,636,479,157,9
16925,2023-12-07 05:00:00,138,230,8,14,530,383,147,8
16926,2023-12-07 06:00:00,83,291,8,15,565,476,89,6
16927,2023-12-07 07:00:00,134,242,11,15,783,619,164,8
16928,2023-12-07 08:00:00,147,169,8,17,515,449,66,13
16929,2023-12-07 09:00:00,106,223,9,10,655,518,137,9
16930,2023-12-07 10:00:00,149,168,10,14,711,611,100,6
16931,2023-12-07 11:00:00,65,126,6,12,760,559,201,8
16932,2023-12-07 12:00:00,126,259,7,13,631,546,85,6
16933,2023-12-07 13:00:00,140,249,11,17,777,635,142,10
16934,2023-12-07 14:00:00,50,240,8,19,741,635,106,11
16935,2023-12-07 15:00:00,146,234,13,12,576,503,73,8
16936,2023-12-07 16:00:00,110,171,8,12,642,467,175,12
16937,2023-12-07 17:00:00,147,133,7,19,620,541,79,11
16938,2023-12-07 18:00:00,82,268,11,10,660,515,145,5
16939,2023-12-07 19:00:00,82,122,8,16,568,446,122,9
16940,2023-12-07 20:00:00,52,158,6,18,593,483,110,5
16941,2023-12-07 21:00:00,73,184,11,19,796,671,125,10
16942,2023-12-07 22:00:00,117,235,5,16,684,548,136,14
16943,2023-12-07 23:00:00,98,116,5,16,660,500,160,13
16944,2023-12-08 00:00:00,74,182,12,13,787,662,125,9
16945,2023-12-08 01:00:00,82,242,7,19,585,513,72,11
16946,2023-12-08 02:00:00,149,215,8,15,759,654,105,13
16947,2023-12-08 03:00:00,120,196,7,13,741,575,166,14
16948,2023-12-08 04:00:00,123,249,13,16,575,475,100,9
16949,2023-12-08 05:00:00,115,191,7,18,773,565,208,13
16950,2023-12-08 06:00:00,120,197,6,12,763,623,140,8
16951,2023-12-08 07:00:00,126,163,11,12,617,537,80,9
16952,2023-12-08 08:00:00,143,256,14,14,598,519,79,6
16953,2023-12-08 09:00:00,80,108,7,15,752,600,152,6
16954,2023-12-08 10:00:00,147,173,10,11,540,444,96,6
16955,2023-12-08 11:00:00,96,240,10,19,686,486,200,13
16956,2023-12-08 12:00:00,116,137,8,13,749,543,206,13
16957,2023-12-08 13:00:00,70,175,5,17,520,459,61,11
16958,2023-12-08 14:00:00,112,253,11,17,634,447,187,5
16959,2023-12-08 15:00:00,116,128,12,15,756,617,139,14
16960,2023-12-08 16:00:00,104,117,11,19,569,482,87,5
16961,2023-12-08 17:00:00,100,249,11,12,502,390,112,13
16962,2023-12-08 18:00:00,97,220,12,12,683,489,194,12
16963,2023-12-08 19:00:00,105,169,14,12,752,562,190,7
16964,2023-12-08 20:00:00,87,197,5,17,757,579,178,9
16965,2023-12-08 21:00:00,102,248,14,15,647,458,189,10
16966,2023-12-08 22:00:00,142,233,9,15,656,479,177,5
16967,2023-12-08 23:00:00,123,207,5,17,580,483,97,12
16968,2023-12-09 00:00:00,135,274,7,13,608,484,124,12
16969,2023-12-09 01:00:00,79,219,14,12,582,420,162,13
16970,2023-12-09 02:00:00,131,253,10,13,567,497,70,6
16971,2023-12-09 03:00:00,91,239,9,17,710,520,190,11
16972,2023-12-09 04:00:00,140,232,10,15,789,621,168,10
16973,2023-12-09 05:00:00,132,160,9,17,559,457,102,7
16974,2023-12-09 06:00:00,66,112,9,19,773,589,184,13
16975,2023-12-09 07:00:00,137,134,13,15,627,486,141,6
16976,2023-12-09 08:00:00,95,152,11,13,582,427,155,5
16977,2023-12-09 09:00:00,77,276,14,17,689,554,135,10
16978,2023-12-09 10:00:00,118,229,13,12,532,471,61,7
16979,2023-12-09 11:00:00,90,150,5,10,721,573,148,7
16980,2023-12-09 12:00:00,114,153,10,16,749,595,154,10
16981,2023-12-09 13:00:00,113,160,5,18,736,639,97,12
16982,2023-12-09 14:00:00,73,113,6,17,798,559,239,13
16983,2023-12-09 15:00:00,149,157,10,12,697,555,142,8
16984,2023-12-09 16:00:00,66,153,13,12,734,613,121,12
16985,2023-12-09 17:00:00,68,217,8,16,606,449,157,14
16986,2023-12-09 18:00:00,110,198,13,12,782,637,145,6
16987,2023-12-09 19:00:00,78,183,10,17,755,654,101,13
16988,2023-12-09 20:00:00,148,284,10,17,686,578,108,14
16989,2023-12-09 21:00:00,106,268,10,18,689,603,86,7
16990,2023-12-09 22:00:00,91,119,7,13,522,415,107,8
16991,2023-12-09 23:00:00,117,269,10,15,676,481,195,9
16992,2023-12-10 00:00:00,76,218,14,16,570,467,103,8
16993,2023-12-10 01:00:00,97,241,14,14,758,587,171,12
16994,2023-12-10 02:00:00,98,270,12,13,652,543,109,13
16995,2023-12-10 03:00:00,85,266,12,19,558,472,86,11
16996,2023-12-10 04:00:00,110,189,14,14,603,471,132,11
16997,2023-12-10 05:00:00,139,194,14,18,643,491,152,9
16998,2023-12-10 06:00:00,129,237,9,13,586,469,117,13
16999,2023-12-10 07:00:00,71,269,14,15,622,494,128,9
17000,2023-12-10 08:00:00,127,116,9,19,579,433,146,7
17001,2023-12-10 09:00:00,143,278,13,11,648,502,146,9
17002,2023-12-10 10:00:00,123,279,13,13,612,520,92,7
17003,2023-12-10 11:00:00,56,104,11,13,641,463,178,12
17004,2023-12-10 12:00:00,70,201,8,14,568,430,138,7
17005,2023-12-10 13:00:00,62,217,14,11,644,489,155,10
17006,2023-12-10 14:00:00,88,184,6,11,632,532,100,7
17007,2023-12-10 15:00:00,97,141,8,19,788,661,127,13
17008,2023-12-10 16:00:00,50,220,5,14,692,555,137,11
17009,2023-12-10 17:00:00,70,245,5,18,740,597,143,10
17010,2023-12-10 18:00:00,112,192,5,10,743,635,108,11
17011,2023-12-10 19:00:00,143,161,9,11,744,597,147,8
17012,2023-12-10 20:00:00,133,200,12,13,692,578,114,6
17013,2023-12-10 21:00:00,79,156,7,16,734,548,186,13
17014,2023-12-10 22:00:00,112,115,11,11,506,407,99,6
17015,2023-12-10 23:00:00,127,140,6,11,650,513,137,9
17016,2023-12-11 00:00:00,102,167,7,14,534,466,68,11
17017,2023-12-11 01:00:00,92,131,7,16,658,530,128,5
17018,2023-12-11 02:00:00,59,149,5,12,728,524,204,8
17019,2023-12-11 03:00:00,131,227,9,19,543,450,93,9
17020,2023-12-11 04:00:00,146,199,8,12,741,528,213,10
17021,2023-12-11 05:00:00,102,109,10,18,544,422,122,11
17022,2023-12-11 06:00:00,76,240,6,14,771,553,218,8
17023,2023-12-11 07:00:00,116,120,12,17,733,633,100,10
17024,2023-12-11 08:00:00,135,194,12,12,577,508,69,10
17025,2023-12-11 09:00:00,53,199,13,13,624,461,163,12
17026,2023-12-11 10:00:00,80,183,7,11,568,484,84,10
17027,2023-12-11 11:00:00,132,185,13,16,617,527,90,11
17028,2023-12-11 12:00:00,101,173,9,16,567,417,150,11
17029,2023-12-11 13:00:00,95,219,13,10,599,478,121,6
17030,2023-12-11 14:00:00,77,127,14,19,598,443,155,13
17031,2023-12-11 15:00:00,109,171,13,18,587,489,98,6
17032,2023-12-11 16:00:00,139,171,14,18,528,399,129,11
17033,2023-12-11 17:00:00,98,216,13,10,717,601,116,5
17034,2023-12-11 18:00:00,75,259,14,12,740,625,115,10
17035,2023-12-11 19:00:00,112,132,8,14,554,436,118,12
17036,2023-12-11 20:00:00,54,111,10,12,589,511,78,7
17037,2023-12-11 21:00:00,80,139,11,18,682,503,179,9
17038,2023-12-11 22:00:00,115,224,6,14,674,548,126,9
17039,2023-12-11 23:00:00,81,159,10,12,656,576,80,12
17040,2023-12-12 00:00:00,107,123,11,13,779,638,141,11
17041,2023-12-12 01:00:00,85,141,6,14,550,420,130,11
17042,2023-12-12 02:00:00,68,187,8,13,684,533,151,12
17043,2023-12-12 03:00:00,131,127,6,16,644,555,89,6
17044,2023-12-12 04:00:00,141,247,12,15,503,361,142,7
17045,2023-12-12 05:00:00,72,132,5,12,651,584,67,13
17046,2023-12-12 06:00:00,145,185,11,18,574,456,118,13
17047,2023-12-12 07:00:00,57,179,7,15,687,593,94,7
17048,2023-12-12 08:00:00,125,296,5,13,723,623,100,12
17049,2023-12-12 09:00:00,110,283,7,17,795,713,82,5
17050,2023-12-12 10:00:00,60,116,12,13,517,421,96,10
17051,2023-12-12 11:00:00,56,114,13,15,545,448,97,12
17052,2023-12-12 12:00:00,111,119,6,19,764,537,227,8
17053,2023-12-12 13:00:00,118,130,6,11,716,612,104,11
17054,2023-12-12 14:00:00,119,265,12,17,712,558,154,13
17055,2023-12-12 15:00:00,93,166,8,11,592,507,85,8
17056,2023-12-12 16:00:00,135,175,10,17,658,484,174,7
17057,2023-12-12 17:00:00,95,214,14,14,551,447,104,8
17058,2023-12-12 18:00:00,84,209,9,17,632,527,105,6
17059,2023-12-12 19:00:00,97,264,5,12,648,455,193,9
17060,2023-12-12 20:00:00,55,239,9,15,797,612,185,12
17061,2023-12-12 21:00:00,129,206,13,10,583,437,146,5
17062,2023-12-12 22:00:00,147,171,5,17,530,378,152,12
17063,2023-12-12 23:00:00,82,213,10,15,734,594,140,11
17064,2023-12-13 00:00:00,74,156,6,17,519,451,68,8
17065,2023-12-13 01:00:00,57,182,10,14,756,618,138,12
17066,2023-12-13 02:00:00,127,145,12,15,568,483,85,12
17067,2023-12-13 03:00:00,80,277,5,12,734,529,205,14
17068,2023-12-13 04:00:00,83,116,14,17,522,417,105,9
17069,2023-12-13 05:00:00,61,178,12,10,547,395,152,10
17070,2023-12-13 06:00:00,77,148,13,12,595,450,145,12
17071,2023-12-13 07:00:00,72,164,6,13,773,666,107,9
17072,2023-12-13 08:00:00,60,149,10,11,789,570,219,11
17073,2023-12-13 09:00:00,128,188,6,10,524,401,123,13
17074,2023-12-13 10:00:00,60,143,12,12,655,466,189,11
17075,2023-12-13 11:00:00,124,163,5,18,508,451,57,12
17076,2023-12-13 12:00:00,53,120,11,12,624,450,174,10
17077,2023-12-13 13:00:00,103,245,9,15,788,626,162,8
17078,2023-12-13 14:00:00,61,189,12,13,785,552,233,12
17079,2023-12-13 15:00:00,116,278,8,16,778,682,96,12
17080,2023-12-13 16:00:00,53,168,14,14,529,387,142,10
17081,2023-12-13 17:00:00,83,108,10,14,583,485,98,7
17082,2023-12-13 18:00:00,89,230,13,11,770,546,224,8
17083,2023-12-13 19:00:00,59,236,5,11,769,622,147,9
17084,2023-12-13 20:00:00,72,192,6,12,763,674,89,8
17085,2023-12-13 21:00:00,89,192,5,14,703,515,188,8
17086,2023-12-13 22:00:00,147,175,13,17,605,528,77,9
17087,2023-12-13 23:00:00,95,105,10,17,757,585,172,6
17088,2023-12-14 00:00:00,147,181,9,10,626,551,75,6
17089,2023-12-14 01:00:00,108,229,11,10,536,413,123,12
17090,2023-12-14 02:00:00,95,241,13,10,797,571,226,6
17091,2023-12-14 03:00:00,67,103,13,18,752,656,96,7
17092,2023-12-14 04:00:00,53,272,8,11,639,550,89,11
17093,2023-12-14 05:00:00,78,276,14,13,722,613,109,12
17094,2023-12-14 06:00:00,66,285,7,14,766,539,227,7
17095,2023-12-14 07:00:00,98,147,11,14,533,422,111,11
17096,2023-12-14 08:00:00,137,287,11,14,598,497,101,14
17097,2023-12-14 09:00:00,121,127,13,12,557,491,66,12
17098,2023-12-14 10:00:00,94,180,9,14,674,594,80,10
17099,2023-12-14 11:00:00,63,145,14,16,542,428,114,7
17100,2023-12-14 12:00:00,124,180,6,16,516,393,123,7
17101,2023-12-14 13:00:00,91,227,5,12,530,377,153,10
17102,2023-12-14 14:00:00,115,235,6,16,563,442,121,6
17103,2023-12-14 15:00:00,131,142,13,14,522,384,138,8
17104,2023-12-14 16:00:00,67,136,13,17,693,614,79,8
17105,2023-12-14 17:00:00,105,217,8,11,682,525,157,9
17106,2023-12-14 18:00:00,100,108,8,13,797,691,106,8
17107,2023-12-14 19:00:00,85,164,7,16,538,455,83,14
17108,2023-12-14 20:00:00,98,269,11,18,538,399,139,9
17109,2023-12-14 21:00:00,125,235,5,19,684,522,162,12
17110,2023-12-14 22:00:00,103,192,12,16,721,639,82,8
17111,2023-12-14 23:00:00,72,293,11,16,628,547,81,6
17112,2023-12-15 00:00:00,129,259,11,14,732,633,99,12
17113,2023-12-15 01:00:00,86,234,14,10,598,479,119,14
17114,2023-12-15 02:00:00,51,271,8,13,596,524,72,14
17115,2023-12-15 03:00:00,118,231,5,14,575,406,169,12
17116,2023-12-15 04:00:00,110,250,8,12,740,579,161,10
17117,2023-12-15 05:00:00,90,100,5,14,553,469,84,6
17118,2023-12-15 06:00:00,73,279,9,16,540,396,144,6
17119,2023-12-15 07:00:00,64,125,9,14,546,479,67,7
17120,2023-12-15 08:00:00,128,145,13,12,563,477,86,9
17121,2023-12-15 09:00:00,123,157,9,11,746,667,79,12
17122,2023-12-15 10:00:00,93,258,8,12,726,520,206,11
17123,2023-12-15 11:00:00,72,238,10,19,721,629,92,12
17124,2023-12-15 12:00:00,120,297,5,17,658,540,118,6
17125,2023-12-15 13:00:00,133,153,6,13,606,470,136,5
17126,2023-12-15 14:00:00,119,292,11,17,535,440,95,9
17127,2023-12-15 15:00:00,140,179,13,14,594,500,94,7
17128,2023-12-15 16:00:00,57,243,8,12,716,580,136,10
17129,2023-12-15 17:00:00,84,129,10,19,616,529,87,13
17130,2023-12-15 18:00:00,73,281,7,14,504,379,125,12
17131,2023-12-15 19:00:00,55,124,14,16,644,557,87,11
17132,2023-12-15 20:00:00,125,227,10,13,510,439,71,8
17133,2023-12-15 21:00:00,138,234,10,17,510,405,105,11
17134,2023-12-15 22:00:00,98,244,13,15,717,539,178,9
17135,2023-12-15 23:00:00,55,118,13,19,784,672,112,9
17136,2023-12-16 00:00:00,131,293,14,15,603,471,132,6
17137,2023-12-16 01:00:00,128,288,5,18,629,492,137,8
17138,2023-12-16 02:00:00,88,238,7,14,797,634,163,13
17139,2023-12-16 03:00:00,147,278,6,19,672,579,93,14
17140,2023-12-16 04:00:00,83,127,11,12,620,443,177,8
17141,2023-12-16 05:00:00,108,144,11,15,769,623,146,8
17142,2023-12-16 06:00:00,140,179,8,11,782,566,216,6
17143,2023-12-16 07:00:00,88,298,12,18,682,529,153,6
17144,2023-12-16 08:00:00,66,277,12,14,673,494,179,13
17145,2023-12-16 09:00:00,67,110,7,16,570,439,131,5
17146,2023-12-16 10:00:00,137,260,11,17,725,515,210,8
17147,2023-12-16 11:00:00,56,227,13,13,711,499,212,5
17148,2023-12-16 12:00:00,88,165,8,15,542,402,140,8
17149,2023-12-16 13:00:00,63,183,10,19,678,496,182,10
17150,2023-12-16 14:00:00,130,192,14,12,568,474,94,11
17151,2023-12-16 15:00:00,96,100,10,15,749,539,210,14
17152,2023-12-16 16:00:00,103,271,10,17,742,587,155,7
17153,2023-12-16 17:00:00,105,161,9,13,563,424,139,8
17154,2023-12-16 18:00:00,124,182,11,17,635,532,103,11
17155,2023-12-16 19:00:00,51,191,12,12,733,601,132,11
17156,2023-12-16 20:00:00,142,186,13,19,646,506,140,14
17157,2023-12-16 21:00:00,132,264,11,17,701,496,205,7
17158,2023-12-16 22:00:00,84,190,12,16,758,616,142,10
17159,2023-12-16 23:00:00,130,168,13,19,699,532,167,14
17160,2023-12-17 00:00:00,82,120,10,11,745,577,168,11
17161,2023-12-17 01:00:00,126,192,9,17,582,490,92,8
17162,2023-12-17 02:00:00,82,135,14,16,633,493,140,9
17163,2023-12-17 03:00:00,91,182,7,15,595,509,86,5
17164,2023-12-17 04:00:00,66,170,13,18,514,400,114,8
17165,2023-12-17 05:00:00,93,259,8,13,742,597,145,8
17166,2023-12-17 06:00:00,69,108,11,12,595,509,86,14
17167,2023-12-17 07:00:00,52,221,10,16,563,486,77,6
17168,2023-12-17 08:00:00,100,188,11,17,681,549,132,7
17169,2023-12-17 09:00:00,102,126,14,13,665,554,111,9
17170,2023-12-17 10:00:00,123,248,12,14,607,451,156,14
17171,2023-12-17 11:00:00,113,121,7,12,634,552,82,12
17172,2023-12-17 12:00:00,78,287,14,14,653,571,82,9
17173,2023-12-17 13:00:00,64,231,10,12,705,552,153,12
17174,2023-12-17 14:00:00,100,282,11,17,561,457,104,11
17175,2023-12-17 15:00:00,64,249,11,17,765,671,94,5
17176,2023-12-17 16:00:00,79,202,9,19,621,494,127,7
17177,2023-12-17 17:00:00,80,259,13,19,749,660,89,12
17178,2023-12-17 18:00:00,104,205,11,10,645,507,138,12
17179,2023-12-17 19:00:00,86,271,5,18,525,429,96,7
17180,2023-12-17 20:00:00,146,133,10,18,665,589,76,12
17181,2023-12-17 21:00:00,76,113,10,12,648,533,115,7
17182,2023-12-17 22:00:00,80,169,5,18,515,405,110,5
17183,2023-12-17 23:00:00,98,176,13,12,578,455,123,5
17184,2023-12-18 00:00:00,85,258,9,15,507,396,111,10
17185,2023-12-18 01:00:00,64,198,14,17,670,574,96,13
17186,2023-12-18 02:00:00,57,205,5,12,781,606,175,9
17187,2023-12-18 03:00:00,57,214,13,12,737,602,135,7
17188,2023-12-18 04:00:00,92,229,7,17,504,376,128,8
17189,2023-12-18 05:00:00,116,173,14,14,562,411,151,14
17190,2023-12-18 06:00:00,87,127,12,15,617,489,128,10
17191,2023-12-18 07:00:00,67,196,10,18,699,517,182,5
17192,2023-12-18 08:00:00,94,161,10,18,588,516,72,14
17193,2023-12-18 09:00:00,69,107,6,19,671,538,133,5
17194,2023-12-18 10:00:00,98,148,6,11,768,595,173,7
17195,2023-12-18 11:00:00,92,115,14,14,587,491,96,11
17196,2023-12-18 12:00:00,146,299,14,13,624,513,111,12
17197,2023-12-18 13:00:00,91,192,10,14,653,479,174,6
17198,2023-12-18 14:00:00,133,277,8,18,759,543,216,5
17199,2023-12-18 15:00:00,128,130,14,12,519,399,120,13
17200,2023-12-18 16:00:00,124,238,9,10,550,403,147,6
17201,2023-12-18 17:00:00,133,195,13,14,785,556,229,5
17202,2023-12-18 18:00:00,54,199,7,18,639,498,141,10
17203,2023-12-18 19:00:00,149,200,13,11,525,454,71,9
17204,2023-12-18 20:00:00,109,180,7,15,668,490,178,7
17205,2023-12-18 21:00:00,66,176,12,15,585,416,169,14
17206,2023-12-18 22:00:00,87,175,11,16,749,556,193,10
17207,2023-12-18 23:00:00,52,152,5,19,538,430,108,13
17208,2023-12-19 00:00:00,131,150,12,15,593,425,168,12
17209,2023-12-19 01:00:00,84,278,5,18,511,376,135,5
17210,2023-12-19 02:00:00,68,278,9,16,525,369,156,11
17211,2023-12-19 03:00:00,76,144,5,19,763,600,163,8
17212,2023-12-19 04:00:00,86,286,10,12,577,442,135,10
17213,2023-12-19 05:00:00,71,264,7,14,528,434,94,13
17214,2023-12-19 06:00:00,114,280,9,15,609,518,91,5
17215,2023-12-19 07:00:00,137,140,7,15,589,427,162,8
17216,2023-12-19 08:00:00,55,193,5,17,636,481,155,11
17217,2023-12-19 09:00:00,79,209,5,13,654,549,105,6
17218,2023-12-19 10:00:00,65,161,10,16,597,448,149,13
17219,2023-12-19 11:00:00,146,235,11,15,587,454,133,5
17220,2023-12-19 12:00:00,59,106,7,10,566,504,62,6
17221,2023-12-19 13:00:00,111,138,6,18,587,460,127,11
17222,2023-12-19 14:00:00,137,250,12,11,569,404,165,9
17223,2023-12-19 15:00:00,87,210,7,16,646,514,132,12
17224,2023-12-19 16:00:00,129,222,6,12,710,546,164,8
17225,2023-12-19 17:00:00,61,133,10,10,774,580,194,5
17226,2023-12-19 18:00:00,106,253,10,15,620,503,117,10
17227,2023-12-19 19:00:00,122,106,7,11,749,630,119,9
17228,2023-12-19 20:00:00,104,102,14,16,535,386,149,9
17229,2023-12-19 21:00:00,145,112,12,12,710,546,164,6
17230,2023-12-19 22:00:00,114,150,5,15,791,672,119,12
17231,2023-12-19 23:00:00,57,243,14,15,637,567,70,12
17232,2023-12-20 00:00:00,56,115,10,15,689,530,159,5
17233,2023-12-20 01:00:00,126,129,14,15,595,520,75,14
17234,2023-12-20 02:00:00,82,147,8,16,777,629,148,6
17235,2023-12-20 03:00:00,70,149,14,10,687,536,151,9
17236,2023-12-20 04:00:00,105,297,12,11,594,423,171,13
17237,2023-12-20 05:00:00,60,155,10,11,521,461,60,9
17238,2023-12-20 06:00:00,73,290,8,14,586,488,98,6
17239,2023-12-20 07:00:00,62,165,9,12,530,402,128,5
17240,2023-12-20 08:00:00,77,261,7,18,776,595,181,11
17241,2023-12-20 09:00:00,118,125,14,13,652,487,165,14
17242,2023-12-20 10:00:00,133,243,14,16,605,451,154,5
17243,2023-12-20 11:00:00,84,163,11,13,758,665,93,8
17244,2023-12-20 12:00:00,85,240,7,19,644,451,193,5
17245,2023-12-20 13:00:00,125,165,12,13,636,507,129,9
17246,2023-12-20 14:00:00,89,113,10,16,784,661,123,9
17247,2023-12-20 15:00:00,95,110,8,15,671,510,161,7
17248,2023-12-20 16:00:00,105,135,6,17,650,543,107,8
17249,2023-12-20 17:00:00,79,133,9,13,794,572,222,11
17250,2023-12-20 18:00:00,82,167,10,19,589,514,75,9
17251,2023-12-20 19:00:00,137,169,13,10,568,403,165,11
17252,2023-12-20 20:00:00,105,297,13,14,556,405,151,5
17253,2023-12-20 21:00:00,72,259,13,13,637,539,98,12
17254,2023-12-20 22:00:00,123,231,12,10,723,507,216,7
17255,2023-12-20 23:00:00,93,253,11,11,780,551,229,13
17256,2023-12-21 00:00:00,58,221,10,11,672,538,134,11
17257,2023-12-21 01:00:00,106,246,7,15,759,665,94,9
17258,2023-12-21 02:00:00,84,249,8,11,717,604,113,14
17259,2023-12-21 03:00:00,125,127,9,12,797,714,83,5
17260,2023-12-21 04:00:00,81,285,6,10,548,481,67,10
17261,2023-12-21 05:00:00,118,228,13,10,593,512,81,14
17262,2023-12-21 06:00:00,96,178,10,16,744,620,124,7
17263,2023-12-21 07:00:00,94,207,11,14,655,538,117,6
17264,2023-12-21 08:00:00,58,290,14,16,543,476,67,6
17265,2023-12-21 09:00:00,72,190,12,18,761,619,142,11
17266,2023-12-21 10:00:00,109,221,5,13,772,600,172,13
17267,2023-12-21 11:00:00,96,228,6,12,775,635,140,8
17268,2023-12-21 12:00:00,146,103,6,11,656,508,148,6
17269,2023-12-21 13:00:00,108,271,5,18,644,551,93,11
17270,2023-12-21 14:00:00,64,262,11,16,521,381,140,5
17271,2023-12-21 15:00:00,94,152,13,19,658,494,164,13
17272,2023-12-21 16:00:00,107,220,6,11,652,553,99,12
17273,2023-12-21 17:00:00,96,128,11,11,679,501,178,10
17274,2023-12-21 18:00:00,64,160,5,15,790,582,208,12
17275,2023-12-21 19:00:00,94,276,5,15,512,402,110,13
17276,2023-12-21 20:00:00,66,212,6,14,661,558,103,12
17277,2023-12-21 21:00:00,91,112,14,19,708,627,81,9
17278,2023-12-21 22:00:00,64,245,14,19,655,508,147,9
17279,2023-12-21 23:00:00,100,144,13,12,657,575,82,10
17280,2023-12-22 00:00:00,127,114,9,16,771,625,146,8
17281,2023-12-22 01:00:00,106,272,14,10,508,383,125,13
17282,2023-12-22 02:00:00,120,128,5,19,662,501,161,12
17283,2023-12-22 03:00:00,149,137,7,16,672,478,194,9
17284,2023-12-22 04:00:00,149,243,12,15,584,442,142,12
17285,2023-12-22 05:00:00,51,189,12,18,617,459,158,14
17286,2023-12-22 06:00:00,59,120,5,10,577,496,81,7
17287,2023-12-22 07:00:00,57,146,9,19,559,457,102,5
17288,2023-12-22 08:00:00,114,170,9,18,753,669,84,9
17289,2023-12-22 09:00:00,82,109,7,11,753,625,128,11
17290,2023-12-22 10:00:00,81,247,13,11,600,510,90,13
17291,2023-12-22 11:00:00,115,132,10,11,712,552,160,13
17292,2023-12-22 12:00:00,131,186,14,14,727,615,112,13
17293,2023-12-22 13:00:00,73,179,8,13,694,509,185,6
17294,2023-12-22 14:00:00,116,160,10,12,721,560,161,14
17295,2023-12-22 15:00:00,143,130,11,13,624,497,127,6
17296,2023-12-22 16:00:00,134,163,10,18,627,489,138,7
17297,2023-12-22 17:00:00,145,257,7,19,624,521,103,7
17298,2023-12-22 18:00:00,146,160,5,13,666,594,72,14
17299,2023-12-22 19:00:00,91,135,12,18,798,624,174,5
17300,2023-12-22 20:00:00,137,110,14,14,743,591,152,8
17301,2023-12-22 21:00:00,67,140,11,12,675,481,194,9
17302,2023-12-22 22:00:00,148,242,9,17,775,638,137,10
17303,2023-12-22 23:00:00,56,234,6,17,540,429,111,12
17304,2023-12-23 00:00:00,90,116,10,13,696,569,127,14
17305,2023-12-23 01:00:00,148,178,5,18,759,534,225,10
17306,2023-12-23 02:00:00,100,133,12,13,652,468,184,5
17307,2023-12-23 03:00:00,122,150,12,19,798,711,87,8
17308,2023-12-23 04:00:00,91,219,6,17,624,442,182,12
17309,2023-12-23 05:00:00,146,269,6,18,722,622,100,11
17310,2023-12-23 06:00:00,119,272,8,16,608,480,128,13
17311,2023-12-23 07:00:00,80,192,11,13,522,376,146,11
17312,2023-12-23 08:00:00,58,138,7,19,654,550,104,13
17313,2023-12-23 09:00:00,118,245,11,13,635,539,96,10
17314,2023-12-23 10:00:00,98,294,7,17,798,683,115,13
17315,2023-12-23 11:00:00,112,101,6,19,505,360,145,6
17316,2023-12-23 12:00:00,81,227,11,12,603,454,149,14
17317,2023-12-23 13:00:00,68,258,5,18,602,448,154,5
17318,2023-12-23 14:00:00,63,152,13,12,532,430,102,7
17319,2023-12-23 15:00:00,94,139,8,13,565,470,95,14
17320,2023-12-23 16:00:00,114,222,5,10,593,459,134,7
17321,2023-12-23 17:00:00,103,252,13,19,784,587,197,5
17322,2023-12-23 18:00:00,126,245,7,14,713,581,132,14
17323,2023-12-23 19:00:00,86,251,14,17,707,540,167,13
17324,2023-12-23 20:00:00,133,104,12,18,705,630,75,14
17325,2023-12-23 21:00:00,75,210,7,16,711,593,118,10
17326,2023-12-23 22:00:00,64,199,7,11,673,488,185,12
17327,2023-12-23 23:00:00,97,282,7,10,591,476,115,9
17328,2023-12-24 00:00:00,125,108,13,13,502,360,142,12
17329,2023-12-24 01:00:00,115,140,13,10,533,457,76,7
17330,2023-12-24 02:00:00,115,270,12,15,612,547,65,10
17331,2023-12-24 03:00:00,83,166,9,14,778,672,106,14
17332,2023-12-24 04:00:00,83,151,12,13,769,608,161,11
17333,2023-12-24 05:00:00,56,255,8,10,711,518,193,12
17334,2023-12-24 06:00:00,101,107,7,13,732,600,132,12
17335,2023-12-24 07:00:00,126,273,10,19,637,471,166,11
17336,2023-12-24 08:00:00,79,155,11,16,756,654,102,10
17337,2023-12-24 09:00:00,83,196,9,19,738,603,135,13
17338,2023-12-24 10:00:00,121,165,5,13,671,476,195,8
17339,2023-12-24 11:00:00,117,245,13,14,744,656,88,8
17340,2023-12-24 12:00:00,116,163,9,18,671,586,85,13
17341,2023-12-24 13:00:00,93,179,12,12,647,467,180,8
17342,2023-12-24 14:00:00,140,296,8,15,607,539,68,13
17343,2023-12-24 15:00:00,64,291,5,12,687,579,108,11
17344,2023-12-24 16:00:00,96,102,12,18,745,614,131,8
17345,2023-12-24 17:00:00,65,147,5,12,536,438,98,7
17346,2023-12-24 18:00:00,147,192,6,12,572,439,133,10
17347,2023-12-24 19:00:00,110,214,12,17,742,545,197,10
17348,2023-12-24 20:00:00,136,141,5,11,760,654,106,11
17349,2023-12-24 21:00:00,126,166,9,17,694,548,146,8
17350,2023-12-24 22:00:00,117,192,6,16,743,656,87,7
17351,2023-12-24 23:00:00,56,269,13,18,701,630,71,6
17352,2023-12-25 00:00:00,56,234,6,12,539,402,137,12
17353,2023-12-25 01:00:00,134,131,10,19,716,556,160,11
17354,2023-12-25 02:00:00,114,273,6,10,529,371,158,6
17355,2023-12-25 03:00:00,117,222,10,16,556,461,95,12
17356,2023-12-25 04:00:00,65,169,7,16,624,520,104,14
17357,2023-12-25 05:00:00,86,204,5,16,581,494,87,12
17358,2023-12-25 06:00:00,53,164,11,15,690,507,183,11
17359,2023-12-25 07:00:00,122,271,12,15,505,383,122,9
17360,2023-12-25 08:00:00,104,135,13,15,690,504,186,11
17361,2023-12-25 09:00:00,72,128,5,19,534,393,141,8
17362,2023-12-25 10:00:00,115,132,6,11,700,534,166,5
17363,2023-12-25 11:00:00,68,182,6,12,718,601,117,5
17364,2023-12-25 12:00:00,105,259,14,19,559,404,155,10
17365,2023-12-25 13:00:00,122,151,12,13,574,432,142,5
17366,2023-12-25 14:00:00,131,195,14,11,546,450,96,7
17367,2023-12-25 15:00:00,70,209,6,11,672,480,192,10
17368,2023-12-25 16:00:00,117,187,12,18,629,485,144,12
17369,2023-12-25 17:00:00,70,286,7,13,538,390,148,14
17370,2023-12-25 18:00:00,51,191,11,19,579,502,77,9
17371,2023-12-25 19:00:00,63,122,7,17,727,585,142,12
17372,2023-12-25 20:00:00,132,118,13,14,738,549,189,10
17373,2023-12-25 21:00:00,69,285,13,12,729,612,117,5
17374,2023-12-25 22:00:00,149,227,7,17,604,424,180,8
17375,2023-12-25 23:00:00,64,160,14,10,550,428,122,7
17376,2023-12-26 00:00:00,136,152,11,14,718,565,153,8
17377,2023-12-26 01:00:00,57,256,14,12,790,568,222,5
17378,2023-12-26 02:00:00,74,186,13,14,732,551,181,9
17379,2023-12-26 03:00:00,142,155,14,15,778,558,220,6
17380,2023-12-26 04:00:00,77,174,7,16,547,421,126,9
17381,2023-12-26 05:00:00,144,297,7,16,564,489,75,6
17382,2023-12-26 06:00:00,85,273,8,17,611,457,154,11
17383,2023-12-26 07:00:00,123,236,7,10,799,696,103,7
17384,2023-12-26 08:00:00,103,133,11,10,623,444,179,5
17385,2023-12-26 09:00:00,78,145,12,16,542,462,80,12
17386,2023-12-26 10:00:00,91,192,11,17,659,471,188,13
17387,2023-12-26 11:00:00,57,280,14,19,725,597,128,5
17388,2023-12-26 12:00:00,99,232,10,17,682,605,77,8
17389,2023-12-26 13:00:00,77,281,8,17,779,551,228,7
17390,2023-12-26 14:00:00,111,285,7,18,688,592,96,11
17391,2023-12-26 15:00:00,84,176,7,11,739,638,101,6
17392,2023-12-26 16:00:00,129,132,8,16,764,642,122,10
17393,2023-12-26 17:00:00,67,174,13,15,614,437,177,13
17394,2023-12-26 18:00:00,106,128,8,17,736,620,116,5
17395,2023-12-26 19:00:00,83,154,13,17,628,542,86,14
17396,2023-12-26 20:00:00,128,114,9,15,500,396,104,12
17397,2023-12-26 21:00:00,140,256,5,14,691,576,115,10
17398,2023-12-26 22:00:00,111,107,8,16,537,464,73,7
17399,2023-12-26 23:00:00,110,231,8,12,703,534,169,10
17400,2023-12-27 00:00:00,104,213,9,17,574,510,64,7
17401,2023-12-27 01:00:00,65,107,13,17,740,653,87,14
17402,2023-12-27 02:00:00,105,275,6,10,666,559,107,11
17403,2023-12-27 03:00:00,84,119,11,13,761,670,91,5
17404,2023-12-27 04:00:00,115,132,14,19,704,606,98,7
17405,2023-12-27 05:00:00,139,215,9,14,525,387,138,10
17406,2023-12-27 06:00:00,55,144,11,18,544,384,160,5
17407,2023-12-27 07:00:00,59,246,10,15,787,660,127,8
17408,2023-12-27 08:00:00,128,271,7,11,647,531,116,5
17409,2023-12-27 09:00:00,72,129,7,17,558,444,114,6
17410,2023-12-27 10:00:00,115,153,5,16,710,632,78,10
17411,2023-12-27 11:00:00,79,270,7,19,501,360,141,5
17412,2023-12-27 12:00:00,109,259,6,15,649,537,112,8
17413,2023-12-27 13:00:00,50,119,13,18,590,485,105,10
17414,2023-12-27 14:00:00,90,287,9,16,749,662,87,6
17415,2023-12-27 15:00:00,92,285,12,15,780,683,97,10
17416,2023-12-27 16:00:00,66,117,12,11,769,674,95,5
17417,2023-12-27 17:00:00,51,195,6,10,692,528,164,7
17418,2023-12-27 18:00:00,72,296,14,12,726,637,89,5
17419,2023-12-27 19:00:00,140,262,7,18,719,562,157,9
17420,2023-12-27 20:00:00,113,153,10,18,654,490,164,9
17421,2023-12-27 21:00:00,54,225,10,18,735,649,86,6
17422,2023-12-27 22:00:00,97,129,8,19,696,531,165,13
17423,2023-12-27 23:00:00,137,190,9,19,533,422,111,12
17424,2023-12-28 00:00:00,65,167,5,19,727,650,77,13
17425,2023-12-28 01:00:00,54,251,14,10,593,484,109,11
17426,2023-12-28 02:00:00,98,240,9,14,557,492,65,9
17427,2023-12-28 03:00:00,148,180,7,10,692,578,114,7
17428,2023-12-28 04:00:00,104,273,6,10,669,567,102,5
17429,2023-12-28 05:00:00,141,214,10,12,761,636,125,10
17430,2023-12-28 06:00:00,127,206,11,13,653,463,190,7
17431,2023-12-28 07:00:00,80,117,9,10,566,451,115,11
17432,2023-12-28 08:00:00,95,229,8,17,774,667,107,5
17433,2023-12-28 09:00:00,54,289,12,13,718,622,96,13
17434,2023-12-28 10:00:00,120,277,7,12,629,554,75,13
17435,2023-12-28 11:00:00,147,246,9,10,610,458,152,8
17436,2023-12-28 12:00:00,135,124,10,16,545,408,137,12
17437,2023-12-28 13:00:00,124,214,9,11,727,543,184,9
17438,2023-12-28 14:00:00,65,126,9,14,545,472,73,5
17439,2023-12-28 15:00:00,124,173,5,11,696,556,140,8
17440,2023-12-28 16:00:00,78,275,6,14,737,555,182,7
17441,2023-12-28 17:00:00,128,292,6,17,627,505,122,10
17442,2023-12-28 18:00:00,145,169,9,15,517,410,107,6
17443,2023-12-28 19:00:00,77,297,10,19,717,578,139,5
17444,2023-12-28 20:00:00,76,129,13,16,575,425,150,10
17445,2023-12-28 21:00:00,98,230,12,14,572,451,121,10
17446,2023-12-28 22:00:00,106,108,14,12,587,519,68,8
17447,2023-12-28 23:00:00,59,251,12,13,760,622,138,14
17448,2023-12-29 00:00:00,115,137,14,18,729,641,88,9
17449,2023-12-29 01:00:00,137,185,7,14,542,419,123,5
17450,2023-12-29 02:00:00,64,259,14,17,668,548,120,8
17451,2023-12-29 03:00:00,139,137,12,19,608,429,179,5
17452,2023-12-29 04:00:00,103,212,7,15,580,509,71,6
17453,2023-12-29 05:00:00,113,227,9,10,512,360,152,6
17454,2023-12-29 06:00:00,111,236,9,17,686,575,111,5
17455,2023-12-29 07:00:00,110,228,11,19,565,398,167,14
17456,2023-12-29 08:00:00,82,147,12,17,759,538,221,11
17457,2023-12-29 09:00:00,115,298,5,17,641,457,184,10
17458,2023-12-29 10:00:00,104,299,6,19,503,354,149,7
17459,2023-12-29 11:00:00,110,148,8,12,782,554,228,5
17460,2023-12-29 12:00:00,97,258,11,18,717,546,171,11
17461,2023-12-29 13:00:00,113,160,7,11,678,478,200,12
17462,2023-12-29 14:00:00,74,278,8,10,747,617,130,6
17463,2023-12-29 15:00:00,52,140,7,13,725,525,200,13
17464,2023-12-29 16:00:00,53,197,8,19,661,570,91,11
17465,2023-12-29 17:00:00,133,144,14,12,765,629,136,10
17466,2023-12-29 18:00:00,130,186,9,12,507,385,122,7
17467,2023-12-29 19:00:00,123,119,14,18,658,557,101,11
17468,2023-12-29 20:00:00,76,264,5,18,782,598,184,5
17469,2023-12-29 21:00:00,87,110,12,16,762,577,185,7
17470,2023-12-29 22:00:00,125,150,5,14,524,433,91,13
17471,2023-12-29 23:00:00,85,106,5,15,676,532,144,11
17472,2023-12-30 00:00:00,63,236,11,12,726,539,187,9
17473,2023-12-30 01:00:00,67,141,6,19,577,433,144,7
17474,2023-12-30 02:00:00,141,173,10,12,546,397,149,5
17475,2023-12-30 03:00:00,148,208,10,10,766,550,216,11
17476,2023-12-30 04:00:00,82,289,13,14,797,578,219,12
17477,2023-12-30 05:00:00,111,150,5,17,731,524,207,14
17478,2023-12-30 06:00:00,64,143,5,19,621,504,117,11
17479,2023-12-30 07:00:00,80,177,12,14,728,595,133,12
17480,2023-12-30 08:00:00,109,192,5,13,725,597,128,9
17481,2023-12-30 09:00:00,127,209,6,17,519,431,88,10
17482,2023-12-30 10:00:00,61,297,7,18,532,396,136,11
17483,2023-12-30 11:00:00,145,217,14,14,752,662,90,12
17484,2023-12-30 12:00:00,105,189,8,15,524,437,87,6
17485,2023-12-30 13:00:00,52,190,14,12,569,470,99,9
17486,2023-12-30 14:00:00,80,162,8,17,777,603,174,12
17487,2023-12-30 15:00:00,106,225,8,14,552,479,73,13
17488,2023-12-30 16:00:00,126,146,11,17,676,481,195,9
17489,2023-12-30 17:00:00,98,192,14,16,538,461,77,12
17490,2023-12-30 18:00:00,116,273,5,11,519,405,114,14
17491,2023-12-30 19:00:00,110,136,6,15,601,432,169,11
17492,2023-12-30 20:00:00,133,290,14,10,642,480,162,10
17493,2023-12-30 21:00:00,102,145,13,14,645,536,109,11
17494,2023-12-30 22:00:00,72,242,13,19,771,688,83,6
17495,2023-12-30 23:00:00,88,281,6,15,798,564,234,5
17496,2023-12-31 00:00:00,79,144,5,10,510,399,111,5
17497,2023-12-31 01:00:00,51,198,13,14,534,393,141,14
17498,2023-12-31 02:00:00,95,272,14,18,562,439,123,10
17499,2023-12-31 03:00:00,126,106,14,13,679,529,150,9
17500,2023-12-31 04:00:00,114,227,5,17,522,401,121,10
17501,2023-12-31 05:00:00,92,155,7,18,625,545,80,14
17502,2023-12-31 06:00:00,67,248,6,16,748,526,222,12
17503,2023-12-31 07:00:00,106,121,11,14,663,472,191,11
17504,2023-12-31 08:00:00,107,184,13,16,649,464,185,8
17505,2023-12-31 09:00:00,130,194,11,10,552,442,110,8
17506,2023-12-31 10:00:00,120,224,11,16,747,630,117,13
17507,2023-12-31 11:00:00,51,122,13,17,736,578,158,10
17508,2023-12-31 12:00:00,72,299,7,15,756,638,118,14
17509,2023-12-31 13:00:00,132,108,12,17,653,549,104,6
17510,2023-12-31 14:00:00,129,277,7,12,572,437,135,5
17511,2023-12-31 15:00:00,128,150,11,18,607,541,66,10
17512,2023-12-31 16:00:00,117,272,9,17,633,499,134,9
17513,2023-12-31 17:00:00,144,206,12,14,708,570,138,5
17514,2023-12-31 18:00:00,82,283,13,13,681,528,153,10
17515,2023-12-31 19:00:00,65,234,9,12,658,566,92,6
17516,2023-12-31 20:00:00,131,190,8,10,639,481,158,7
17517,2023-12-31 21:00:00,78,234,12,16,785,585,200,9
17518,2023-12-31 22:00:00,102,146,14,16,533,430,103,12
17519,2023-12-31 23:00:00,57,138,11,19,700,520,180,8
